Aqil haqqani	Yar ye kia D G Ranger ho kar dar raha ha pat to kahi ka
Shoaib Salman	Sir Social medium ka kuch Karen Hame Social medium ko Handle karne ki bohot zarorat hai Logo ke pa Common sense hai nhi Log Sensible nhi Awaam Ko kbhi Amrood pe Allah ka Naam likha nazar aata hai kbhi Chaand per Hamari Awaam ko sense hai nhi ye propaganda ko promote karne main Useful Saabit hoti hai Her jhooti succhi Videos Bina soche samjhe share Kar dete Hain Maanta Hun Awaam jaan Kar nhi karti Bhole pn main aisa karti hai But Awaam ka bhola pn propaganda phelane walo ke lye useful Saabit ho raha hai Lehaza Social medium pe kuch work Kya jaye km az km Facebook ko Registered Kya Jaye
mk ahsan	No one reason for street crime is police which is involved Change whole Karachi police
Danish Dani Dani	I love u D G sir
naveed shaikh	Pakistan army zindabad
i Love u Pakistan	Pakistan ringer zinda bad
sarmad maqbool	I am proud of you guy Bless you
Arman Dhillon	Pak army zindabad ISI zindabad Rangers zindabad
Am Am	Oye Gando Uzair bloch Ka pta mang Rhay ho Ta kay Kall ko u ko koi mar daey
rashid khan	Thank you ranger
Uzair Jutt	Markhoors🇵🇰🇵🇰🇵🇰
Junaid Aftab	قابل تعریف، پورے پاکستان کے لیے کام ہو۔ پولیس کی اخلاقی حالت بہت خراب ہے
Hamza Afzal	ڈی جی صاحب نے میڈیا سوسائٹی اور سندھ حکومت ننگا کر کے رکھ دیا ہے زور دار تھپڑ ان لوگوں کے منہ پر جو فوج کے بجٹ پر بکواس کرتے ہیں
Ghulam Murtaza	bhot bhot sukriya ap sb ka bhot he omda show tha mary pa alfaz nahi k main show ki tareef kr sakon
Shiza ji Shiza butt	Kafi arsy k bade kici ko humble or frequently bolty hoey suna very nice sir
asad choohan	yah interview ha yah Dg rangre ki briefing ji main kisi ko bolny ki ijazat nah
8 balll pool	انشاءاللہ پاکستان اب بہتری کی جانب گامزن ہے۔ اللہ تعالی پاکستان کو دشمنوں کی شر سے محفوظ رکھے ۔آمین۔ ہمارے دلوں کی دھڑکنیں پاکستان کے ساتھ دھڑکتا ہے۔ لیکن آئین پاکستان ہمیں پاکستانی نہیں سمجھتا ۔ فرام گلگت بلتستان
mwaseem abbasi	I like the conversation style Pak army zinda bad Pakistan 🇵🇰 paeinda bad
jaffar khan	Isi
Shahid Shafiq	جناب آپ 30 سال سے ھیں کراچی میں۔۔۔۔آپ صرف عکسری بینک،،سمینٹ بیکری ،شگر میلز ، یہ کام تھا ،، کراچی کا سب کچھ سمینٹ کر ،بم بلاسٹ یہ سب آپ کی اپنی طالبان ،نے کیے۔لیاری گینگ وار، ذرداری ،یہ سب
Khubaib Rehman	Very Good Show WellDone Pakistan Rangers 🤗😍
alijutt jut	5 minute ki baat itni lambi
Tanveer Afzal Malik	پاک فوج زندہ باد۔۔۔۔ پاکستان پائندہ باد۔
Safina Safina	Kashaf sab 24 October show look like you are not happy Pakistan going up Imrankhan what he doing you don t like I think you pmln ppp Wich is crupet in the all world
Khaakpae Ahley Bait-o- Sahaba Ikram	Jhoot ka palanda hai pura program Pichley 5 Saal main 80 judicial killing huwi hai 155 kay qareeb log missing hai Yeh kaunsa aman o amaan hai
Atif Ali Shah	PAKISTAN ZINDABAD PAK ARMY PAINDABAD SINDH RANJERS LOVE U AND THANK YOU VERY MUCH SIR FOR YOUR INFORMATION
syed zain	Thank you Pakistan Ranger for bring back happenes to our city 🤗🤗😍 PakistanZindabad PakRangerPaindabad ISIZindabad
Paki Pal	Sab sy acha dor Gernal Pervez musharraf ka tha Karachi mai Allah Pak unhy sehat or tandrusti Ata farmaye Rangers Phr sy 1 baar hold kry Karachi ko Street crime buhat sy report he nahi hoty na police interested hai FIR Katny mai wo FIR katna badnami samjty hain Us Police Station ki Crime report kam hona kisi b city k liye acha nahi hai police asi honi chaiye k wallet chori py b FIR hosaky easily Sir sab hogya ab Education system or jo 2 3 point apny bataye hain drug addict k liye usky liye ap pressurize krain Sindh Government ko Karachi walo ko ab koi 1 relief package b milna chaiye Jobs milni chaiye Rangers Army and Police mai please do something about it Ahsas e memromi paida horhi hai Karachi walo k andr bybas feel krrhy hain Ab koi iska faida na utha lay issy phly do something about it sir humari buhat umeedain hain apsy hope you will get this msg
M,r riffat	Ho my god sochal medium kitna joota he
Hamza Ali	Pakistan zandbad Pak army zandbad Pak isi zandbad Pak RJR zandbad
Muhammad Wasay Nesar	Inki baton se lg rha hy KARACHI duniya ka sb sy aman wala sheher hy Bht acha laga sun ky
Class One	To proud my ISI
Ejaz Malik	Rangers great 👍 job
Shah Nawaz Dhumanvi	18 15 میڈیا کو شرم آنی چاہیئے
aslam qureshi	Yai Garnal Safeid Jhut Bol Raha Hei Es Ka Court Marshal Hona Chaeiyai
Khan Baba	تبديلي والو کی مہنگاہی اب سب حالات خراب کرے گی
zahid ali	love you Pakistan army and pak isi and pak Ranger
Salman Khan	Pak Army very good ❤️🇵🇰
Azhar	Gen sahib please first slap this ghadaar anchor he is one of those bullshit people who involves in propaganda and his channel ARY owner involves in money laundering
attaullah awan	Pak Rangers zindabad
tanweerahmed khan	👍
Javed malik iqbal	Good
soul not for sale	Pak Army we love you
Uzair Ali	Golden Words Muhajir ho sindhi ho pashtun ho koi b ho kisi b ilaqay m jannay say pehlay sochay na
Afzaal Kamboh	Good work
Abid Malik	D G RANGER ko program me dekh kar acha lga good
hujjat zaidi	Rangers Zindabad
Serious Shituation	The best of whole program wa at conclusion Love you Sir Pakistan Zindabad Pak Rangers Zindabad
Mighty VG	vote right vote kite
syed ali	Karachi just need 6 thing Improve Digital need such a Apps and secure website for Data collection in Civil insituitions Build Technical school fir Productive labor Build Rehab Centers Bring Health Card system or health insurance a state law Also to Build an Instituition for Labor institute which will do background check and Qualification of any person sccording to their posting to boost merit system And build Dawah center
Shazad Anwer	Kashif abbasi kiun jhut bol rahy hai Kon kartaa thaa program jab MQM power main thee aap ke etni oqaat there k aap naam nahy laytay thay kisis ka or har program main qatlon ko betha Kar puchty thay yeh qatil Kon hai jab k har bandhy ko pata hota thaa ba shamul aap k qatil aap samnay he baithaa huwa hai
i love Pakistan	یہ شہزاد ملک میں ہیں تو ملک کی طرف کوئی میلی آنکھ سے نہیں دیکھ سکتے ہمیں ہماری فوج آئی ایس آئی اور رینجرز پر فحر ہے we love you Pak army
Zain Khurram	Kahan hain patwari jo kethy hain khalai makhlooq kotty ka ka ky khud koty ho gy hain
Aamir Awan	Pervez Musharraf zindabad
Husnain Fahad	WOW Excellent show very sensible and well disciplined i really appreciate that it will help to clear to all confused perception to our beloved Armed force of Pakistan insha Allah Thank You ARY Digital and Mr Kashif Abbasi and to this show a well I really appreciate that honestly
kaleem saadat	welldone sindh ranger
RGGAAF FORUM	Good homework straight forward task deliver but nice pleasure person
m s	Speak with respect kashif bhai This is our beloved army❤❤❤
Adnan Orakzai	♥
Ali Khan	KASHAF ABASI AJ TUM NE JIS KUTTE KO APNE CHENAL PAR BULAYA THA EN KUTTOO KO APNE GHAR BULA KAR PORGRAM KYA KAR ARY KO KHRAB NA KAR
Sajid Ali	Amran khan zindabad ilove Pak army zindabad ilove Pak army zindabad
Muhammad Idrees	Wonderful proud of u sir proud of Pakistan army
Qaiser Khan	This is called professionism
Akhtar Rao	پاک فوج زندہ باد
Touseef Ashraf	Very sensible guy
Ejaz Ahmad	Pakistan Army zindabad
See Me Entertainment	Pak Rangers zinda bad
Dgff Dgg	شکریہ اے آر وایی 😘😘
Saqib Ijaz Saqib Ijaz	Pak army zindabad
Majid Khan	پاک فوج زندہ باد ۔ عمران خان زندہ باد ۔
imran Qaiser Rind Baloch	I Love Pak Army 💖💖💖💖 I Love Pakistan 💖💖💖💖 I Love Pak I S I💖💖💖💖
Saleem Noor	پاکستان رينجر زنده باد
Mahr Muhammad Kishwar Mahtab	Kashif Abbasi you must educate yourselves to this man
Aarish Khan	Sir aap great ho Please make karachi free of crime We appreciate your effort for bringing peace in karachi There are few incident happening here and there these day but we acknowledge that with your effort we have come a long way Thank you so much for the great work Rangers have done
AtiQ Mughal	Our security force Zindabad love u our gumnam hero
Ali Ali	PAK RANGERS ZINDAABAD ☺☺
Mohammad Rafique	Don t take My comment s a Granted With All MY DUE RESPECT
Muf G	رینجرز نے وہ کام کر دکھایا ہے جو کہ کراچی کے دہشتگردوں کے وہم و گمان میں بھی نہیں تھا۔ ایم کیو ایم، عذیر بلوچ اور ٹی ٹی پی کے دہشتگرد عناصر کو جس طرح ٹھکانے لگایا ہے اس پر پوری رینجرز کو ہلال پاکستان ملنا چاہییے۔
Asad Shah	GA SINDH RANGERS
Dr Samina Yasin Shaikh	Excellent today
jawad kahlil	Pak army zindabad
ASH FC WEAR	Pti mean Karachi m pak arm treat intelligent with them
Asad Khan	Thank you ranger i Salute Rangers to help Karachi for cleaning crime and Killing
sunnyhshaikh	One of the best program interview by Kashif Abbasi 👍🏻👍🏻👍🏻
Ahmad Imtiaz	Brilliant program What a gentleman with stats Maj Gen Mohammad Saeed RESPECT
Muhammad Zubair Aleem	3 3 3
Armaan Ahmad	Pak army is our heart and ISI is our heartbeat Pak army zindabaad ISI zindabaad IK zindabaad Pakistan paindabaad
Lionheart Jatt	video thumbnail ni acha
syed Masoom	پاکستانی میڈیا کا شرمناک کردار ہے
Panjtani video channel	Pakistan Rangers the grate four of Pakitan Rangers zindabad
Ahmad Sajjad	Very good program
Tayyab Kharoti	Zindabad pak army
Lلودھیانوی گجر مقبول	کرپٹ سیاستدانوں کی وجہ سے پاکستانی عوام کا بہت خون بہایا گیا انشااللہ یہ چور اپنے انتقام کو پہنچے گے
farhan ahmed	This wa the first time in last thirty year that karachities cast their vote without any forced pressure The Youth factor majority ha given edge to PTI in most constituency This is the change in the mindset of youth Our Parents always reminisced about the time when Karachi wa leading in all field such a education economy Youth of Karachi are the most affected by the violence a they have been brought up on fearful situation You are very Right DG sahib people will stand up and do their part keep eye on young generation where they go No violence any more we are with Rangers and police for the betterment of Karachi especially for maintaning this peace afater such a long time no more mafia and gangwar party
Nafees Ahmad	DG RANGER very calm cool Man I salute you sir
Faseeh Ullah	Masha Allah great to see Insha Allah peace will come again to all Pakistan 🇵🇰
Sunil Nayan	ہم کراچی والوں کو سب سے پہلے اس بات کا تعین کرنا ہے کہ ہمیں کون سا کراچی چاہیئے۔ وہ والا جہاں روزانہ دس دس لاشیں گرائی جاتی تھیں۔ ہر طرف خوف و ہراس تھا کسی نے مہاجر وں کے نام پر دادا گیری قائم کی ہوئی تھی تو کسی نے لیاری کو دبوچا ہوا تھا۔ کراچی کا ماضی 2013 ؁ء تک خوفناک تھا۔ مجھے اب بھی یاد ہے کہ ہم جب تک اپنے گھر واپس نہیں پہنچ جاتے تھے ہمارے والدین کی سانس اٹکی رہتی تھی۔ مگر اب صورتحال ویسی نہیں ہے۔ نہ تو عزیز آباد کے اطراف میں کوئی غنڈے ہاتھوں میں ڈنڈے لے کر کھڑے ہیں اور نہ ہی دوکانوں اور بسوں کو آگ لگانے کی کسی میں جرات ہے۔ یہ سب رینجرز کے ڈنڈے کی وجہ سے ہوا ہے۔ اگر رینجرز نہ ہوتی تو آج حالات اس سے بھی بدتر ہو چکے ہوتے۔ گینگ وار اور ایم کیو ایم کے غنڈوں کو کسی کا خوف یا ڈر ہے تو وہ صرف رینجرز ہے۔ ہماری تو دعا ہے کہ رینجرز ہمیشہ کراچی میں رہے تاکہ غنڈہ گردی اور بدمعاشی سے ہماری جان بچی رہے
Sabiha Shah	Allah Pak Pakistan ki hifazat farmaye or Zardaari Nawaz Shahbaz or Malik Riaz ko gharat karay ameen
Rana Arslan Amazing Videos	Very good medium ki asi ki tesi kar di sir a na plz medium be responsible
Atiq Ahmed	Rightly pointed out I am common citizen of Karachi resident of Nazimabad i am concerned about the terrorism target killing Kidnapping what not Karachi witnessed during last few decade of unprecedented violence a surge in ethnic based violence killed hundred and adversely affected the economy a well a the daily life of the resident of Karachi One Call All Closed But now Thanx God social and economic activity have been rejuvenated strong in Karachi since restoration of peace and i must say it due to Rangers You take Rangers away from Karachi and the city will plunge into anarchy again
Muzaffar Ali	عمران خان زنداآباد پاک فوج زنداآباد
FOOLITICAL KHAN	Mashallah the bestest show of Kashif
Am Abbasi	It s good to see point of view from law enforcement Agencies PakistanArmy 😍 LongLiveImranKhan 😍 LongLivePakistan 😍 LovePakistanISI 😍
MUHAMMAD HANZALA	Pak army zindabad
Zaheer Ul haq	We are proud of Pakistan Pakistan Armed force Inter Services Intelligence Military Intelligence and Imran Khan We have total confidence extreme respect love from the core of heart and know all these are the defender of our dear homeland Those who are against these Pakistan defense establishment institution are enemy like India America etc
Dilawar Khan	come to panjab
Abdul Qadir Memon	1985 se 2013 tak 92000 log mare Gaye Karachi me 🦍🦍🦍🦍🦍🦍🦍
Noor saba	PAK ARMY Zindabad ❤❤❤
Khushal Khan	We really proud of our army ranger
Qamar Adeel	Pakistani medium is on payroll of India Afsos ki baat hai indian medium ko kabi nahi suna esa jo pakistani medium krta hai Ese medium se behtar hai sab channel band kr doye jayein
Rashid Mehmood	اللہ پاک پاکستان کی اور ہماری فوج کی ہر دشمن سے حفاظت فرمائے آمین
XULQI MOON	Great show and well explained by General sahab Thanks to agency Rangers and everyone who sacrificed for this
shakir shakir	i love pak armi
Babar Hussain	رینجرز پولیس آمن کی شان
Gulab khan	آب بدلے گا پاکستان ان شاءاللہ تعالیٰ وہ ہوگا نیا پاکستان،⁦🇵🇰⁩⁦🇵🇰⁩
naseer awan	Great program
Mashood Abbasi	Many quote
Gujjar Hasan	1st Time in past few month This Program Enjoyed well and Mind Is Peacefull Ranger Pakistan Army Pakistan Zindabad
Shahzad 1	Pak army pak isi zindabad 🙌🙌🙌🙌🙌🙌🙌🙌
Sahil Shah	Humari agency aur army pe pura barosa hai 💖💖💖💖 i love pak army and isi 💚💚💚
malik shahzad Latif	مجھے فخر ھے اپنے سچے اور کھرے عظیم قائد عمران خان صاحب پر
Parking Wala	Kashif abbasi app k tassub muhajero k khelaf app ko battoo se tappak raha he kiya srif mqm the kiya ppp or anp amman ki fakhta the
Muhtaram Khan	Pak army zandabad ham badmashyio ko takanay lago baray baray magar machoo ko pakrna hay our takanay lagana hay
Aftab Ahmed	Police ko bhi renjerz ka uniform dedena chaheye takay awam ka kuch aitmad police per bhi bahal ho 😂😍🙏
Tanweer Qureshi	I am used to of Kashif Abbasi s irrelevant show always inviting lafafa journalist and politician who try to protect the corrupt Sharifs but today he ha surprised me doing this different kind of and informative show I think for a moment he ha realized that Lafafa money is not everything
Mirjee Obaidurrahman	Database banya ki na ha
Nasir Afridi	Great job ranger We proud of you
Hassan Khan	That s not fair sir I know k aap ny bohat acha kaam kiya hai karachi mei but apko sab k against khul kar answer krna chahye jese Altaf Hussain ar Hammad Siddiqui k question pr answer kiya wese hi Uzair Baloch Sharjeel Memon ar Asif Zardari k barey mei bi jawab dena tha jo aap ny nahi diya gol mol kr diya Ap k is attitude ka hi faida uthaati hai MQM london ar muhajirs k dilon mei nafrat ki aag lagati hai against Pak force kindly ghour karen meri baat py k me kya kehna chah raha hon apki personality neutral honi chahye blkul q k ap hmarey muhafiz hain bt i m sorry to say is interview mei apka role bilkul biased tha Jazak Allah Pakistan Zindabad Pak Fouj Paindabad
Nabeel Ishtiaque	Love u paaak fouj
Danny Boy	Why this lannatti makroo munafiq chor liar mian Nawaz Sharif his lannatti makroo daughter a chor liar maryam safer butt is out of jail Lannatt on the lannatti justice system of Pakistan
Farooq Ali	Farooq ali
Zakir Zia	is mai koi shaq nahi k 2008 se 2013 tak ham karachi walo ne bhot kuch face kia hai itna kuch dekha hai k batate hoye bhi khoof ata hai ranger ne karachi ko saaf kia ye inka ehsaan hai jabhi ham chlate phir inko salute marte hain bhot bheter ho chuka hai karachi ab mager abhi bhi bhot kuch baki hai wo jab tak nahi clear hoga jab tak sindh se bhuttu nahi marega MQM se ziyada karachi ko ppp ne barbad kia hai or aj tak kar rahi hai MQM bhi shamil hai mager ppp se kam hai bhuttu marega tu hi sindh or karachi mai khushali ayegi
Babar Kala	Good💪
Oz Ahmed	Beautiful uniform and a beautiful man I am so proud that we have such a wonderful and professional army By the way ISI is the top intelligence agency in the world Take that James Bond
Nabeel Khan	Thank You Rangers ❤
shanaz shahid Shahid	Ham apni fouj per fakher kertay hain aur aur buhat respect kertay hain Allah isay hamaisha shandar kamyabi de
Thunder Bolt	Wah To the point baat karte hain or kia andaze guftagu he DG sahib ka Kashif bhai super like always
VA 3584	target internal badhmashia
faisal zeeshan	Love ypu General Shab LOVE PAK ARMY
LD TEK	With respect Rangers officer sahib in ur deptments lot of officer and police high officer are corrupt As they take big bribe and let the criminal go free most of S H O and above DSP not all of them but majority of them involved in corruption and they organise crime even now police are under influence
masood mustufa	Kashif abbasi itnay pyar tamez sabar o tahmul sy siyasat dano ka b interview lay lia karo
Shahid Mahmood	Pak ranger zindabad
MALIKK4You	Salute You Sir
fahid sultan	Welldon sir Love pak army pak ranjir isi and all ccurte forsess good job Allah ap sub ka hamio nasir ho ameen
Emad Hyder	IloveyouISI😘😘😘😘😘 IloveLEAP😍
Muhammad Madni	love to all law enforcement agency of PAKISTAN
Khalid Baloshi	Nice show sir
imran shah	Really happy to listen all this a a citizen of Karachi Pakistan karachi police couldn t change ever they are like a poison for citizen of Pakistan
Musa Afghani	pak Army zindabad
kamran	Pak ranger zindabad
Shahnawaz Qazafi	اس پروگرام سے یہ ثابت ہوتا ہے کہ پچھلے پانچ سالوں سے کراچی کے بارے میں غلط پروپیگنڈہ کر کے پیپلز پاڑی کو بدنام کیا گیا
Rameez Ali	Very calm and definitive answer Very good analytically correct I support Karachi operation Well done paramilitary force
M k	عمران خان 👍❤ پاک افواج آئ ایس آئ زندہ باد پاکستان پاہندہ باد
Azhar  Abbas	Well done sir we love you Pak army zindab Pakistan paaindbad
jamshaid ali	Pak army zindabaad
Anas Ahmed	karachi operation mai ranger ka kirdar qabil e tareef hai ki terhan mehnat se lagan se karachi mai itne kum arsay mai aman layaye hain yeh baat yaqeenan qaabil e tareef hai we salute GEN raheel shareef gen bilal akbar and now gen muhammad saeed
Raja Nadeem Hamayoon	After long time I observed an outclass officer with dashing personality and smiling face responded all query properly and accordingly Long live Pakistan and Pak Army
shabbi ali	Interesting interview start from 40 45 to own word Altaf hussain Karachi ayen gay Rangers unhy arrest kary gi Ran Yes Kashif Phir tu wo na hi ayen pakistan hahaha
Asad Korai	Better than any spokesperson
Aftab Shah	My pride and my proud my pak army force
ABU UMAR	پاکستان آرمی زندہ آباد
traila quarter ton	19 25 lanat hai is ghaddar medium pe jo is mulk ko sari dunya mein badnaam karta hai
mohammad akhtar	ALLAH Pakistan ko aur Army ko salamat rakhay
Sajjad Ali	Pak army zinda baad Pakistan painda baad
Ahmad Hassan	بانوے ہزار قتل اوہ خُدایا اتنے تو جنگ میں نہیں مرتے کون ذمہ دار ہے؟؟؟کون جواب دے گا؟؟؟؟؟ یہ تمام ایم کیو ایم کے قیام کے بعد ہوا کس نے قائم کی ایم کیو ایم اور کون تحفظ دیتا رہا ایم کیو ایم کو کیا کبھی وہ احتساب کے کٹہرے میں آ ہیں گے؟؟؟؟ یا یہ تمام وہ بچپن کی کھیل کی طرح ہے ؛ہاتھوں سے بناؤ پاؤں سے گراو اور کرتے جاؤ ۔۔۔
ALi QurEsHi	ارے یہ سب یہ خود حالات خراب کرتے اور خود ہی حالات اچھے کر دیتے ہیں کون نہیں جانتا 25 سال سے دمک کی طرح چاٹ رہیں ہیں ابے بھائی جاؤ بیرکو میں تم جاؤ کراچی سے حالات خود ہی سہی ہوجاگے الطاف حسین نے کی دفع بولا ھے ک جاؤ کراچی سے جب سے دوسمن بنے ہے یہ کچھ نہیں کر رہے بس مزہے کر رہی کاروبار کر رہیں جاؤ بھائی جاؤ کراچی پر اور کراچی کی عوام ہے تراش کہو اپنی ہی عوام کو مارتے ہو شرم نہیں آتی قاتل ہو تم لوگ
Alex Stuttgart	عمران خان زندہ باد پاک فوج زندہ باد پاکستان زندہ باد 👍✌🇵🇰
Shakil Gujjar	Good program 👍
sprinterz777	One of the best episode of off the record program So calm cool and composed personality of DG Rangers Very articulate answer Complete knowledge and grip on the subject I salute you Sir for your great service to Pakistan and Karachi
Naim Malik	Salute to our arm force and thnx to Kashif for inviting Sir Watching u lot from uk 🇬🇧 London love 💕 and respect ✊
I.m.Pakistan Pakistan is Ours	I must say Kashif s way of asking question is quite illiterate manner He must observe who is sitting in front of him He is behaving like he is talking to political spokesperson instead oF DG RANGERS
Aijaz Hyder	Pakistan Ranger is good working I proudly Pakistan Ranger zindabad
sarfraz shakeel	I love ranger 2013 to 2018 ousum duty in karachi
Shah Jahan	the most ethical debate in medium history I had never list seen before that it wa very calm and polite conversation every issue wa explained with statistic well done sir dg ranger credit go to Pakistan military that feel proud u on our professional Pakistan Army love you Pakistan army❤ long live Pakistan❤❤
Choudhary Tanveer	I love Pakistan Armey
Baharti are dogs	PAK RANGER ZINDABAD PAK MEDIA MURDAB yi ghaleez kay aulaad apnay rating kay waastay sab koch jhooth dikha rahay thay yi laanti medium
Riz Riz	By that interview I can say karachi is in rebuilding phase Many more good year to come inshallah Loved the way he concluded the interview
Jehangir Shah	Mashallah Jarnel sab ap ko haq hasil he k ap jarnal ka rank mele pak army zinda bad
Asmat Bajwa	پاک آرمی سٹاف زندہ باد
laila khan	Malik Riaz pe b program Karo u k case hearing Q nai dekhai jaati Malik Riaz pe medium Q khamosh he Kia Malik Riaz ne apko bheyria town mein Ghar de dia he Kiya Ary humara proud he Geo news lafafi TV he plzzzzzzzzz Malik Riaz pe b program kare plzzzzzzzzzzzzzz
Awais. Muhammed	Thanks Pak Rangers
muhammad sulaiman	Rangers wahan pe rehna chahtay hain is leye ye sab horahahai
Abdul Khan	I would to give a big salute to our Rangers for protecting the poor people of Pakistan
Truth Bitter	ARY tou army ka tatto hai hi hamesha see
Asar Ali	I think Kashif Abbasi should work on his question before programme start Some of question sound controversial about politics which he shouldn ’ t ask
M Sidd	pakistan army itself make terrorist and use them against each othet
smart baby	boht arsy baad show dekha ji mein chikny waly nhi thy and salute to our RANGERS on his performance ALLAH PAK or taufeeq dy aap ko
ehsen zain	i love you sir PAK Rangers zindabad
Farhat Kan	پاکستان رینجرز پاک فوج چیف جسٹس ساقیب نثار صاحب عمران خان صاحب PTI زندہ باد
DEEPAK SINGH	Isase puchho ki kya ye bhi 1971 ne surrender hua tha
Saeed Kamran	Salute to OUR FORCES INTELLIGENCE AGENCIES
Raina Khanum	I can not believe I m seeing DG Ranger on a current affair programme 🙊🙈🙅
Hazrat Sher	Highly appreciated dg ranger Saab and kashif abbasi Saab fair honest truth and heart touching discussion without any blame we are proud on our security agency
starmooono	Wow What a presentation Wow Speaking power with crystal clear figure Liked the man Bravo Well done Keep it up Watched Thousands of talk show Impressed with the great advocacy and level of our force
TK	East or west rangez r best 4 karachi
k kamran khan	Islam zindabad pakistana army zindabad
Jeroo Lhr	Mashallh Good Saqib Nassar
salman manshahi	Zindabad DG ranger
Fahim Fahim Patni	Maza aagae sunkar
UMER SHEHZAD	Dear Stupid Kashif this is the most senior General in the Pak Ranger How badly way of talking
Ali Asghar	Zinda bad
Ajaz- Kashmir Baney Ga Pakistan Insha Allah !!!	Masha Allah Pak Rangers and Pak Armed Forces are the best we are proud of them they are our shining star Long Live Pak Armed Forces Pakistan Paindabad
Imran Siyal	Good army
Zafar .Cheema	Pak army Ranger Police zindabaad P T I zinda baad Pakistan painda baad 😘😘😘
Yousuf Muhammadi	❤️🇵🇰
Muhammad Abbas	Dg ranger sb Allah tallah ap ko salmat rakhey ap Pakistan k hero h
Adeel Ahmad	Kashif bro this is ur best show according to my point of view we are the proud of army
farooq shaikh	It is planned programm it will later appear the outcomeis it going to governor roll now
Zubair Ahmed	Good program
mehmood zafar	کاش ہمارے ملک کا کوئی سیاستدان بھی اس طرح عوام کو بریف کرتا۔
Syed khalid Hussain	In loogon k barai mai asal propogenda News One walai kartain hain
Noma Waqar	Pak army zanda baad
nighat majeed	Excellent Kashif your question are straight forward
Saeed Khan	good prog
Tamzid Karim	Car snatching street crime and kidnapping these can not be completely eliminated until the police is being reformed top to bottom Rangers can play a supporting role for the police if and when required but not more than that Afterall it not the primary job of ranger to counter these criminal activity Rangers is no doubt effective against terrorism Militancy the type of which Karachi wa facing Political party related terget Killings but below these it the job of police to counter the criminal activity being discussed
khalid mahmood	Bastard altaf hussain
Muhammad Fayyaz	Obviously Sir Credit go to Pakistan Rangers
Jawwad Saeed	Lol Kashif Now army is responsible for petty crime Why is an Army officer sitting there discussing ransom kidnapping extortion instead of police chief Are you giving a message we should close our police station
Waris Zaman	good program today
Husnain arif	Amazing yar aj Pata chala Hamari phohj no 1 kaysay focus archeiment and goal
Amaan Ali	Pak Rangers Zindabad
Umar Akbar	پاک فوج زندہ باد پاکستان زندہ باد پاک آ رمی زندہ باد جنرل باجوہ صاحب زندہ باد عمران حان زندہ باد انشاءاللہ جس طرح کراچی پرامن ھوا ھے ایک دن آۓ گا سارا پاکستان پرامن ھو جائے گا انشاءاللہ آھستہ آ آھستہ حرامی لوگ پکڑے جا رھے ھیں پاکستان پر امن حو جائے گا ھم کو اپنی فوج پر فحر ھے اور مجھے پاکستانی ھو نے پر میری فوج دینا کی نمبر ون فوج ھے آ ئی لو یو پاک فوج پاک فوج زندہ باد
Muhammad IQBAL Greece	Pakistan army zindabad 🇵🇰🇵🇰🇵🇰🇵🇰
Awallla Awallla	Niec g
Javed Chughtai	Sahi banda sahi seet pr
Tanveer Azher	Great and intelectual discussion Actually both personality are graceful but army personal s attitude wa awesome Real professional attitude Thanks
I A	Great well done Pak Rangers 👍👍👍
ahmed malik	Ranges zindabad
Paigham hai ISLAM	Kashif Bhai pls manshiyat per bhi qabo payen Karachi Mai har teesra shaks drug leta hai chotay chotay bachay peetay hain
Naim Ulla	g o
Altaf Hussain	Pakistan Rangers zinda abad
Muhammad Khalid	General Sahib Zinda Bad Best Info displayed in best possible way Very good I have no word to appreiciate your presentation very very well done Such lecturer exist in Pak Army Waoooooo
Abubkar Jutt	Pak army zindhabad
virk A	Sirf meri jaan
shamo najib	Pti zindabad
high sky	Sulman iqbal mother fucker im seeing ad after each minute why u bitch always hungry for money i wa excited to watch this program but coz of ur greedy policy now leaving your channel
Jani Khan8	So nice PTI 💑 💏😘 😘👏 👏💪💪💪 💝💟💯 🏃✌ ✌✌
shahkar bhutta	Great kashif bhai Allah pak apko izzat dy
Arfan Ali	Pakistan zindabad and chief justice zindabad and pak Armey zindabad
Aamir saleem	I love pk isi army pm jc
Mirza Sheraz Baig	Zabardast
#pothwar	Media ko false news deny py danda dya jae to pakistan bilkul sedhy track py chal pary ga
Asad Aaghar	Aj tak ka sab se acha show tha great abasi saheb dafa kro siasat dano ko program me bulany ki zrorat nhi he esy program kia kro pls
usman ali	plz kashif abasi for a country best intrest ap koi b difficult question mat kare BALY AP PAKISTANI IMAGE KO PROTECT KARE THANK YOU
ahmed khan	Salute to pak ranger 🙋‍♂️
mughal Obaid	Pak army love u
mani shani	general sb sa lute hai apko ALLAH PAK ap logon ki hifazat karay
Nasir ali	Very nice Program of the year
Mister Subhani	EXCELLENT JOB PLEASE MEDIA MUST DO THIS KIND OF SHOW NOT POLITICAL GARBAGE SHOW PEOPLE S ARE SICK FROM IT
Ashan jameel	apka bht bht shukriya humae apna pur aman karachi dene ka😍😍
Shahzaib Aziz	پاک فوج پاک رینجرز کو سلام
Israr Israr	پاکستان آرمڈ فورسز زندہ باد
Ahmed Khan	love pti love pak army
Faisal Qayyum	long live ranger
AK NIAZi	Isi ko economic terrorist ka pecha kerna chaye
Muhammad Tahir	PAK ARMY ⚘✌⚘💚 PAK ARMY⚘✌⚘💚⚘👍
Minion Wolverine	Difference between a political spokeperson and a military spokeperson Long live pak army Long live ranger Zaradari sharifs altafs maulanas murda baad
ch junaid zahid hussain	Walikum salaam Boht Ala I love my Pakistan 😘🌷😘 I love 🇵🇰 Army
Fsdabad 595	ماشااللہ بہت محنت سے کراچی سے صفائی کی ہے، اللہ تعالی ہم سب حفاظت فرمائے، آمین
Tahir Tahir	Pakistan army love you
Shafaqat Ali	Pak army zindabad but nawaz dakoo Choor zardari ko pahnsi do
Pak Zindabad	ranger zindabad
Sameer Ali Ali	💪💓
FATA PuKHT00N	امریکہ افغانستان سے بہت جلد واپس جارہا ہیں ۔جس پر افواج پاکستان کا ایک بیانیہ سامنے آیا ھے کہ افغانستان میں مکمل امن تک امریکی فوجیوں کو افغانستان میں رہنا چاہیے ۔بہت سے لوگ اس بیانیے کی حقیقت کو نہی سمجھ پائے ۔ آج میں آپ کو اس کے بارے میں وضاحت دینا چاہتے ہیں دراصل امریکہ ایک گہری پلاننگ کے تحت افغانستان سے نکل رہاھے امریکہ نے بہت بڑی تعداد میں افغانستان کے اندر داعش اور بلیک واٹر کو جمع کیا ھے اور ان کی مدد کے لئے ان کے ساتھ ان کی خفیہ ایجنسیز کے لوگ بھی موجود ہے دسمبر 2017 میں امریکہ نے بلیک واٹر اور داعش کے ساتھ ایک سمجھوتہ کیا ھے جس میں پہلی بار بلیک واٹر نے امریکن کو یہ کہا کہ ہمیں جنگی جہاز اور طیارے چاھیئے پاکستان کے اوپر حملہ کرنے کے لئے کچھ عرصہ پہلے ہی داعش نے اپنے خصوصی گروپ میں یہ اعلان کیا تھا کہ بہت جلد ہمارے پاس جنگی جہاز ھوں گے ۔ یہاں ھم آپ کو یہ بھی بتانا چاہتے ہیں جتنی جلدی پاکستان کو اپنے بارڈر پر باڑ لگانے کی ھے اس سے زیادہ جلدی امریکنز کو افغانستان سے نکلنے کی ھے ۔ امریکنز کے افغانستان سے نکلتے ہی پاکستان کے اوپر حملوں میں۔ شدت اجائیگی ۔کیونکہ ایک تو الزام امریکہ پر نہی آئے گا دوسرا امریکہ جو طیارے اور ہیلی کاپٹرز جاتے وقت افغانستان فورسز کو دے کے جائیں گے وہی طیارے اور ہیلی کاپٹرز تک رسائ بلیک واٹر کی ھوگی ۔ اور اس کام ان کے ساتھ انڈین بھی شریک ھوں گے پھر اپکو یہ خبریں بھی سننے کو ملیں گی کہ دھشت گردوں نے افغان فورسز کے ہیلی کاپٹر یار طیاروں پر قبضہ کر لیا ھے اور پھر انہیں قبضہ شدہ طیارے یا ہیلی کاپٹرز کے ذریعے پاکستان کے اوپر حملہ کیا جائے گا یہ سب کچھ امریکہ کا پلان کیا ھوا ھے بجائے اس کے کہ ھم امریکن کو افغانستان سے نکلنے پر خوش ھوں ہمیں اس بات کے بارے میں سوچنا چاہیے کہ ھم دوشمن کی اس جنگی حکمت عملی کو کیسے ناکام بنا سکتے ہیں یہاں پر میں صرف یہ کہوں گا ۔kill your enemy before he kill you میرے خیال میں یہی بہتریں حکمت عملی ہو سکتی ھے کہ بجائے اس کے کہ ھم انتظار کریں کہ کب ھمارا دوشمن ھم پر حملہ اور ھوگا اس سے پہلے ہی ھم اپنے دوشمن کو ختم کرتے ہیں یہاں میں آپ کو یہ بھی بتادینا چاہتا ھوں کہ دوشمن کی اصل ہدف پاکستان کو ڈی سٹیبلائز کرکے پاکستان کی ایٹمی ہتھیاروں کو اپنے قبضے میں لینا ھے اور انشاء اللہ ایسا کھبی بھی نہی ھوگا لیکن دوشمن ہمیں بہت ذیادہ نقصان پہنچا سکتا ہیں اور اس کے لئے ہمیں مضبوط منصوبہ بندی کرنی ھوگی ۔ ۔۔۔۔۔۔۔اللہ پاکستان کا حامی و ناصر ہو ۔س۔۔ ۔۔۔۔۔۔۔امین ثم آمین 🤲🤲🤲🤲🤲🤲
Akhtar Akhtar	Very Good Ranger
Daud Bhatti	Humary gaon ka Hero
Ali jan afridi	ایم کیو ایم کا جب تک کراچی سے مکمل صفایا نہ کر دیا جائے تب تک کراچی کا امان کسی دیوانے کا خواب ہی رھے گا
Usman Hameed	Imran Khan k patner han mqm waly ab to check post khtm Hun gii
Jani Ajmal	Pak Army zindabad You are our National heero
faisal jameel	I LOVE YOU PAKISTAN I S I
Jamal Jay	Gen sb 👉 bravo pak army zindabad better than police
mudassar zareef	Pakistan 🇵🇰 zindabad pak army zindabad imran khan zindabad
Shah zain	ایک زوردار نعرہ لگانا چاہتا ہوں دشمنوں کو بتانا چاہتاہوں پاک فوج اورآء ایس آیس زندہ باد
Hina Niazi	Pakistan pak army isi long live may allah bless you 👍👍👍🙂🙂🙂🙂🙂
mario khan	عمران خان زندہ آباد ۔۔۔۔ پاک فوج زندہ آباد ۔۔۔۔۔۔۔
m sohail	Long live Pak army 🇵🇰
Ariba Qurban	Nice show Pakistan army zindabad
Sharu Minie	Waiting for today s program
