Prashanth Prashanth	Super Mallanna
Telugu Knowledge	Kcr okkade tagutadara howle badkav prathi okkadu tagutadu
Gaddam sai	kcr nijaswarupam chupincharu
Shiva B	Mallanna alias MLA
Hajee Shaik	Super
Anilp Anilp	‡∞Ö‡∞®‡±ç‡∞® ‡∞®‡∞ø‡∞ú‡∞Ç ‡∞¶‡±ä‡∞∞ ‡∞∏‡±ç‡∞µ‡∞≠‡∞æ‡∞µ‡∞æ‡∞®‡±ç‡∞®‡∞ø ‡∞ö‡±Ç‡∞™‡∞ø‡∞Ç‡∞ö‡∞æ‡∞∞‡±Å ‡∞Ö‡∞®‡±ç‡∞® ‡∞®‡∞æ‡∞°‡±Å ‡∞¶‡±ä‡∞∞‡∞≤‡∞æ ‡∞™‡∞æ‡∞≤‡∞®‡∞≤‡±ã ‡∞Æ‡∞® ‡∞§‡∞æ‡∞§‡∞≤‡±Å ‡∞§‡∞Ç‡∞°‡±ç‡∞∞‡±Å‡∞≤‡±Å ‡∞é‡∞®‡±ç‡∞®‡±ã ‡∞ï‡∞∑‡±ç‡∞ü‡∞æ‡∞≤‡±Å ‡∞™‡∞°‡±ç‡∞°‡∞æ‡∞∞‡±Å ‡∞é‡∞™‡±ç‡∞™‡∞ü‡∞ø‡∞ï‡±à‡∞®‡∞æ ‡∞¶‡±ä‡∞∞‡∞≤‡∞æ ‡∞™‡±ã‡∞ï‡∞ü‡∞æ ‡∞Æ‡∞æ‡∞∞‡∞¶‡±Å ‡∞Ö‡∞¶‡∞ø ‡∞è‡∞∞‡∞Ç‡∞ó‡∞Æ‡±à‡∞®
Shiva Kumar	‡∞Æ‡±Ä ‡∞ó‡±Å‡∞¶‡±ç‡∞¶‡∞≤ ‡∞¶‡∞Æ‡±ç‡∞Æ‡±Å ‡∞â‡∞Ç‡∞ü‡±á ‡∞ü‡∞ø ‡∞Ü‡∞∞‡±ç ‡∞é‡∞∏‡±ç ‡∞®‡±Å ‡∞ì‡∞°‡∞ø‡∞Ç‡∞ö‡∞Ç‡∞°‡∞ø ‡∞ö‡±Ç‡∞¶‡±ç‡∞¶‡∞æ‡∞Ç
Ashok Dornala	‡∞é‡∞µ‡∞∞‡∞ø ‡∞Ö‡∞≠‡±Ä‡∞™‡±ç‡∞∞‡∞æ‡∞Ø‡∞Æ‡±Å ‡∞µ‡∞æ‡∞∞‡∞ø‡∞¶‡±Ä ‡∞∞‡∞æ ‡∞Æ‡∞≤‡±ç‡∞≤‡∞ø‡∞ó‡∞æ
Mahendar Borigam	super anna prastutsm kcr same
L C Ravi	Super malanna
Pavan Krishna	Exact imitation of kcr very well done
Geetha Lakshmi	Super story and direction
Sharadha Yerragunta	Ne mokam Kcr loin ra
Sravan SANNAILA	‡∞Æ‡∞∏‡±ç‡∞§‡±ç‡∞ó‡±Å‡∞Ç‡∞¶‡∞ø ‡∞Æ‡∞≤‡±ç‡∞≤‡∞®‡±ç‡∞®
Naveen Koram	Super super super nijamaina rajakiyam idhi chusena kontha mandhi mari ardham chesukunte Chala baguntadhi
k Narayana	kcr
Mahipal Reddy	Kiraak direction and good performance by Kcr character
Paparao gidde	Xlent xlent Bro
jai organic	Super
ellasaram gangadhar	Anna super
Nageshwar Rao	Super
dutta shiva	üëçüëç
santhu romala	Perfecte kcr character
Vijaya Gudep	Lovely video what a creativity this video will create record in YouTube will impact upon the December 2018 election
purra babu	Super video
Srinivas Putta	‡∞ï‡±Ü‡∞∏‡∞ø‡∞Ü‡∞∞‡±ç ‡∞®‡∞ø‡∞ú‡∞∏‡±ç‡∞µ‡∞∞‡∞™‡∞æ‡∞®‡±ç‡∞®‡∞ø ‡∞ï‡∞≥‡±ç‡∞≥‡∞ï‡±Å ‡∞ï‡∞ü‡±ç‡∞ü‡∞ø‡∞®‡∞ü‡±ç‡∞ü‡±Å‡∞ó‡∞æ ‡∞ö‡±Ç‡∞™‡∞ø‡∞Ç‡∞ö‡∞æ‡∞∞‡±Å ‡∞á‡∞ï‡∞®‡±à‡∞®‡∞æ ‡∞à‡∞™‡±ç‡∞∞‡∞æ‡∞Ç‡∞§ ‡∞™‡±ç‡∞∞‡∞ú‡∞≤‡±Å ‡∞Æ‡∞æ‡∞∞‡∞æ‡∞≤‡∞ø
pavankumar sayam	Super mallanna
instrumental music	Hai
rainbow digital	‡∞Æ‡∞® ‡∞∞‡∞∏‡±ç‡∞ü‡∞±‡∞Ç ‡∞µ‡±Ä‡∞¢‡±Ä‡∞™‡±ä‡∞á‡∞®‡∞Å‡∞™‡±ç‡∞™‡±Ç‡∞¢‡±Å ‡∞Æ‡∞æ‡∞ï‡±Å ‡∞π‡±à‡∞¶‡±ç‡∞∞‡∞æ‡∞¨‡∞æ‡∞¶‡±ç ‡∞ï‡∞æ‡∞µ‡∞æ‡∞≤‡∞ø ‡∞Ö‡∞®‡±ç‡∞®‡∞æ‡∞∞‡±Å ‡∞Ö‡∞¶‡∞ø ‡∞≤‡±á‡∞ï‡∞™‡±ã‡∞§‡±Ü ‡∞Æ‡±á‡∞∞‡±Å ‡∞é‡∞Ç ‡∞™‡±Ä‡∞ï ‡∞≤‡±á‡∞∞‡±Å
bobby murty	good effort gud
vamshi naik	miru chesina e video ki me dhairyaniki hat off
sap server access in hyderabad	extra ordinaryy
Babu Sri	Real story
Kanakam Anil	Kcr palana gadila palana
Mallesh K	‡∞ö‡∞æ‡∞≤ ‡∞¨‡∞æ‡∞ó‡±Å‡∞Ç‡∞¶‡∞ø ‡∞ï‡±Ü‡∞∏‡∞ø‡∞Ü‡∞∞‡±ç ‡∞®‡±Ä‡∞ú‡∞æ ‡∞ú‡±Ä‡∞µ‡∞ø‡∞§‡∞Ç ‡∞á‡∞¶‡∞ø ‡∞∏‡±Å‡∞∏‡∞ø‡∞®‡±ã‡∞°‡±Å ‡∞ï‡±Ü‡∞∏‡∞ø‡∞Ü‡∞∞‡±ç ‡∞ï‡±Å ‡∞ì‡∞ü‡±Å ‡∞µ‡±á‡∞Ø‡∞°‡±Å ‡∞ú‡±à ‡∞§‡±Ü‡∞≤‡∞Ç‡∞ó‡∞æ‡∞£
Victorious	December 11 tarvata nee talla ekkada pettukuntav chuddam KCR the great malli KCR CM pakka meeru antha yentha negative chesta antha strong TRS avuthundi mee walla kadhu ra ainani dimpadaam
bore raghu Raghu	Real
prasad gollapelli	‡∞Æ‡±Å‡∞∂‡∞Ç ‡∞∂‡±ç‡∞∞‡±Ä‡∞®‡±Å ‡∞Ö‡∞®‡±ç‡∞®‡∞æ ‡∞Ü‡∞ï‡±ç‡∞ü‡±Äo‡∞ó‡±ç ‡∞∏‡±Ç‡∞™‡∞∞‡±ç
mainam yellesh	Em ayyindi anna any problem Episode 3 enduku thesesaaru
srinivas badargama	Episode 3 emindi anna
Shasshank ss Shasshank	What is this bathala poshety part 3 YouTube lo nuchi tisivesaru
Omewar Dattu	Superb
S N	Kcr ni target cheyi but dhoralu ani chupinchaku ok ma cast lo chala mandhi manchi pedha vallu unnaru
Rajesh Katakam	Excellent acting nd directing
Gundagani Ashok	Part 3 Epudu
madhu kiran	Ayithe ikkada 12mandhi narsi Gallu unnaru
Waseem Mohd	super anna
ravi kumar	Mallana after election chudaam evaru dero evaru dongoooo
Mallesh Chittanoori	Nice compliment Anna
Raju Pandu	Superb Brother nice video Same to Sam k c r now Out t r s Rip
chinni Bhukya	Superb talent
Kiran1997 Kiran	Super dairection
Manikonda Shashi Kumar	This is congress mark politics since 70 year some slave of Reddy Dora will make such fake and false interpretation just wait for five more year world will know what is kcr
Bandari Ganesh	Telangana ragastalam
manthena prakash	Vori malliga neku avasararamara
Shiva SS56	Super anna
gaddam mahesh	same ma urlo kuda 100 elage jarigindi eppudu kuda local election alage untunnayi kani prajalu hushar ayinaru
sreenivasa rao	Smoking is injury to health director yewadu in tha public ga E galiz program thistara Thu
Chandrashekhar Vallimpula	Edhi nijam
Ram Mohan S	‡∞ï‡∞≤‡±ç‡∞µ‡∞ï‡±Å‡∞Ç‡∞ü‡±ç‡∞≤ ‡∞¶‡±ä‡∞∞‡∞µ‡∞æ‡∞∞‡∞ø‡∞®‡∞ø ‡∞á‡∞Ç‡∞§‡∞ó‡∞æ ‡∞∏‡∞Æ‡∞∞‡±ç‡∞§‡∞ø‡∞Ç‡∞ö‡∞æ‡∞≤‡±ç‡∞∏‡∞ø‡∞® ‡∞Ö‡∞µ‡∞∏‡∞∞‡∞Ç ‡∞â‡∞Ç‡∞¶‡∞æ ‡∞ï‡∞∞‡∞Ç‡∞ü‡±ç ‡∞Ö‡∞Ç‡∞ü‡±á ‡∞§‡±Ü‡∞≤‡∞ø‡∞Ø‡∞®‡∞ø ‡∞≤‡∞ï‡±ç‡∞∑‡∞≤ ‡∞ó‡±ç‡∞∞‡∞æ‡∞Æ‡∞æ‡∞≤‡∞ï‡±Å ‡∞ï‡∞∞‡±Ü‡∞Ç‡∞ü‡±ç ‡∞á‡∞ö‡±ç‡∞ö‡∞ø‡∞Ç‡∞¶‡∞ø ‡∞é‡∞µ‡∞∞‡±Å ‡∞∞‡±ã‡∞°‡±ç ‡∞Ö‡∞Ç‡∞ü‡±á ‡∞è‡∞Ç‡∞ü‡±ã ‡∞§‡±Ü‡∞≤‡∞ø‡∞Ø‡∞®‡∞ø ‡∞≤‡∞ï‡±ç‡∞∑‡∞≤ ‡∞ó‡±ç‡∞∞‡∞æ‡∞Æ‡∞æ‡∞≤‡∞ï‡±Å ‡∞∞‡±ã‡∞°‡±ç‡∞≤‡±Å ‡∞µ‡±á‡∞∏‡∞ø‡∞Ç‡∞¶‡∞ø ‡∞é‡∞µ‡∞∞‡±Å ‡∞Æ‡∞® ‡∞á‡∞Ç‡∞ü‡±ç‡∞≤‡±ã ‡∞Æ‡∞® ‡∞§‡∞æ‡∞§ ‡∞ï‡∞æ‡∞≤‡∞Ç ‡∞ï‡∞Ç‡∞ü‡±á ‡∞Æ‡∞® ‡∞§‡∞Ç‡∞°‡±ç‡∞∞‡±Å‡∞≤ ‡∞ï‡∞æ‡∞≤‡∞Ç ‡∞Æ‡±Ü‡∞∞‡±Å‡∞ó‡±ç‡∞ó‡∞æ ‡∞â‡∞Ç‡∞ü‡±Å‡∞Ç‡∞¶‡∞ø ‡∞Æ‡∞® ‡∞§‡∞Ç‡∞°‡±ç‡∞∞‡±Å‡∞≤ ‡∞ï‡∞æ‡∞≤‡∞Ç ‡∞ï‡∞Ç‡∞ü‡±á ‡∞Æ‡∞® ‡∞ï‡∞æ‡∞≤‡∞Ç ‡∞á‡∞Ç‡∞ï‡∞æ ‡∞Æ‡±Ü‡∞∞‡±Å‡∞ó‡±ç‡∞ó‡∞æ ‡∞â‡∞Ç‡∞ü‡±Å‡∞Ç‡∞¶‡∞ø ‡∞Æ‡∞∞‡∞ø ‡∞¶‡±Ä‡∞®‡∞ø‡∞®‡∞ø ‡∞¨‡∞ü‡±ç‡∞ü‡∞ø ‡∞Æ‡∞®‡∞Ç ‡∞è ‡∞µ‡∞ø‡∞ß‡∞Ç‡∞ó‡∞æ ‡∞Æ‡∞® ‡∞§‡∞Ç‡∞°‡±ç‡∞∞‡±Å‡∞≤‡∞®‡±Å ‡∞Æ‡∞® ‡∞§‡∞æ‡∞§‡∞≤‡∞®‡±Å ‡∞Ö‡∞∞‡±ç‡∞•‡∞Ç ‡∞ö‡±á‡∞∏‡±Å‡∞ï‡±ã‡∞µ‡∞æ‡∞≤‡∞ø KCR ‡∞Æ‡±Å‡∞ñ‡±ç‡∞Ø‡∞Æ‡∞Ç‡∞§‡±ç‡∞∞‡∞ø ‡∞Ö‡∞Ø‡±ç‡∞Ø‡±á‡∞®‡∞æ‡∞ü‡∞ø‡∞ï‡∞ø ‡∞Æ‡∞® ‡∞Æ‡±å‡∞≤‡∞ø‡∞ï ‡∞µ‡∞∏‡∞§‡±Å‡∞≤‡±Å ‡∞Æ‡∞∞‡∞ø‡∞Ø‡±Å ‡∞ï‡∞æ‡∞Ç‡∞ó‡±ç‡∞∞‡±Ü‡∞∏‡±ç ‡∞™‡∞æ‡∞≤‡∞® ‡∞™‡±ç‡∞∞‡∞æ‡∞∞‡∞Ç‡∞≠‡∞ø‡∞Ç‡∞ö‡∞ø‡∞® ‡∞®‡∞æ‡∞ü‡∞ø ‡∞Æ‡±å‡∞≤‡∞ø‡∞ï ‡∞µ‡∞∏‡∞§‡±Å‡∞≤‡∞®‡±Å ‡∞¨‡±á‡∞∞‡±Ä‡∞ú‡±Å ‡∞µ‡±á‡∞∏‡∞ø ‡∞Æ‡∞æ‡∞ü‡±ç‡∞≤‡∞æ‡∞°‡∞ø‡∞§‡±á ‡∞¨‡∞æ‡∞ó‡±Å‡∞Ç‡∞ü‡±Å‡∞Ç‡∞¶‡∞ø ‡∞à ‡∞™‡±ã‡∞≤‡∞ø‡∞ï‡∞≤‡±Å ‡∞¨‡∞ü‡±ç‡∞ü‡∞§‡∞≤‡∞ï‡±Å ‡∞Æ‡±ã‡∞ï‡∞æ‡∞≤‡∞ø‡∞ï‡∞ø ‡∞Æ‡±Å‡∞°‡∞ø ‡∞™‡±Ü‡∞ü‡±ç‡∞ü‡∞ø‡∞®‡∞ü‡±ç‡∞≤‡±Å‡∞Ç‡∞¶‡∞ø
ramesh nani	True story cunning fellow KRC
Siri Rajan	No doubt next CM KCR
Venu Venu	Jai kcr jai TRS
Praveen B	Are va party la bagotham
SamnayaK CreationS	Off screen of KCR
Learning	Super brooooo
Arjun Reddy	super
Venkat V	‡∞Æ‡∞≤‡±ç‡∞≤‡∞®‡±ç‡∞® ‡∞ö‡∞ø‡∞≤‡±ç‡∞≤‡∞∞ ‡∞∞‡∞æ‡∞ú‡∞ï‡±Ä‡∞Ø‡∞æ‡∞≤‡±Å ‡∞ú‡∞∞ ‡∞Æ‡∞æ‡∞®‡±Å‡∞ï‡±ã ‡∞®‡∞ø‡∞≤‡∞æ‡∞Ç‡∞ü‡∞ø ‡∞ï‡∞æ‡∞Ç‡∞ó‡±ç‡∞∞‡±á‡∞∏‡±ç ‡∞§‡±ä‡∞§‡±ç‡∞§‡±Å‡∞≤‡±Å ‡∞é‡∞Ç‡∞§ ‡∞Æ‡∞Ç‡∞¶‡∞ø ‡∞µ‡∞ö‡±ç‡∞ö‡∞ø‡∞®‡∞æ ‡∞ú‡∞®‡∞æ‡∞≤‡±Å ‡∞Æ‡∞≥‡±ç‡∞≤‡±Ä ‡∞ï‡±á‡∞∏‡±Ä‡∞Ü‡∞∞‡±ç ‡∞Æ‡±Å‡∞ñ‡±ç‡∞Ø‡∞Æ‡∞Ç‡∞§‡±ç‡∞∞‡∞ø ‡∞ï‡∞æ‡∞µ‡∞æ‡∞≤‡∞®‡∞ø ‡∞ï‡±ã‡∞∞‡±Å‡∞ï‡±Å‡∞Ç‡∞ü‡±Å‡∞®‡±ç‡∞®‡∞æ‡∞∞‡±Å
Rakesh. P Rakesh. P	Meru mara ra thu kcr Ni appudu badhnam jesudu
Suresh Kumar	Anna super chesinav
naresh islavath	Super
Malyala Anil	It is the true
kishore nani	Super
Anil Kumar	Super
shravan kumar	Sarpanch KCR vupa sarpanch kadiyam nu correct ga chuyinchirru
Krishna Uppari	Makki ki Makki
Mahesh Gurajapu	Where is the location Chala bagundi
Sadanandam Prameedula	Real story real lo chupinchinru super
Nagaraj Yadav	Kcr paniaidi
Chamakuri Venkatesh	super kcr katalu
Ravindra Chandra	KCR chesinatle undi and KCR ni kalaku katinatlu chupuncharu
Vikram goud	Jai TRS
Luxmi Bai	Doraa Ne banchand nuv keka
VAMSHI KRISHNA	Arey o sodiga malliga nuvvu nijayithiga nee vilekari darmanni patisthe nenu ninnu adarshanga tiskoni nee news chusthunde howle ga nuvvu congress thotthu vi vala mokalla cheppulaki banisa nuvvu kcr meeda okani midane enduk chestunav itlantivi dammunte kodaka anni party la mida valla chese panula midha pettu ante oka party vallani vimarsinche vanki oka channel edkelli ochinai paisal sodiga valla sanka nakithe eshirra bicham
Paramesh M	‡∞á‡∞¶‡∞ø ‡∞ï‡±Ü‡∞∏‡∞ø‡∞Ü‡∞∞‡±ç ‡∞ó‡∞æ‡∞®‡∞ø ‡∞¨‡±Å‡∞¶‡±ç‡∞ß‡∞ø ‡∞Ö‡∞µ‡±Å‡∞®‡±Å ‡∞®‡∞ø‡∞ú‡∞Æ‡±á ‡∞∏‡±Ç‡∞™‡∞∞‡±ç ‡∞¨‡∞æ‡∞ó‡∞ö‡±Å‡∞™‡∞ø‡∞Ç‡∞ö‡∞∞‡±Å ‡∞ï‡±Ü‡∞∏‡∞ø‡∞Ü‡∞∞‡±ç ‡∞∏‡±ç‡∞ü‡±ã‡∞∞‡±Ä
INDIAN DREAMZ	Exlent script anna chimpenav poo
Ramavath Mohan	really kcr manasthathwam and correct mallana yevariki swartham undadhu kani idhi kontha mothadhulo undali mari kcr la vaddhu kcr a West cm in my country
Dharavath Shanker	KCR AND J REDDY THIS IS real story
Jagan SAAI	üëåüòÇüòÇüòÇüëè
cheluri kishore	Daring short film
sirram raju	Super
Jaknale Laxman	100 correct ga chyesaru super mallana
gajani ravan	An extraordinary Man gutsy guy
vinay reddy	Ee Dora vi anni Lathukoru matalu lathukoru chethalu telanganani nasanam chesthundu
PALLAPU YELLAIAH	Kcr next osthe ontimeeda gochikuda vunchadura nayana
Raja The great	üòÇüòÇüòÇüòÇüòÇüòÇüòÇüòÇüòÇüòÇüòÇüòÇüòÇüòÇüòÇüòÇüòÇüòÇüòÇüòÇüòÇüòÇüòÇüòÇüòÇüòÇüòÇüòÇüòÇüòÇüòÇüòÇ‡∞°‡±Ç‡∞™‡±ç ‡∞ï‡±á‡∞∏‡∞ø‡∞∞‡±ç ‡∞Ø‡∞æ‡∞ï‡±ç‡∞ü‡∞ø‡∞Ç‡∞ó‡±ç ‡∞á‡∞∞‡∞ø‡∞ó ‡∞¶‡±Ä‡∞∏‡∞ø‡∞Ç‡∞°‡±Å
nerella praveen	Uttam kumr Reddy Janareddy Komati Reddy Rachana Reddy Jeevan Reddy Revanth Reddy Kodandaram Reddy Chinna Reddy Damodar Reddy Geeta Reddy Veellu andaru doralu kada daluthula cheppu mallanna First vallani AA thokalu teaskomanu
Nama Avinash	Mallanna super super
Malavath Santhosh	Correct bro
Sampth Akula	‡∞á‡∞¶‡∞ø ‡∞ï‡±Ü‡∞∏‡∞ø‡∞∞‡±ç‡∞ó‡∞æ‡∞®‡∞ø ‡∞¨‡∞§‡±Å‡∞ï ‡∞§‡±Å
venkateswararao chitturi	Mallanna nuvvu keka anna
C Rithwik	nice short film about politician
Santosh H	Thamdu NV keka ra
sharath babu	It s true now a day
Karthikgoud Marikal	Poshetty like a kcr
bharath yerram	Arey Lkodaka ni bathukula M Kcr ni anantha mogoniva va ra nuv
Arun K	‡∞Æ‡∞≤‡±ç‡∞≤‡∞®‡±ç‡∞® ‡∞™‡∞ï‡±ç‡∞ï ‡∞ï‡∞æ‡∞Ç‡∞ó‡±ç‡∞∞‡±Ü‡∞∏‡±ç ‡∞™‡∞æ‡∞∞‡±ç‡∞ü‡±Ä ‡∞Æ‡∞®‡∞ø‡∞∑‡∞ø ‡∞í‡∞∞‡±á‡∞Ø‡±ç ‡∞Æ‡∞≤‡±ç‡∞≤‡∞®‡±ç‡∞® ‡∞®‡±Å‡∞µ‡±ç‡∞µ‡±Å ‡∞ú‡∞∞‡±ç‡∞®‡∞≤‡∞ø‡∞∏‡±ç‡∞ü‡±ç ‡∞ï‡∞¶‡∞æ ‡∞Ö‡∞®‡±ç‡∞®‡±Ä ‡∞™‡∞æ‡∞∞‡±ç‡∞ü‡±Ä ‡∞≤ ‡∞§‡∞™‡±ç‡∞™‡±Å‡∞≤ ‡∞ó‡±Å‡∞∞‡∞ø‡∞Ç‡∞ö‡±Ä ‡∞ö‡±Ü‡∞™‡±ç‡∞™‡±Å‡∞∞‡∞æ ‡∞Ö‡∞™‡±ç‡∞™‡±Å‡∞°‡±Å ‡∞®‡±Å‡∞µ‡±ç‡∞µ‡±Å ‡∞ú‡∞®‡∞≤‡∞ø‡∞∏‡±ç‡∞ü‡±ç ‡∞Ö‡∞®‡∞ø ‡∞®‡∞Æ‡±ç‡∞Æ‡±Å‡∞§‡∞æ‡∞∞‡±Å
Sirigiri Srujay	politics anthe correct ga chupinchav selute to you go on we will support you i share this video to my friend simultaniously
Siri Media	Vadevadoo telivi thakkuva gadu unnadu
Madikonda Mahesh	‡∞§‡±ä‡∞Ç‡∞¶‡∞∞‡∞ó‡∞æ 2 ‡∞µ ‡∞¨‡∞æ‡∞ó‡∞Ç ‡∞µ‡∞ø‡∞°‡±Å‡∞¶‡∞≤ ‡∞ö‡±á‡∞Ø‡∞Ç‡∞°‡∞ø
ram chander	‡∞Ö‡∞ö‡±ç‡∞ö‡±Å ‡∞ï‡±Ü‡∞∏‡∞ø‡∞Ü‡∞∞‡±ç ‡∞ö‡∞∞‡∞ø‡∞§‡±ç‡∞∞
prabhakar bolli	Super acting ra cnu
farmar farmar agrechnell	Supar sar
fan of pawan kalyan	brother hatsff team ki nd neeku üëåüëå
Rajashekar Rajashekar	orey pichipuku mallana
Chellapelli Prashanth	Abbbaaaa KEka po
pavan kumar	Etidhi makeytidhi antunna
VANGURI SURESH	Super ma dalithulu ku unity untey bagunddu elanti kcr na kodukulu thata thiyochu
raju sripathi	Good work Anna we are expecting more from U we wish you all Good luck üíêüíê
P SRIKANTH	‡∞Æ‡∞≤‡±ç‡∞≤‡∞®‡±ç‡∞® ‡∞Æ‡∞∏‡∞æ‡∞≤‡∞æ ‡∞∏‡±Ç‡∞™‡∞∞‡±ç ‡∞â‡∞Ç‡∞¶‡∞ø
N R	Super plz spread this video
menh saicharan	Meeru Congress Ko voteyamani cheptav vallaku votesthe neeku buddagoshi ki Ku Da battalekunda chestaru gurthunchuko
srikanth j	Appriciated Mallanna for your direction But why individual are targeted a this wa done by all political party major share ‚úã next cycle Not aware if this happened in last 4yrs If possible contribute good to society with some solution to such problem bcos people are aware a these thing are happening
rajender s	Super Anna
R VINAY	Naveenam ki scamgress sankale kammaguntay le Journalist ainapudu neutral ga undali prathi party ni endagattali Kani Oka party dhi thaguthu inko party midha poyadam crct kadhu Niku dhammunte scamgress inni samvathsarala scam la gurinchi video theeyagalava Nenu dalit ne Entha em motthukunna dalitulaki rajyadhikaram radhu ranivvaru Okavela vachina kuda keelubommalaga mana mekmoham Singh laga thappa adhikaralu chethilo undavu Atleast ee govt Aina entho kontha manchi chesindhi adhi ni kullu kallaki kanipinchadhu le Manchi eye care lo chuyinchuko naveena Nelako news channel nelako YouTube channel mare malligadu neethulu cheppudu manam inundu dharidhram nayana tension padaku le scamgress gelisthe niku MLC seat pakka don t worryyyy malliii Ni istam ochinantha eguru bidda Dec 11 varake entha egirina kuda Dj song pettukuni maree eguru
sreenivasulu dupati	Brother super bro
Kadari Ramesh	Mallanna ki congress lo seat istham annattunnaru andhuke ee alochana vachinattundhi
Prasad Dv	‡∞®‡±á‡∞®‡±Å ‡∞Ü‡∞Ç‡∞ß‡±ç‡∞∞‡∞æ ‡∞ï‡∞æ‡∞®‡±Ä ‡∞à ‡∞∏‡±ç‡∞ü‡±ã‡∞∞‡±Ä ‡∞§‡±Ü‡∞≤‡∞Ç‡∞ó‡∞æ‡∞£ ‡∞¶‡±Ä ‡∞ï‡±á‡∞∏‡±Ä‡∞Ü‡∞∞‡±ç ‡∞ï‡∞°‡∞ø‡∞Ø‡∞Ç‡∞∂‡±ç‡∞∞‡±Ä‡∞π‡∞∞‡∞ø
satyanarayana balusa	Broker mallanna
Raj Rgv	Upasurpanch Banisa suman
bharath swabhiman	Bold story Jara jagarthaa mallanna Nenu nee Veera abhi maninene
chand Shaik	Extraordinary direction performance u have bright future
Krishnamurthy krishnamurthy	‡∞è‡∞Ç ‡∞ö‡±Ü‡∞™‡±ç‡∞™‡∞ø‡∞®‡∞æ‡∞µ‡±Å ‡∞ï‡±á‡∞∏‡±Ä‡∞Ü‡∞∞‡±ç ‡∞™‡∞æ‡∞ï‡±Å‡∞≤‡∞æ‡∞ü ‡∞®‡∞Ç‡∞¨‡∞∞‡±ç ‡∞µ‡∞®‡±ç ‡∞Æ‡∞Ç‡∞ö‡∞ø skit ‡∞§‡±Ä‡∞∂‡∞æ‡∞µ‡±Å ‡∞Æ‡∞≥‡±ç‡∞≤‡±Ä ‡∞Æ‡∞Ç‡∞ö‡∞ø ‡∞§‡±Ä‡∞Ø‡∞æ‡∞≤‡∞®‡∞ø ‡∞ï‡±ã‡∞∞‡±Å‡∞ï‡±Å‡∞Ç‡∞ü‡±Ç ‡∞∏‡±Ç‡∞™‡∞∞‡±ç
Krishna Neelam	Arye mallana lanjoduka neku gudda balsindi E video Evarike set aithadi Telusa makyaludye congerrs party ki ra palthuga Ne abba jai KCR jai telangana
Shravan Patel	Arey lucha director ga
ROCK AND ROLL	Smoking is injury to health
anil kumar	This is the attitude of Kcr
yugender velde	Dhalitunni CM cheste em vachedi Manmohan Singh ni PM chesi Sonia Gandhi rule chesinattu KCR rule chesevadu Deputy CM istene Rajayya garu and family avineethi lo irrukupoyaru Aina Mayavathi CM ai UP ki em chesindi KCR tagite tappenti Suitcase lalo dabbulu tesukelli MLC ni konadaniki try chesi direct ga dorikina Revanth Reddy lanti avineethi paruduni bhujalameda ettukunna scamgress ni vadili Telangana tesukochi raitu laki water pettubadi bheema lanti pathalanu techina KCR meda padi edustunnaru Inkeppudu vastadi meku telivi
AVINASH REDDY	Are q news sampestham kodaka nuvu bayata kanapadu enkenalu ra me dalithulaku reservation already chala dochukunaru ma kastani 35 year s nundi ma constituency lo sc st reservation ki echi em development ay lekunda padi undi Alantidi meku mali CM seet kavala
Solomon Kane	So much bgm and worse editing Make it a a fun So much slow moving
Thadagonda Thiru	super Anna Good
bharath nani	‡∞®‡±Ä ‡∞™‡∞æ‡∞∞‡±ç‡∞ü‡±Ä ‡∞ó‡±Å‡∞∞‡∞ø‡∞Ç‡∞ö‡∞ø ‡∞®‡±Å‡∞µ‡±ç‡∞µ‡±Å ‡∞ó‡±ä‡∞™‡±ç‡∞™‡∞ó‡∞æ ‡∞ö‡±Ü‡∞™‡±ç‡∞™‡±Å‡∞ï‡±ã ‡∞ï‡∞æ‡∞®‡±Ä ‡∞é‡∞¶‡±Å‡∞ü‡∞ø ‡∞µ‡∞æ‡∞∞‡∞ø ‡∞™‡∞æ‡∞∞‡±ç‡∞ü‡±Ä ‡∞ï‡∞æ‡∞®‡±Ä ‡∞Æ‡∞®‡±Å‡∞∑‡±Å‡∞≤‡∞®‡±Å ‡∞ï‡∞æ‡∞®‡±Ä ‡∞µ‡∞ø‡∞Æ‡∞∞‡±ç‡∞∂‡∞ø‡∞Ç‡∞ö‡±á ‡∞Ü‡∞≤‡±ã‡∞ö‡∞® ‡∞Æ‡±Ä‡∞≤‡∞æ‡∞Ç‡∞ü‡∞ø ‡∞¶‡∞ø‡∞ï‡±ç‡∞ï‡±Å‡∞Æ‡∞æ‡∞≤‡∞ø‡∞® ‡∞ü‡±Ä‡∞µ‡±Ä ‡∞õ‡∞æ‡∞®‡∞≤‡±ç‡∞∏‡±ç ‡∞µ‡∞æ‡∞≥‡±ç‡∞≤‡±á ‡∞®‡±á‡∞®‡±Å ‡∞Ö‡∞®‡±Å‡∞ï‡±Å‡∞Ç‡∞ü‡±Å‡∞®‡±ç‡∞®‡∞æ‡∞®‡±Å Fuck üñïüñïüñïüñïüñïüñïüñïüñïüñïüñïüñïüñïüñï Note ‡∞®‡±á‡∞®‡±Å ‡∞è ‡∞™‡∞æ‡∞∞‡±ç‡∞ü‡±Ä ‡∞ï‡∞æ‡∞¶‡±Å ‡∞à ‡∞™‡∞æ‡∞§‡±ç‡∞∞ ‡∞≤‡±ã ‡∞é‡∞µ‡∞∞‡±Å ‡∞â‡∞®‡±ç‡∞® ‡∞á‡∞≤‡∞æ‡∞ó‡±á ‡∞ï‡∞æ‡∞Æ‡±Ü‡∞Ç‡∞ü‡±ç ‡∞™‡±Ü‡∞ü‡±ç‡∞ü‡±á‡∞µ‡∞æ‡∞°‡∞ø‡∞®‡∞ø ‡∞®‡±Å‡∞µ‡±ç ‡∞é‡∞Ç‡∞ö‡±Å‡∞ï‡±Å‡∞®‡±ç‡∞® ‡∞™‡∞∞‡±ç‡∞∏‡∞®‡±ç ‡∞§‡∞™‡±ç‡∞™‡±Å ‡∞ï‡∞æ‡∞¶‡±Å ‡∞ï‡∞æ‡∞®‡±Ä ‡∞á‡∞≤‡∞æ ‡∞ö‡±Ü‡∞§‡±ç‡∞§‡∞ó‡∞æ ‡∞∏‡±ç‡∞ï‡±ç‡∞∞‡∞ø‡∞™‡±ç‡∞ü‡±Å ‡∞∞‡∞æ‡∞Ø‡∞°‡∞Ç ‡∞§‡∞™‡±ç‡∞™‡±Å
durgam durgaprasad	Very nice
Pulluri Raju	Good story this can be done film also Good screenplay
colours nani	Super üëå
Sriramula Srikanth	kcr is the great leader ever
bandari aravind	Super brother I love you
Y. S.	KCR lekapothe Telangana State a vacchedhi kaadhu yes student role 100 undhi public dhi kuda undhi kani Udyamanni Delhi varaku thisukelli Telangana ivvaka thappadhu anela chesindhi KCR maatrame
CRAZY KING	100 kcr story bakka lanjodku kcr madarchod kcr andarki pullalu petti labhapadtadu bakka lanjodku
mahesh g	‡∞Æ‡∞≤‡±ç‡∞≤‡∞®‡±ç‡∞® ‡∞®‡±Å‡∞µ‡±ç‡∞µ‡±Å ‡∞á‡∞®‡±ç‡∞®‡∞ø ‡∞ï‡±á‡∞∏‡±Ä‡∞Ü‡∞∞‡±ç ‡∞Æ‡±Ä‡∞¶ ‡∞ï‡±ç‡∞∞‡∞ø‡∞Ø‡±á‡∞ü‡±ç ‡∞ö‡±á‡∞∏‡∞ø‡∞® ‡∞ï‡±á‡∞∏‡±Ä‡∞Ü‡∞∞‡±ç ‡∞ó‡∞æ‡∞∞‡±Å ‡∞§‡∞ø‡∞∞‡∞ø‡∞ó‡∞ø ‡∞Ö‡∞ß‡∞ø‡∞ï‡∞æ‡∞∞‡∞Ç‡∞≤‡±ã‡∞ï‡∞ø ‡∞µ‡∞∏‡±ç‡∞§‡∞æ‡∞∞‡±Å üòçüòç
Jumidi Mahender	Imitation super bro keep it up
Manu Kumar	Super location Good takeing Future to the director
Roopani Ganesh	Kcr CM aite kcr matrame tagubotu congress vaste janalu taagubotulu avutaru ika mi istam
Tirupathi Markanti	‡∞Ö‡∞Ø‡∞ø‡∞® ‡∞ó‡∞æ ‡∞ö‡±Ä‡∞™‡±ç ‡∞≤‡∞ø‡∞ï‡±ç‡∞ï‡∞∞‡±ç ‡∞ó‡∞æ‡∞°‡±Å ‡∞¶‡±ä‡∞∞ ‡∞è‡∞Ç‡∞¶‡∞ø‡∞∞‡∞æ üòÅüòÅüòÅüòÅüòÅüòÅüòÅ
Vishwanth N	Anna niku em anyayam chesindu anavasaramga blem chestunnav
mahesh babu	Rey KCR la chesiii name bale chamge chesaruuuuüòÇüòÇüòÇ
gopi krishna vollala	Ditoo kcr storyy
Saikumar Rachakonda	Kcr
Aakiti Shiva	anna super
Anju Anju	Ore mallanna Me phone number pampara Neku pedha gift esta Ne leka telust Video last lo number sent me
Ravi Ravi Kumar	Arei falthu gallara kcr did good job in Telangana howla gallaki chupinchu gee video ni
Vijay Mahadev	Part 2jaldhi upload cheyy Paanam aguthale d
Ravi K	KCR odipoinanka pataasulu kaalchi raavana dahanam cheddamanna
RAJAIAH KANDE	Today political position in ap and t
Mehaboob Basha	Keka bro epati rajakeyam elane undhi
Ravinder Nagelli	Anna super
Rahul D	Are havle job ninnu cm cheste istavara nuvvu kadu evadu CM ayina andariki job rav student Ee vishayam artam cheskovale teliyaka pote muskuni kusovale
raju Gangadhara	Dorana avadu vadu Dora avaniki vaday Dora
RAJESH RAYARAKULA	this is kcr reality
R V B	‡∞Ö‡∞∞‡±á ‡∞ì ‡∞≠‡±ã‡∞∑‡∞ø‡∞°‡±Ä‡∞ï‡±á ‡∞Æ‡±Ä‡∞∞‡±Ü‡∞Ç‡∞§ ‡∞¨‡∞ü‡±ç‡∞ü‡∞≤‡±Å ‡∞ö‡∞ø‡∞Ç‡∞™‡±Å‡∞ï‡±Å‡∞®‡±ç‡∞®‡∞æ ‡∞Æ‡∞≤‡±ç‡∞≤‡±ä‡∞ö‡±ç‡∞ö‡±á‡∞¶‡∞ø TRS ‡∞™‡±ç‡∞∞‡∞≠‡±Å‡∞§‡±ç‡∞µ‡∞Æ‡±á KCR ‡∞Æ‡∞æ‡∞§‡±ç‡∞∞‡∞Æ‡±á ‡∞∞‡∞æ‡∞∏‡∞ø‡∞™‡±Ü‡∞ü‡±ç‡∞ü‡±Å‡∞ï‡±ã
manoohara chary	‡∞®‡±Å‡∞µ‡±ç‡∞µ‡±Å ‡∞∏‡±Ç‡∞™‡∞∞‡±ç ‡∞Æ‡∞≤‡±ç‡∞≤‡∞®‡±ç‡∞®
sreekanth microlabs	Hat s off Sir Continue the total story Real kcr
Rajashekar Kadari	mari intha neechudu kadhu le kcr thaginantha matrana cheddavadu kadhu
Vinay Kumar	Amma denemma jeevitam enta dhairyam endi bhayya meeku Direct cm meeda ne video na
Hari Krishna	super anna asalu KCR lagey vunnadu Super
om om	Superb
Srikanth Goud	‡∞®‡∞Æ‡∞∏‡±ç‡∞§‡±á ‡∞≤‡∞ø‡∞ï‡±ç‡∞ï‡∞∞‡±ç ‡∞¶‡±ä‡∞∞
vivek Marati	Superb
neelam praveen	Kcr nijaswarupam idhe anna
Rampally Venu	The same thing happened in scamgress government since 1956 Scamgress castism
Pawan kumar	Superrr
shakir shaik	5 58 dailouge please
Sunkari Swamy	rachakonda Ramesh Anna kada mallanna antunnaru
Nishith Sriram	It ‚Äô s very bad for what you doing üòåyou r a good talented person but u misuse todo like this so please stop we living 21st century not back1930 ‚Äô s don ‚Äô t waste ur time üôè still we respect you mallana naveenüôè
Bonda Muralikrishna	Superb spoof Black COBRA politics Ancestor of Dora s
Mahi Thonte	Really story
dunna shadrach	2nd part please
rambabu mamindla	‡∞à‡∞∏‡∞æ‡∞∞‡∞ø ‡∞§‡±Ü‡∞∞‡∞æ‡∞∏ ‡∞ó‡±Ü‡∞≤‡±Å‡∞∏‡±ç‡∞§‡±á ‡∞Æ‡∞≥‡±ç‡∞≥‡±Ä ‡∞Æ‡∞® ‡∞§‡±Ü‡∞≤‡∞Ç‡∞ó‡∞æ‡∞£ ‡∞¨‡∞§‡±Å‡∞ï‡±Å‡∞≤‡±Å ‡∞á‡∞≤‡∞æ‡∞ó‡±á ‡∞â‡∞Ç‡∞ü‡∞æ‡∞Ø‡∞ø
sridhar lagishetti	Part 2 inka super untadhi kavacchu
chandu ubbani	E KCR lanti tuglak na kodukulani tarimi tarimi kottali mallana KCR correct mogudu revanth Reddy nuvve anna
K Nagarjuna	Soolluuuu
srinivas kurla	Abbaa nijam cheppinav brother
Kranthi Reddy	Ne Amma puku ra ekiri lanjodka
Sri rama Rao	Same ‡∞ü‡±Å same ‡∞á‡∞ß‡∞ø ‡∞ö‡∞æ‡∞≤‡∞æ ‡∞∏‡∞Ç‡∞µ‡∞§‡±ç‡∞∏‡∞∞‡∞æ‡∞≤ ‡∞®‡±Å‡∞Ç‡∞°‡∞ø ‡∞Ü‡∞Ç‡∞ß‡±ç‡∞∞ ‡∞≤‡±ã ‡∞â‡∞™‡∞Ø‡±ã‡∞ó‡∞ø‡∞∏‡±ç‡∞§‡±Å‡∞®‡±ç‡∞® ‡∞´‡∞æ‡∞∞‡±ç‡∞Æ‡±Å‡∞≤‡∞æ ‡∞ï‡∞æ‡∞™‡±Å ‡∞≤‡∞ï‡±Å ‡∞¨‡±Ä‡∞∏‡±Ä ‡∞≤‡∞ï‡∞ø ‡∞Æ‡∞∞‡∞ø‡∞Ø‡±Å ‡∞¶‡∞≥‡∞ø‡∞§‡±Å‡∞≤‡∞ï‡±Å ‡∞ó‡±ä‡∞°‡∞µ ‡∞™‡±Ü‡∞ü‡±ç‡∞ü‡∞ø ‡∞∞‡±Ü‡∞Ç‡∞°‡±Å ‡∞ï‡±Å‡∞≤‡∞æ‡∞≤‡±Å ‡∞á‡∞≤‡∞æ‡∞ó‡±á ‡∞∞‡∞æ‡∞ú‡±ç‡∞Ø‡∞¶‡∞ø‡∞ï‡∞æ‡∞∞‡∞Ç ‡∞Ö‡∞®‡±Å‡∞≠‡∞µ‡∞ø‡∞∏‡±ç‡∞§‡±Å‡∞®‡±ç‡∞®‡∞æ‡∞Ø‡∞ø ‡∞Ü‡∞Ç‡∞ß‡±ç‡∞∞‡∞æ‡∞≤‡±ã ‡∞Ö‡∞Ç‡∞¶‡±Å‡∞≤‡±ã ‡∞Æ‡±Å‡∞ï‡±ç‡∞Ø‡∞Ç‡∞ó‡∞æ ‡∞™‡∞ö‡±ç‡∞ö ‡∞ï‡±Å‡∞≤‡∞Ç ‡∞¨‡∞æ‡∞ó‡∞æ ‡∞Ü‡∞∞‡∞ø‡∞§‡±Ä‡∞∞‡∞ø‡∞Ç‡∞¶‡∞ø ‡∞ï‡∞æ‡∞®‡∞ø ‡∞Æ‡∞ø‡∞ó‡∞§‡∞æ ‡∞ï‡±Å‡∞≤‡∞æ‡∞≤‡±Å ‡∞á‡∞™‡±ç‡∞™‡∞ü‡∞ø‡∞ï‡∞ø ‡∞™‡∞æ‡∞™‡∞Ç ‡∞Ö‡∞Æ‡∞æ‡∞Ø‡∞ï‡∞Ç‡∞ó‡∞æ ‡∞µ‡±Ä‡∞≥‡±ç‡∞≤ ‡∞™‡∞≤‡±ç‡∞≤‡∞ï‡±Ä ‡∞Æ‡±ã‡∞∏‡±ç‡∞§‡±Ç‡∞®‡±á ‡∞µ‡±Å‡∞®‡±ç‡∞®‡∞æ‡∞Ø‡±ç ‡∞ï‡∞≤‡∞ø‡∞Ø‡±Å‡∞ó‡∞Ç ‡∞≤‡±ã ‡∞µ‡±Ä‡∞≥‡±ç‡∞≤‡±Å ‡∞ö‡±à‡∞§‡∞®‡±ç‡∞Ø ‡∞µ‡∞Ç‡∞§‡±Å‡∞≤‡±Å ‡∞Ö‡∞µ‡±Å‡∞§‡∞æ‡∞∞‡∞®‡±ç‡∞® ‡∞Ü‡∞∂ ‡∞Ö‡∞Ø‡∞ø‡∞§‡±á ‡∞®‡∞æ‡∞ï‡±Å ‡∞≤‡±á‡∞¶‡±Å
Naresh Naresh	Extent
Gopi simha	bathala posetti na veedevva ku ra picha nakodaka na loveda lo channel dongana kodaka telangana lo cheda puttav ga ra g pagiliddi malli
SHIVA B	Story screenplay direction super
Pavan pavan	same a kcr mind
spicy foods	‡∞∞‡±Ü‡∞Ç‡∞°‡±ã ‡∞é‡∞™‡∞ø‡∞∏‡±ã‡∞°‡±ç ‡∞≤‡±ã ‡∞à‡∞Ø‡∞® ‡∞®‡∞ø‡∞Æ‡±ç‡∞∏‡±ç ‡∞≤‡±ã ‡∞ö‡±á‡∞∏‡∞ø‡∞® ‡∞¶‡±ä‡∞Ç‡∞ó ‡∞¶‡±Ä‡∞ï‡±ç‡∞∑ ‡∞∏‡±ç‡∞ü‡±ã‡∞∞‡±Ä ‡∞™‡±Ü‡∞ü‡±ç‡∞ü‡∞Ç‡∞°‡∞ø
manohar peteti	All the best mallanna
Prasad dalith mulavasi	Dalithulu ela unity laykhanaee rajulu kalaykha pothunnaru
Pulkantimahesh Mahesh	Osm video bro
Sai Krishna	Super Bro
purna chandar	This is what exactly happening in most of the village of telangana
Ashok Kunamalla	‡∞∏‡±Ç‡∞™‡∞∞‡±ç
madhu puttam	Super brother Inspired by real event and real person Fantastic bro Double thumb up from my side
BTech Babu	‚ù§da lo chanel
Athem Shekar 9912493612	üëçüëçüëçüëçüëåüëåüëå
Anil Chintala	Background üëåüëå
Kanakaiah Ekanakaiah	‡∞Ö‡∞¨‡±ç‡∞¨‡∞æ ‡∞∏‡±Ç‡∞™‡∞∞‡±ç ‡∞Ö‡∞®‡±ç‡∞® ‡∞§‡∞æ‡∞ó‡±Å‡∞¨‡±ã‡∞§‡±Å ‡∞¨‡∞æ‡∞ó‡±ã‡∞§‡∞Ç ‡∞ó‡∞ø‡∞¶‡±á
samuel gali	Super Kcr e gurthostundu Same getup plan
raju super raj super	Super bro
Ramdas Nayak	Super b
billa Munna	Superb video great creative üôè
Anil Agurla	Nice anna
Racharla Ashok	Superb director garu
Vishnu Pendela	Vijey gaaa super raa
amanh velpula	Wow exlent
MITHUN GOUD	Intaki Mallanna a party Congress geliste Dalituni CM chestara
vishnu vardhan	Adenti Atanu episode motham tagutune unnadu
sri 2011	Kirrak
NA Machine designs	Sexy tisinavvv
Syed Arif Basha	Same Kcr
Naresh Nani	Arey neku shiggu unnadha tHu
Kambala mounika Kambala mounika	Tirst change your beahivor
s venkat	Dorala gu a pagalagotaleeeeee Lanjakoukuluuu
Srikanth	2000 correct hots off to your directionüòëüëèüëèüëèüëè
A J CREATIONS	Excellent Anna chaala bagundi
vikas pasupuleti	Kcr laga undi story superb
Muniraja Y	Super anna
Pavan Kumar	Awesome performance
Gadhrla Srinivas	Super vedeo present situation chepparu Kcr ee vedeo chusthe bangundu 2 bottle 2 packet sigarates ekkuva esthadu
Karingu Mahesh	Wow wonderful s
Muralidhar Reddy	Excellent video Director u r the right person to make a bio pic of KCR In This video the assistant is Mahendar Reddy and the student is balka suman Excellent show
raviteja raama	Report abusive
fazeel fazeel	Osm
Shriniwas Madnal	Vadu dora la ledu gorya la unadu
gandimidi nagesh	superb kcr character
SrJ4U All	Osmania la chaduvukunnodu pommanagane emi teliyakunda poyi case pedatharra bai Improve inka
vamcp	superüëåüëåüëå exact behavior of mukkodu
Gonepally Krishna	Makaludea balisindara
Salman Pahalwan	Kcr ki dagatu undi super
Pakala Ramesh Goud	üñïüñïüñï
ARK CreATionS	Chaala bagundi aa camera angle gani aa screenplay story baagundi great
Ahammad Saleem	Super bhayya
Tadem Raju	Super Anna
sanjeev abhinava	Super
Veera Swamy	Wonderful story very realistic SC st bc lanu high cast Valle kaadu SC st kulalo unna kula peddalu kuda ilanti natakale adutaru
J√¶ƒë√¶v ≈ò√¶v√Æ≈àƒëƒõ≈ô ≈á√¶√Ω√¶ƒ∑	Kcr ku saraina mogudu mallana
Venkat Venkatesh	enkokasari elanti video cheyaku sankanakipothav
chilamarthi srinivas	Kcr Garine Avamana parusthata ra bhaka sale ne mukaneki video okati
Bharath Today	‡∞Ö‡∞°‡±ç‡∞°‡∞°‡±ç‡∞°‡±á ‡∞∏‡±Ç‡∞™‡∞∞‡±ç ‡∞µ‡±Ä‡∞°‡∞ø‡∞Ø‡±ã ‡∞ï‡∞∞‡±Ü‡∞ï‡±ç‡∞ü‡±ç ‡∞ü‡±à‡∞Ç ‡∞≤‡±ã ‡∞ï‡∞∞‡±Ü‡∞ï‡±ç‡∞ü‡±Å ‡∞µ‡±Ä‡∞°‡∞ø‡∞Ø‡±ã ‡∞µ‡±à‡∞∞‡∞≤‡±ç ‡∞ö‡±á‡∞Ø‡∞Ç‡∞°‡∞ø
subbu ponnekanti	‡∞∞‡∞ø‡∞Ø‡∞≤‡±ç Kcr
Raveena Reddy	Super political story same KCR
rajashekar gandla	Ticket ivvakapothe chillara rajikayalu chesthunava mallaya
salman pasha	Janagaon district Queilashapur VILGE lo thesaru kada qilashapur gadhee
most popular videos BMS	Super Anna üôãüôãüòáüòòüôèüôèüôè
a to z best videos	Intanti vedavalu vuntaru
bathula prasad	Good
Srinivas Yerram	Super
RAM KIRAN	super bro baga tisaru
Manikumar Vallala	Kcr chusthe inko full bottle traguthadu
Power tech All in one	Next video eppudu anna
Chiranjeevi Chiru	super mallanna
amar amarendra	Superb bro
Rajashekar Elthuri	Kcr ni minchina acting
saleem md	‡∞á ‡∞µ‡±Ä‡∞°‡∞ø‡∞Ø‡±ã ‡∞ï‡±á‡∞∏‡±Ä‡∞Ü‡∞∞‡±ç ‡∞ö‡±Ç‡∞∏‡±ç‡∞§‡±á ‡∞á‡∞Ç‡∞ï‡±ä ‡∞∞‡±Ü‡∞Ç‡∞°‡±Å ‡∞™‡±Ü‡∞ó‡±ç‡∞ó‡±Å‡∞≤‡±Å ‡∞é‡∞ï‡±ç‡∞ï‡±Å‡∞µ ‡∞µ‡±á‡∞∏‡±ç‡∞§‡∞æ‡∞°‡±Å üòÇüòÇ
srikanth Pitla	Miru entha negative chesina gelupu kcr he ra
Prasad Alishala	Telanganala jarigina arachakalanu gurthu chesinav bro
rakesh sudda volgs	mallana yetta Alaku vachiv annatu
Harish Chandra	supper anna
Eppala parameshwar	Suppeb
luman satya	Super bro keep it up this is the real fact
y vijendhar	‡∞®‡∞ø‡∞ú‡∞Æ‡±à‡∞® ‡∞∞‡∞æ‡∞ú‡∞ï‡±Ä‡∞Ø‡∞Ç ‡∞ï‡∞≥‡±ç‡∞≥‡∞ï‡±Å ‡∞ï‡∞ü‡±ç‡∞ü‡∞ø‡∞®‡∞ü‡±ç‡∞ü‡±Å ‡∞ö‡±Ç‡∞™‡∞ø‡∞Ç‡∞ö‡∞æ‡∞µ‡±ç ‡∞Ö‡∞®‡±ç‡∞®‡∞æ
Vijay Bhaskar	super bro dogalu
shakeeL syed	Inta story unda mana political science pitamahuduki
sandeep deepu	Very nice this vedio it s true
Kadasi Narender	Epatikina Ardhamaidha BALKA SUMAN PIDDA MURTHI RAVI KADIYAM SRI HARI DR RAJAYA
javvaji dattu	Ni
Ravi Kiran	Real story
Rajender Raja	‡∞Ö‡∞∞‡±á‡∞Ø‡±ç ‡∞ö‡∞¶‡±Å‡∞µ‡±Å‡∞ï‡±Å‡∞®‡±ç‡∞®‡∞æ‡∞∞‡∞æ ‡∞é‡∞µ‡±ç‡∞µ‡∞∞‡∞ø ‡∞Ö‡∞≠‡∞ø‡∞™‡±ç‡∞∞‡∞æ‡∞Ø‡∞Ç ‡∞µ‡∞æ‡∞∞‡∞ø‡∞¶‡∞ø ‡∞è‡∞¶‡∞ø‡∞è‡∞Æ‡±à‡∞®‡∞æ KCR ‡∞Æ‡±ã‡∞∏‡∞™‡±Ç‡∞∞‡∞ø‡∞§ ‡∞∞‡∞æ‡∞ú‡∞ï‡±Ä‡∞Ø‡∞æ‡∞≤‡∞ï‡±Å ‡∞á‡∞¶‡∞ø ‡∞í‡∞ï ‡∞®‡∞ø‡∞¶‡∞∞‡±ç‡∞∂‡∞®‡∞Ç
Srinu Dj	Na love da lo sodhi Onley kcr ledar
Sandeep Goudch	Super store anna
Basid Mohammad	Super sem my vill
naveen koulsha	Super ga undi Real ga kachara gaari biography
Uday Kumar	Ok Shetty antey Dorana
Karthik Raju	super Mallanna kallu theripinche kadha
MUDDAM BALARAJU	‡∞Ö‡∞∞‡±Ü ‡∞≤‡∞Ç‡∞ú‡∞æ‡∞ï‡±ä‡∞°‡∞ï‡∞æ ‡∞ï‡±á‡∞∏‡±Ä‡∞Ü‡∞∞‡±ç ‡∞ö‡±á‡∞∏‡∞ø‡∞® ‡∞™‡∞•‡∞ï‡∞æ‡∞≤‡±Å ‡∞∏‡∞Ç‡∞ï‡±ç‡∞∑‡±á‡∞Æ ‡∞´‡∞≤‡∞æ‡∞≤‡±Å ‡∞Æ‡±Ä ‡∞ï‡∞Ç‡∞°‡±ç‡∞≤‡∞ï‡±Å ‡∞ï‡∞®‡∞¨‡∞°‡∞ü‡∞Ç ‡∞≤‡±á‡∞¶‡∞æ ‡∞≤‡∞Ç‡∞ó‡∞æ‡∞≤‡±Å ‡∞≤‡∞§‡±ç‡∞ï‡±ã‡∞∞‡±ç ‡∞≤‡±Å ‡∞ï‡∞æ‡∞Ç‡∞ó‡±ç‡∞∞‡±Ü‡∞∏‡±ç ‡∞™‡∞æ‡∞∞‡±ç‡∞ü‡±Ä ‡∞≤‡±ã ‡∞Æ‡∞∏‡±ç‡∞§‡±Å‡∞ó‡±Å‡∞®‡±ç‡∞®‡∞æ‡∞∞‡±Å
Ch Koti	Excellent mallanna ‡∞ï‡∞æ‡∞∞‡±Å ‡∞ö‡±Ä‡∞ï‡∞ü‡±ç‡∞≤‡∞®‡±Å ‡∞§‡±ä‡∞≤‡∞ó‡∞ø‡∞Ç‡∞ö‡±á ‡∞ï‡∞∞ ‡∞¶‡±Ä‡∞™‡∞ø‡∞ï ‡∞Æ‡±Ä‡∞∞‡±Å
Rakesh Rakee	Super bro
praveen puskuri	ekkadudi doraia palana nijam nilAKADA MEEDA TELUSTHUNDI PACCHA KAMERLU VACHINA VADIKI LOKAMANTHA PACHAGANE AGU PADUTHUNDI
Nani Chanu	Kutha pagilli potundhi na kodaka evadu ra lavade
Venkatnarsimhareddy Y	‡∞¨‡∞≤‡±á ‡∞µ‡±Å‡∞Ç‡∞¶‡∞ø
vinod naik	super bro
Narend Ra	supar Anna mana bhathukulu maralla dhorala palana povalla anna
farukh khan	Real story of kcr
Avanish Avanishwarao	Really great true concept direction
shravan kavitha	Vijju super raüëåüëå
Balraju Rajaram	Nice criticism mallanna I like this
Varukolu Mahipal	Mallanna superb
Goud Saab	Nijanaga KCR gurunche andariki telusu Iyna KCR hey CM ithadu Anduku antey Opposition LA Correct leader ledu kabate Antha Picha kuntla badcow lu
Shyam Moyyeti	Superrrrr
Nithin Rao	elantivi eni dengina KCR ventruka kuda pikaleru
Ram Krishna	Every leader are like this
Shinde Govind	Super anna
upender ch	‡∞ö‡±Ç‡∞°‡∞Ç‡∞°‡∞ø Mr ‡∞Æ‡∞ø ‡∞∏‡±ç‡∞µ‡∞æ‡∞∞‡±ç‡∞•‡∞Ç ‡∞ï‡±ã‡∞∏‡∞Ç ‡∞é‡∞≤‡∞æ‡∞Ç‡∞ü‡±Ä ‡∞§‡±Ä‡∞∏‡∞ø medium nu ‡∞≤‡∞æ‡∞Ç‡∞ú‡∞≤‡±Å ‡∞ö‡±à‡∞µ‡∞¶‡±ç‡∞¶‡±Å ‡∞®‡±Å‡∞µ‡±Å ‡∞®‡∞ø‡∞ú‡∞Ç‡∞ó‡∞æ ‡∞™‡±ç‡∞∞‡∞ú‡∞æ ‡∞ö‡±à‡∞§‡∞®‡±ç‡∞Ø‡∞Ç ‡∞ï‡±ä‡∞∏‡∞Æ‡±ã ‡∞™‡±ç‡∞∞‡∞ú‡∞æ ‡∞∏‡±ç‡∞∞‡±à‡∞Ö‡∞∏‡±ç‡∞∏‡±Å ‡∞ï‡±ã‡∞∏‡∞Æ‡±ã ‡∞ö‡∞æ‡∞®‡±Ü‡∞≤‡±ç ‡∞™‡∞°‡∞ø‡∞§‡±á ‡∞®‡±Å‡∞µ‡±Å ‡∞®‡∞ø‡∞ú‡∞Ç ‡∞Æ‡∞æ‡∞ü‡±ç‡∞≤‡∞æ‡∞°‡±Å ‡∞§‡∞™‡±ç‡∞™‡±Å‡∞®‡±Å ‡∞Ö‡∞Ç‡∞¶‡∞∞‡∞ø ‡∞∏‡∞Æ‡∞ï‡±ç‡∞∑‡∞Ç ‡∞≤‡±ä ‡∞ñ‡∞Ç‡∞°‡∞ø‡∞Ç‡∞ö‡±Å ‡∞∞‡±á‡∞ü‡∞ø‡∞Ç‡∞ó‡±ç ‡∞ï‡±ä‡∞∏‡∞Ç ‡∞ü‡±à‡∞Ç ‡∞™‡∞æ‡∞∏‡±ç ‡∞ï‡±ä‡∞∏‡∞Ç ‡∞ö‡∞æ‡∞≤ ‡∞µ‡±Ä‡∞°‡∞ø‡∞Ø‡±ã‡∞∏‡±ç ‡∞ö‡±à‡∞í‡∞ö‡±Å
Rakesh uml	Super bro Inka elantivi cheyyandi
Gundagani Muralikrishna	Chala Baga tisav Anna u r great
M Ravi	Excellent
Rakeshyadav Supreme	‡∞Ö‡∞∞‡±á‡∞Ø‡±ç ‡∞Æ‡∞≤‡±ç‡∞≤‡∞ø‡∞ó‡∞æ ‡∞®‡∞ø ‡∞≤‡±Å‡∞ö‡±ç‡∞ö‡∞æ ‡∞µ‡±Ä‡∞°‡∞ø‡∞Ø‡±ã ‡∞≤‡∞®‡±Å ‡∞é‡∞µ‡∞°‡±Å ‡∞®‡∞Æ‡±ç‡∞Æ‡∞°‡±Å
suresh gurrala	Nirudhyoga dhrohi Kcr jitthulamari nakka oosaravalli Kcr Nirudhyoga dhrohi Kcr Nirudhyogula usuru thagili naashanam avuthundhani trs government
Telangana Chiranjeevi	Worst video
Syed Irfan	Dimpinavoga k c r ki
Ganesh Bathini	anna chala baga thisaru
dhanunjaya001 kanna	We r waiting for secound part bro
cc tamil	Good donganaa koduku kcr
Vijaykumar Boppe	Super dude
raju bureddy	Orey lanjakoduka eam matladuthunnav Jagratha bedda rodi midha kanipista champesam
2727siva	Arey dinchinav po
Banu Banu	Eamra malanna Naveen neku gudha Baga balisinda raa badkow gudha pagala denguta
Malleswararao Ginjupalli	what a directory
Kunta Ravanna	Sound üîä music üé∂ tho word Not clear
Harish Manchinella	Upa sarpanch balka suman
Sudheer Mudhiraj	Super bro
raghu naik k	Venaka mundu alochinchani erri 2
Santhosh Ch	mallanna mla ga chudali mimalni
Thirumala Raju	‡∞∞‡∞æ‡∞ú‡∞ï‡±Ä‡∞Ø ‡∞ï‡±Å‡∞§‡∞Ç‡∞§‡±ç‡∞∞‡∞æ‡∞≤‡±Å Super
Barma Prassu	Good parody
kkkk	At the end of the vedio u have shown a bit of episode 2 but I am not able to find in YouTube please give me the second episode link
Prabhakara Reddy	Supar acting
mahesh baru	Pacha kamerlu unna vadiki lokam anta pachaga kanipistadi anta ala undi me tokkalo pata janam kosam rayandi mahila abyunnathi kosam nicha samskruti unnadi desham lo Danni marchadaniki rayandi cheta kada vaak swatantaram echindi tittadaniki kadu Mana nunchi padi Mandi manchi nerchu kodaniki miru anto me stayi anto e patato theta tellam ayindi nenu a party vadini kadu nenu manishini manavatvam unna vadini
Sriramreddy pabbathi	Kochem over indhi mallanna
rakesh ramineni	Anna nuv super Anna
Ajay Konkati	‡∞∏‡±Ç‡∞™‡∞∞‡±ç ‡∞Ö‡∞®‡±ç‡∞®‡∞æ
Naga Bhai	good job Maharaj
Sathish Aedelli	super vijay bhai
Akshay Srimanthula	It s true shot film this wa happened in 2014 n going to happen in this time election in TELANGANA
penta redy	Badugu balaheena vargaalu kallu theruddam dorala ni raajakeeya la nunchi tharimi kodadaam
kranthi kumar	aa gadda mukkodi story kadanna telustundi chaala baaga nijam cheppav iisari vaadi taagubothu goonda partyni yem cheyyalo maaku baaga telsu
vilas thum	Supar
N NN	Loafer kcr gadu
Shekar Gdl	‡∞∏‡±Å‡∞™‡∞∞‡±ç ‡∞Ö‡∞®‡±ç‡∞®
Mahesh Gandhamala	Superb story üëå
samsweet sameer	Banchan bathukulaku alavatu padda pranamaaye miku gitlane kanavadthadu KCR sir
Siva Sagar	Enka episode kuda unayaa
naresh sunke	Evadu ra edu rajapeta lo shooting chesadu
B Ganesh	super good job bro ‡∞é‡∞µ‡∞°‡±Ü‡∞®‡±ç‡∞®‡∞ø ‡∞Ö‡∞Ç‡∞ü‡±Å‡∞®‡±ç‡∞® ‡∞á‡∞ü‡±ç‡∞≤‡∞æ‡∞®‡±á ‡∞â‡∞Ç‡∞°‡±Å
travels narasimha	Super Anna dongala rajyam
prasad babu	‡∞∏‡∞Ç‡∞™‡∞ø‡∞®‡∞µ‡±ç ‡∞™‡±ã ‡∞Ö‡∞®‡±ç‡∞®‡∞æ
sadhash rithu	Super broo
ram reddy	telangana nu andra vallu dochukunte em pikavu anna nuvvu dalithudu cm ayithe sontha talent tho kavali eppudu kcr nu target chesthav mari ee congress vallu goppavalla em nyayam ra nidhi
psp phd	E Fort Ekkada
Solipeta Mahesh	Nammethy dalithuni pranamaina estharu
md jameel	Bad story
praveen kumar	Brother super direction and natural Superb üëåüëåüëå
nithya aaradhana	‡∞ö‡∞æ‡∞≤‡∞æ ‡∞ï‡±Å‡∞ï‡±ç‡∞ï‡∞≤‡±Å nagetive ‡∞ó‡∞æ ‡∞Æ‡±ä‡∞∞‡±Å‡∞ó‡±Å‡∞§‡±Å‡∞®‡±ç‡∞®‡∞æ‡∞Ø‡∞ø ‡∞™‡∞ü‡±ç‡∞ü‡∞ø‡∞Ç‡∞ö‡±Å‡∞ï‡±ã ‡∞ï‡±Å ‡∞Æ‡∞≤‡±ç‡∞≤‡∞®‡±ç‡∞® ‡∞®‡±Ä ‡∞°‡±à‡∞∞‡±Ü‡∞ï‡±ç‡∞∑‡∞®‡±ç ‡∞∏‡±Ç‡∞™‡∞∞‡±ç
Rajasheker Dasari	fucking politics diverting youth fr every 5 yr
Chatarla Shravanth Kumar siddharthvemana	Super mallana
Madhu Nallala	Dhorala palana malla gurthusesindruu manchi concept pattinav Bayya‚úäüëå
Telugu Media	Thu nee bathuku cheda
Praveen studio Kulaspoor	‡∞®‡±Ä‡∞ï‡±Å ‡∞∞‡±ã‡∞ú‡±Å‡∞≤‡±Å ‡∞¶‡∞ó‡±ç‡∞ó‡∞∞‡∞™‡∞°‡±ç‡∞°‡∞æ‡∞Ø‡∞ø ‡∞∞‡∞æ ‡∞Æ‡∞≥‡±ç‡∞≥‡±Ä
Candid Dare	Arey malli ga endi ra idhi
Sakkaram Srikanth	Super natural We are expecting more brother
Haribabu Ooredoo	‡∞í‡∞∞‡±á‡∞Ø‡±ç ‡∞Æ‡∞¶‡∞∞‡±ç ‡∞ö‡±ã‡∞§‡±Å ‡∞ó‡∞æ ‡∞∏‡∞ø‡∞ó‡±ç‡∞ó‡±Å‡∞≤‡±Ü‡∞¶‡∞µ‡±Å‡∞¨‡±á ‡∞¨‡±ã‡∞∏‡∞ø‡∞°‡∞ø‡∞ï‡±á ‡∞§‡±Ä‡∞∏‡∞ø‡∞®‡∞µ‡∞æ‡∞°‡±Å ‡∞é‡∞µ‡∞°‡±Å ‡∞∞‡∞æ ‡∞é‡∞®‡±ã ‡∞â‡∞¶‡±ç‡∞Ø‡∞Æ‡∞æ‡∞≤‡±Å ‡∞ö‡±á‡∞∏‡∞ø ‡∞™‡±ç‡∞∞‡∞æ‡∞£‡∞æ‡∞≤‡∞®‡±Å ‡∞ï‡±Ç‡∞°‡∞æ ‡∞≤‡±á‡∞ï ‡∞ö‡±á‡∞Ø‡∞®‡∞ø ‡∞ï‡±Ü‡∞∏‡∞ø‡∞Ü‡∞∞‡±ç ‡∞ó‡∞æ‡∞∞‡∞ø‡∞®‡∞ø ‡∞Ö‡∞Ç‡∞ü‡∞æ‡∞µ‡∞æ ‡∞Æ‡∞¶‡∞∞‡±ç ‡∞ö‡±ã‡∞§‡±Å ‡∞ï‡±ä‡∞°‡±Å‡∞ï‡∞æ ‡∞ö‡±Ü‡∞™‡±ç‡∞™‡±Å‡∞≤ ‡∞™‡∞ü‡±ç‡∞ü‡∞ø ‡∞∏‡∞Ç‡∞™‡±Å‡∞§‡∞æ‡∞Ç ‡∞≤‡±Å‡∞ö‡±ç‡∞ö‡∞æ ‡∞®‡∞æ ‡∞ï‡±ä‡∞°‡±Å‡∞ï‡±Å‡∞≤‡∞æ‡∞∞‡∞æ
Pk	Em video ra edhi dhintlo thagudu bhukkudu thappa
Muni Swamy	Evideo KCR chusthe andarini intiki pilichi üí£ü§õü§úü§õü§ú
AK7595 AK	Seemandhra palana kanna KCR palana goodüëç Jai KCRüëç
Sandeep Basaraveni	Super film kcr reality
Venkatesh Goud	‡∞∏‡±Ç‡∞™‡∞∞‡±ç
Raghu Kasula	Kcr real story
NKL pc	‡∞á‡∞¶‡∞ø ‡∞é‡∞µ‡∞∞‡∞ø‡∞ï‡∞ø ‡∞Æ‡∞Ç‡∞°‡∞≤‡±ã ‡∞Ö‡∞ï‡±ç‡∞ï‡∞° ‡∞Æ‡∞Ç‡∞°‡±Å‡∞¶‡∞øüëå
vamsi chaitanya	Ka cha raa gaadi reality kcr hataavo t bachaavo
Kottur Aravind Kumar	‡∞∏‡±Ç‡∞™‡∞∞‡±ç video
A k	E music ventey raktha charitra cinema gurthu vasthundi
nenavath ram	üëåüëå
sunil reddy	Next cm kcr pakka rithulaku rithubandhu current eruvulu timeki vasthunnai great cm
prashanth palle	‡∞è‡∞§‡±Å‡∞≤ ‡∞™‡±ã‡∞∑‡∞ø
Attitude Matter's	‡∞ï‡±Ü‡∞∏‡∞ø‡∞Ü‡∞∞‡±ç xerox ‡∞ï‡∞æ‡∞™‡±Ä ‚ò∫Ô∏èüòäüòâüòÇüòÄ
Donthireddy narendar reddy	Same to same kcr
Naveen Dj	‡∞¶‡∞≥‡∞ø‡∞§‡±Å‡∞≤‡∞®‡∞ø ‡∞Æ‡±Å‡∞ñ‡±ç‡∞Ø‡∞Æ‡∞Ç‡∞§‡±ç‡∞∞‡∞ø ‡∞ö‡±á‡∞∏‡±ç‡∞§‡∞æ‡∞®‡±Å ‡∞Ö‡∞®‡∞ø ‡∞™‡±ç‡∞∞‡∞∂‡±ç‡∞®‡∞ø‡∞Ç‡∞ö‡∞æ‡∞∞‡±Å ‡∞ï‡∞æ‡∞®‡±Ä ‡∞á‡∞™‡±ç‡∞™‡±Å‡∞°‡∞ø ‡∞¶‡∞ó‡∞æ ‡∞è‡∞Æ‡∞ø ‡∞ö‡±Ü‡∞Ø‡±ç‡∞Ø‡∞≤‡±á‡∞¶‡±Å ‡∞è‡∞Æ‡∞ø ‡∞Æ‡±Å‡∞ñ‡±ç‡∞Ø‡∞Æ‡∞Ç‡∞§‡±ç‡∞∞‡∞ø ‡∞ï‡±á‡∞∏‡±Ä‡∞Ü‡∞∞‡±ç ‡∞®‡±Ä‡∞µ‡±Å
sandesh reddy	Exactly village lo politics elage vuntay
Vamshi Kris	Arey malli ga nee gudha pagulthadhi ra thondarlo Antha paisal thisukunav ra makedey
Shekar Shekar	Mallanna nuvvu super
santosh yedugani	Ante votti KCR is drunkard aah Congress lonandharu cow milk thagutharu Suda pusallu arey personal life endhuku rah meeku state development ayithudha ledha anadhi important Congress la andharu nidhra aharulu maani scam chesi peekinruh pichi erri puukkku video siggu la√†jaa ledhu na kondukulakhi Thu mi bhathukulu
Murali Yadav	‡∞Ö‡∞∞‡±á ‡∞Æ‡∞≤‡±ç‡∞≤‡∞ø‡∞ó‡∞æ ‡∞®‡±Ü‡∞≤‡∞ï‡±ã ‡∞õ‡∞æ‡∞®‡±Ü‡∞≤‡±ç ‡∞Æ‡∞æ‡∞∞‡±á ‡∞®‡±Å‡∞µ‡±ç‡∞µ‡±Å ‡∞ö‡±Ü‡∞™‡±ç‡∞§‡±Å‡∞®‡±ç‡∞®‡∞µ‡∞æ ‡∞®‡±Ä‡∞ï‡±Å mlc ‡∞ü‡∞ø‡∞ï‡±ç‡∞ï‡±Ü‡∞ü‡±ç ‡∞á‡∞µ‡±ç‡∞µ‡∞≤‡±á‡∞¶‡∞®‡∞ø ‡∞ï‡∞ï‡±ç‡∞∑‡±ç‡∞Ø ‡∞∏‡∞æ‡∞ß‡∞ø‡∞∏‡±ç‡∞§‡±Å‡∞®‡±ç‡∞®‡∞µ‡∞æ ‡∞®‡±Å‡∞µ‡±ç‡∞µ‡±ä‡∞ï ‡∞∏‡±ç‡∞µ‡∞æ‡∞∞‡±ç‡∞•‡∞™‡∞∞‡±Å‡∞°‡∞ø‡∞µ‡∞ø ‡∞§‡±Ü‡∞≤‡∞Ç‡∞ó‡∞æ‡∞£ ‡∞Ö‡∞≠‡∞ø‡∞µ‡±É‡∞¶‡±ç‡∞ß‡∞ø‡∞®‡∞ø ‡∞Ö‡∞°‡±ç‡∞°‡±Å‡∞ï‡±Å‡∞®‡±á ‡∞®‡±Ä‡∞≤‡∞æ‡∞Ç‡∞ü‡∞ø ‡∞µ‡∞æ‡∞≥‡±ç‡∞≤‡±á‡∞∞‡∞æ ‡∞®‡∞ø‡∞ú‡∞Æ‡±à‡∞® ‡∞§‡±Ü‡∞≤‡∞Ç‡∞ó‡∞æ‡∞£ ‡∞¶‡±ç‡∞∞‡±ã‡∞π‡±Å‡∞≤‡±Å ‡∞®‡±Ä‡∞ï‡±Å‡∞Ç‡∞¶‡∞ø‡∞∞‡∞æ ‡∞ï‡±á‡∞∏‡±Ä‡∞Ü‡∞∞‡±ç ‡∞∏‡±Ä‡∞é‡∞Ç ‡∞Ö‡∞Ø‡±ç‡∞Ø‡∞æ‡∞ï ‡∞è‡∞Ç ‡∞™‡±Ä‡∞ï‡∞æ‡∞∞‡±Å ‡∞ó‡∞§ ‡∞™‡±ç‡∞∞‡∞≠‡±Å‡∞§‡±ç‡∞µ‡∞æ‡∞≤‡±Å ‡∞®‡±Ä‡∞ï‡±Å ‡∞ï‡∞≥‡±ç‡∞≥‡±Å ‡∞Æ‡∞ø‡∞Ç‡∞ó‡∞Ø‡∞æ ‡∞¶‡∞µ‡∞°‡∞ó‡∞æ
Pradeep Kumar Pradeep Kumar	edhi real kcr seen
Praveen Yaram	good
Mohan Visalavath	k c r real story
Sai Kumar	Super acting
rowdy series	Anna super story anna
Rajesh Naani	2nd episode eppudu anna
Aakula Ramaiah	Super kcr nija swaroopam edi
Soori Ponnoti	Super
venkat Ramana.	Kcr story
—Ç–Ω—î —ï—ÇŒ±—ÇœÖ—ï	ü§£
ravinder 001 karra001	Congress kukka ea mallanna gadu
ravi dar	Super
Nani Creations	Mo aaa lekka undi
srikanth manchala kamareddy tourism	‡∞∏‡±Å‡∞™‡±ç‡∞™‡∞∞‡±ç ‡∞Æ‡∞≤‡±ç‡∞≤‡∞®‡±ç‡∞® ‡∞§‡±Ü‡∞≤‡∞Ç‡∞ó‡∞æ‡∞£ ‡∞¶‡±ä‡∞∞ ‡∞ó‡±Ç‡∞∞‡±ç‡∞ö‡∞ø ‡∞ö‡±Ü‡∞™‡±ç‡∞™‡∞ï‡∞®‡±á ‡∞ö‡±Ü‡∞™‡±ç‡∞™‡∞ø‡∞®‡∞µ‡±ç ‡∞á‡∞Ç‡∞§‡∞ï‡±Ä ‡∞à ‡∞ó‡∞°‡∞ø ‡∞è ‡∞ä‡∞∞‡∞ø‡∞≤‡±ã‡∞®‡∞ø ‡∞¶‡∞ø
Santhosh Kumar	Bgm mareee ekkuvundi set kale
my village creation vlbp	nice bro msg
Arsha Rajinikanth555	Super video it s really fact
V S	‡∞§‡±Ü‡∞≤‡∞Ç‡∞ó‡∞æ‡∞£ ‡∞∞‡∞æ‡∞∑‡±ç‡∞ü‡±ç‡∞∞‡∞Ç ‡∞∞‡∞æ‡∞ï‡∞Æ‡±Å‡∞Ç‡∞¶‡±Å ‡∞è‡∞° ‡∞™‡∞®‡±ç‡∞®‡∞µ‡±Å ‡∞Æ‡∞≤‡±ç‡∞≤‡∞ø‡∞ó‡∞æ ‡∞∞‡±Ü‡∞°‡±ç‡∞°‡∞ø ‡∞™‡∞ü‡±á‡∞Ç‡∞°‡±ç‡∞≤ ‡∞ó‡±Å ‡∞ï‡∞°‡∞ø‡∞ó‡∞ø‡∞®‡∞ü‡±ç‡∞ü‡±Å‡∞®‡±ç‡∞®‡∞µ‡±Å ‡∞®‡±Ä‡∞≤‡∞æ‡∞Ç‡∞ü‡±ã‡∞®‡∞ø‡∞ï‡∞ø ‡∞µ‡∞æ‡∞≤‡±ç‡∞≤‡±á ‡∞ï‡∞∞‡±Ü‡∞ï‡±ç‡∞ü‡±ç ‡∞∞‡±á‡∞µ‡∞Ç‡∞§‡±ç ‡∞∞‡±Ü‡∞°‡±ç‡∞°‡∞ø ‡∞∏‡∞Ç‡∞ï‡∞≤‡±ã ‡∞ú‡±á‡∞∞‡±Å ‡∞Æ‡∞∏‡±ç‡∞§‡±Å‡∞Ç‡∞ü‡∞¶‡∞ø
shekhar munukuntla	Rip dora
myview channel	Super bro today s telangana political situation chupinchavu
kotakonda 996623143	Chaduvu Leni vaallu Alage unnaru mariyu Chaduvu kunna vaallu Alage unnaru
Nithin Rao Ailineni	Nuvedo kcr tho kurchoni taginatay chupettavu ne acting aaskar award ki undalsina standard ki ekkuva undi neku award ay ledu musaloda
shiva kumar	Super keka kathi eega doma cheema hahahahahahaha
ravinder reddy	Super realizing
srishilam yadav	Jai KCR
chiguru maheshwar	Super video Mallanna
Jagan Vemula	Exellent
MOHD PASHA	Arai aa Dori ra telagana kosam kotladinde
Harish Velpula	Ok bro
naresh physics tut	Super episode
Nagarjuna Vangaveti	This is real face of all political leader in India I am not sure why you are pin pointing KCR only This trend start from NTR now CBN Cong TRS following
Ranjith Dass	üòÜüòÜüòÜüëå
Kokila Raghunath	Same to same KCR story lane undi anna
Sai Bhargava	Lanjakoduka Congress notlo sulli pedatadi cheekandi Yedava thelivi thetalu chupinchaku lanjakoduka Lara
Venkateswarlu Ithraju	Eee video chesina yerripuka Mallanna gariki Okati chepthunna ee video chesi nuvvu chaala thappu chesinav ra Malli trs govt vasthadi Okka Jobs vishayam lo thappa annitlo correct ga ne chesaru 60 year TS ni paalinchina howla congress tdp yedhava lu Telangananu develop cheyaledhoo Avnu kcr dhalithudini C M chesta ani cheyaledhu kaaranam aa time lo kothaga vachina State nidhulani dhochukodaniki aa bolli babu gadi plan vesadu aa time lo kcr c m ga correct antha mogolle aithe Ippudu gelvandra chuddham Rey ee video evadu chesado vaadiki PH pension garunty ga isthdu k cr
Raju dugyani	extraordinary taking
Bharath Mekala	Thammi ee kalamla mana Rajakiyalu ilane unnayi kondharu jAnthuvulavale unnaru chadhuvukunna menu villanu yedho chedham anukunna kani chaduvurani valani marchina tharuvathe mana rajakiyalu marchavachu Anna okati cm gani pm gani varu mana kindha pani chesevaaru kani manam vala kindha pani chesthe vallamu kadhu chadhu vu kunna varu mundhu miru ilanti vati ki nammaka mana rashtranni dheshanni kapadudham jai India I love india
Vikky varma	Good reality of kcr
Naresh Kumar	Doralu evaru telsu mana Telangana lo
ramdas naik	Prathi uri story itlane undi
shaik DSP	‡∞Æ‡±Ä‡∞∞‡±Å ‡∞é‡∞®‡±ç‡∞®‡∞ø ‡∞µ‡±Ä‡∞°‡∞ø‡∞Ø‡±ã‡∞≤‡±Å ‡∞§‡±Ä‡∞∏‡∞ø‡∞® ‡∞é‡∞®‡±ç‡∞®‡∞ø ‡∞µ‡±á‡∞∑‡∞æ‡∞≤‡±Å ‡∞µ‡±á‡∞∏‡∞ø‡∞®‡∞æ ‡∞§‡±Ü‡∞≤‡∞Ç‡∞ó‡∞æ‡∞£‡∞ï‡±Å ‡∞ï‡∞æ‡∞¨‡±ã‡∞Ø‡±á ‡∞∏‡±Ä‡∞é‡∞Ç ‡∞ï‡±á‡∞∏‡±Ä‡∞Ü‡∞∞‡±ç
Sanjeev Buram	nijam
Mittapally Harish	Mallanna it s true
Satishkumar Gangula	Mr malli ‡∞§‡∞æ‡∞ó‡±Å‡∞¨‡±ã‡∞§‡±Å ‡∞µ‡±á‡∞∑‡∞ß‡∞æ‡∞∞‡∞£‡∞≤‡±ã CM KCR ‡∞®‡±Ä ‡∞ö‡±Ç‡∞™‡∞ø‡∞Ç‡∞ö‡∞ø ‡∞∏‡±ä‡∞∏‡±à‡∞ü‡±Ä ‡∞ï‡∞ø ‡∞é‡∞Ç‡∞ö‡±Ü‡∞™‡±ç‡∞™‡∞≤‡∞®‡∞ø‡∞ï‡±Å‡∞®‡±ç‡∞®‡∞µ‡±ç ‡∞Ö‡∞§‡∞®‡±Å ‡∞®‡±Ä ‡∞ï‡∞æ‡∞Ç‡∞ó‡±ç‡∞∞‡±Ü‡∞∏‡±ç‡∞∏‡±ç ‡∞≤‡∞æ‡∞ó‡∞æ ‡∞∏‡±Ä‡∞≤‡±ç‡∞°‡±ç ‡∞ï‡∞µ‡∞∞‡±ç ‡∞∏‡±Ä‡∞é‡∞Ç ‡∞ï‡∞æ‡∞¶‡±Å ‡∞∏‡±Ä‡∞≤‡±ç‡∞°‡±ç ‡∞ï‡∞µ‡∞∞‡±ç ‡∞¨‡∞§‡±Å‡∞ï‡±Å ‡∞ï‡∞æ‡∞¶‡±Å ‡∞™‡±ç‡∞∞‡∞ú‡∞≤‡∞ö‡±á ‡∞é‡∞®‡±ç‡∞®‡±Å‡∞ï‡±ä ‡∞¨‡∞°‡±ç‡∞° CM ‡∞Ö‡∞Ç‡∞ü‡±á ‡∞®‡±Ä‡∞ï‡±Å ‡∞™‡±ç‡∞∞‡∞ú‡∞≤‡∞Ç‡∞ü‡±á ‡∞∞‡±Ü‡∞∏‡±ç‡∞™‡±Ü‡∞ï‡±ç‡∞ü‡±ç ‡∞≤‡±á‡∞¶‡∞æ ‡∞™‡±ç‡∞∞‡∞ú‡∞æ‡∞∏‡±ç‡∞µ‡∞æ‡∞Æ‡±ç‡∞Ø‡∞Ç ‡∞Ö‡∞Ç‡∞ü‡±á ‡∞∞‡±Ü‡∞∏‡±ç‡∞™‡±Ü‡∞ï‡±ç‡∞ü‡±ç ‡∞≤‡±á‡∞¶‡∞æ ‡∞Æ‡∞∞‡∞ø ‡∞§‡±Ü‡∞≤‡∞Ç‡∞ó‡∞æ‡∞£ ‡∞ï‡±ã‡∞ü‡±ç‡∞≤‡∞æ‡∞¶‡∞ø ‡∞§‡±Ü‡∞ö‡±ç‡∞ö‡∞ø‡∞Ç‡∞¶‡∞ø ‡∞Æ‡±Ä ‡∞â‡∞§‡±ç‡∞§‡∞Ç ‡∞ó‡±ç‡∞∞‡±Ç‡∞™‡±ç ‡∞Ö‡∞®‡±Å‡∞ï‡±Å‡∞Ç‡∞ü‡±Å‡∞®‡±ç‡∞®‡∞æ‡∞µ‡∞æ ‡∞Æ‡∞æ‡∞ï‡±Å ‡∞ï‡∞æ‡∞µ‡∞æ‡∞≤‡±ç‡∞∏‡∞ø‡∞Ç‡∞¶‡∞ø ‡∞¶‡∞≥‡∞ø‡∞§ ‡∞Æ‡±Å‡∞ñ‡±ç‡∞Ø‡∞Æ‡∞Ç‡∞§‡±ç‡∞∞‡∞ø ‡∞ï‡∞æ‡∞¶‡±Å ‡∞™‡±ç‡∞∞‡∞ú‡∞≤ ‡∞¨‡∞æ‡∞ó‡±Å‡∞ï‡±ã‡∞∏‡∞Ç ‡∞™‡∞®‡∞ø‡∞ö‡±á‡∞∏‡±á ‡∞ï‡±Ü‡∞∏‡∞ø‡∞Ü‡∞∞‡±ç ‡∞≤‡∞æ‡∞Ç‡∞ü‡∞ø ‡∞Æ‡±Å‡∞ñ‡±ç‡∞Ø‡∞Æ‡∞Ç‡∞§‡±ç‡∞∞‡∞ø ‡∞ï‡±Å‡∞≤‡∞Ç ‡∞ï‡±Å‡∞≤‡∞Ç ‡∞Ö‡∞®‡∞ø ‡∞™‡±ç‡∞∞‡∞ú‡∞≤ ‡∞Æ‡∞¶‡±ç‡∞Ø ‡∞ö‡±Ä‡∞≤‡∞ø‡∞ï ‡∞§‡±á‡∞µ‡∞°‡∞Ç ‡∞®‡±Ä‡∞ï‡±Å ‡∞§‡∞ó‡∞¶‡±Å
ranjithkumar netha	Facts
Amgoth Sanjeeva	‡∞®‡±Ä ‡∞Ö‡∞Æ‡±ç‡∞Æ ‡∞µ‡±Ü‡∞∏‡±ç‡∞ü‡±ç ‡∞®‡∞æ ‡∞ï‡±ã‡∞°‡∞ï
Dara nani	‡∞á‡∞¶‡∞ø ‡∞®‡∞ø‡∞ú‡∞Ç
KASHIREDDY VINAY REDDY	neku andhuku ra dhula first malantivalllu undabatti dhesham Ela undhe arae chesthae Anne partyla medha vdo cheyu anthae Kane me dhrushti lo andharu mancholu kadha m adukunnae bathukulu
manupati Kiranraj	Jai congress jai jai congress
Billakanti ARAVIND REDDY	Simply superb and this is past present and future politics No one can change
Poshetty Jakka	Super real story
Ganesh patel abudhabi	Super correct
harish kudurupaka	Excellent
sagar diamond	Awesome
Karthikreddy Mannem	Srinu nani Anna acting keka po
Rajesh Rao	pikinavthi
sravan balmoori	Avunu ra lanjakodukullara congress meedha kuda pettakapoyindru 60 endlu mana andhari gudda dengutuntey em matladaley eppudu KCR thaguthadu and vadu dora rashtranni thechhinodu ra vadu ina me phalthu dimag gallaku ardham kadu Arey musaloda neeku ticket evvakuntey TRS antey antha alusa madarchodüò°
K Venkatesh	Sare antay ni lekka prakhara telangana prajalu 200 rupalaku oka qater sisaku otu vestharu ledis 100 r otu vestharu anthayna ore lanja koduka ni pellani pampu 100 ku neeku mla tikect isthadu mi musalodu
Laxmi Narayana	arey Lanja koduka elanti vidio chesi kcr gurinchi thapuga matladithe cheputho kodatha niyabba jai kcr
Uday Kiran	Simply aptüòÇ
malli bds	‡∞ö‡±Ü‡∞§‡±ç‡∞§ ‡∞≤‡∞Ç‡∞¨‡∞ø‡∞°‡∞ø ‡∞ï‡±ä‡∞°‡±Å‡∞ï‡∞æ ‡∞á‡∞Ç‡∞§‡∞ï‡∞Ç‡∞ü‡±á ‡∞µ‡∞æ‡∞∞‡±ç‡∞§‡∞≤‡±Å ‡∞≤‡±Ü‡∞µ‡±ç‡∞µ‡∞∞‡∞æ ‡∞¶‡±Å‡∞®‡∞ø‡∞Ø‡∞æ‡∞≤
Pkumar Kumar	Wonderful brother real story
krishna thalari	excellent satire on present tendency
Vinod Dasari	can u tell the background loccation area which district mandal
Burra Srinivas	batkala phoshetti ok ettula yellaiah addi
raheem Raheem	kcr sir good ledar ra ok kcr lekunty thelagna ledu ok plz kcr devudura
Mahesh Yadav	‡∞Æ‡±Ä‡∞∞‡±Å ‡∞é‡∞®‡±ç‡∞®‡∞ø ‡∞∏‡∞ø‡∞®‡∞ø‡∞Æ‡∞æ‡∞≤‡±Å ‡∞§‡±Ä‡∞∏‡∞ø‡∞®‡∞æ ‡∞ó‡±Ü‡∞≤‡±Å‡∞™‡±Å ‡∞ï‡±á‡∞∏‡±Ä‡∞Ü‡∞∞‡±ç ‡∞¶‡±á ‡∞é‡∞Ç‡∞¶‡±Å‡∞ï‡±ã ‡∞°‡∞ø‡∞∏‡±Ü‡∞Ç‡∞¨‡∞∞‡±ç 11 ‡∞® ‡∞ö‡±Ç‡∞∏‡±ç‡∞§‡∞∞‡±Å
creative king	Arey Malli ga neku enka Budhi raaleda Ra kojja lanjakodukaa NV em chysina am pikalevu kojja ga
goutham varma	USARAVELLI
naitham samba	KCR BIOGRAPHY
suresh satla	‡∞à ‡∞ü‡∞æ‡∞≤‡±Ü‡∞Ç‡∞ü‡±ç ‡∞®‡±Å ‡∞∏‡∞ø‡∞®‡∞ø‡∞Æ‡∞æ‡∞≤ ‡∞∏‡±Ç‡∞™‡∞ø‡∞§‡±ç‡∞§‡±Ü ‡∞∞‡∞æ‡∞ú‡∞Æ‡±å‡∞≥‡∞ø ‡∞Ö‡∞Ç‡∞§‡∞ü‡∞ø ‡∞µ‡∞æ‡∞°‡∞µ‡±Å‡∞§‡∞µ‡±ç ‡∞Æ‡∞® ‡∞ú‡∞æ‡∞§‡±Ä‡∞Ø ‡∞™‡∞™‡±ç‡∞™‡±Å ‡∞∞‡∞æ‡∞π‡±Å‡∞≤‡±ç ‡∞ó‡∞æ‡∞Ç‡∞ß‡±Ä ‡∞Æ‡±Ä‡∞¶ ‡∞á‡∞≤‡∞æ‡∞Ç‡∞ü‡∞ø ‡∞µ‡±Ä‡∞°‡∞ø‡∞Ø‡±ã ‡∞ö‡±Ü‡∞Ø‡±ç
Gurana Chakri	Super
Satya B	Super
Rupath Kumar	ni pe m dhe e jai TRS
syam kumar	Good counter to kcr
uttam kiran	Mallana this is too much Kcr did good thing y can t u tel this From last few year ur doing negative thing on CM Kcr stop it yaar Soonly u I ll pay for this
Ajay Patel	super video
rukodar chirige	Rajapeta kota
Nemalika Sreekanth	Superrrrrrrrrr
Sathish Pallepati	Kcr seat ivvaledhani malligadu video chesindu rahul seat ivvaka pothe vadi video theesthadu mundhu gilanti aashinche kukkalani tharimi kottale
DileepReddy Bandi	Supar video
VIPLAVAM VARDHILLALI	Wow supper anna
Dasoju Gopiekrishna	Sadhuvukunoniki dhamak ledhu Sadhuvukononiki dhamak ledhu Dhorala rajyam
Rambabu Rambabu	Super video anna
DINESH POGULA	Same a dimpesaru bayya
srinivas goud	Excellent video Back ground music wa high light for every situation and scene
narapaka laxman	Bro awesome edhi mana Telangana lo jarigina true story ma dhalithulaki jarigina unnadi unnattu chupinchinav bayya üëèüëèüëèüëèüëè
Naveen Kumar	Rahul gandhi oka medhavi mari
Laxmi Goutham	Super taking
Swamy Bairagony	Em kottinavanna
Devae Shetty	idiot mllanna i fuck
Mr K	kallaki kattinattu chupincharu excellent anna
santosh chary	niku kcr meda kopam undi mallanna ah kopam anduko kuda telusu nuv a ticket adginav ah ticket evale but ne kopani mottam socicety meda chupiste atla epudu avaru atla leru anta ammayakanga telangana lo dalithulu leru e 2018 lo veru ga chupiyalsina avasaram ledu e avakasha vada rajakiyallo andaru ani party valu samaname repu congres vachina nka avaru mata tapparu anukuntva
Raju Vasam	inka chala theeyali
suresh jeerla	Jai kcr
Sri Kanth	Bro mor video
lakan gajjela	super ga undi Anna
rock star	Arei luchhaga telangana prjalu korukunedhi samardhudina cm ni vadu e cast vadu anndhi mukyam kadhu nuvvu nee short film em chupinchanv andhulo Nee pokkalaku podha mandhu Nee congress olla pkkalaku podha politics ni busness chesi aandra palakula kalla kindha bathiki telangana prajala raktham thagina congrees dongalaku nee suport
Shaik  Musthafa	Superb Ra Vijay
my channel ram	Thagubothu cm
Sangem Sridhar	super super
Venkat S	Keka anna
peterson G	Mallanna Super
Mallikarjuna Yadav	Dare attempt
Rao Shankar	‡∞∏‡±Ç‡∞™‡∞∞‡±ç story all the best
bollepally swamygoud	Super skit
Narender Chintalachervu	Am Mallanna Evadu Ticket ivvaledu 10 TV Job lonchi teesesindu Ne brathuku Kukka barhukaindi Elanti Video s theeskoni bhathuku
Shaik jani Jani	Meru avesham padakundi Andari paristiti anthe andharu political ente eme kottaga ledu
RAJAMALLU NIJANAPURAM	Behind politics open secret
Uppu Sampath	Arey avle trs doralapalana mari congress la reddy gadu unnadu mari tdp androdaye mari avalanu cheddame cm
Ranjith Reddy	Excellent Thank you for uploading All these day I wa wondering how KCR wa able to manage people This video gave me knowledge on part of it Thanks a lot üôè
Bhaskar Goud	Super
Seenu Seenu	super
DANADI NAGESH YADAV	Jai KCR
dasu rana	üëåüëåüëå supper mallanna
Kolli Hariprasad	Super Anna exlent story and direction Inka Manchi story cheyali meeru nice
Kiran Pothankar	Super RGV kante baga chesaru
Mahipal Kanka	lanjakoduka anti ra edi
Vijay Jella	Real store thz iz ture
Rajender rao Kasu	No mokam la vundi sodi na koduka mari Kodandaram Babu ga ni thu kalavadan bagudara musaloda
Prashanth Beri	‡∞ï‡∞ö‡∞∞ ‡∞∞‡∞ø‡∞Ø‡∞≤‡±ç ‡∞∏‡±ç‡∞ü‡±ç‡∞∞‡±ã‡∞∞‡±Ä
sri sriramwar	Kcr
KIRAN P	Mallanna next title FARMHOUSE JEMMUKKULU cheyandi
satya pal	Many more episode required Mallanna true colour to be exposed
Sravan Yadav	Super mallanna
mallesh kuruma	Super anna
Radha Krishna Ramagiri	Deputy CM CM Ministers Farm house location Costume farm house brandy Adda location bagundi Ittadi Telangana title super Idi Box office hit guru
Seetharamaiah Janumanchi	Pichi naakodukulaku idi badithe thelangaana kooda gurthunchukondi haddulu meera vaddu maakoo mee gottam babulapy partylapy serial rayochu thinedi thelangana thindi paade patalu pagati mogalla paatalu intikelli mee pagati dorala photolu pettukoni bhajanalu chesukondi punyam vasthundi chillara postlu pedithe copy theesi p lo complient cheyyadam kooda maaku thelusu
Sravan A	suuuuuuuuuuuprrrrrrprrrrrr superrrrrrrrrrrrr super superrrrrrrrrrrrrrrrrrrr super anna üëåüëåüëåüëåüëåüëåüëåüëåüëå
prasanthi bonam	Great e video ni v6 ki share cheyyandi bro highlight vuntadhi üòÇüòÇüòÇ
Harsha Vardhan	Eguru ra mallanna DEC 11 varakey kada nuvu entha ekirina
Gopi maddela	Super anna
shiva musku	‡∞Ö‡∞Ø‡±ç‡∞Ø‡∞æ ‡∞Ö‡∞Æ‡±ç‡∞Æ ‡∞™‡±Ü‡∞ü‡±ç‡∞ü‡∞ø‡∞®‡∞æ ‡∞™‡±á‡∞∞‡±Å ‡∞ö‡±Ü‡∞™‡±ç‡∞™‡±Å‡∞ï‡±ã‡∞≤‡±á‡∞®‡∞ø ‡∞µ‡∞æ‡∞°‡∞ø‡∞µ‡∞ø ‡∞®‡±Å‡∞µ‡±ç‡∞µ‡±Å ‡∞®‡±Å‡∞µ‡±ç‡∞µ‡±Å ‡∞ö‡∞¶‡∞ø‡∞µ‡∞ø‡∞®‡∞æ ‡∞ï‡∞æ‡∞≤‡±á‡∞ú‡±ç ‡∞®‡∞Ç‡∞¶‡±Å ‡∞Æ‡±á‡∞Æ‡±Å ‡∞ö‡∞¶‡∞ø‡∞µ‡∞ø‡∞®‡∞Ç ‡∞ï‡∞æ‡∞®‡±Ä ‡∞í‡∞ï ‡∞µ‡∞ø‡∞≤‡±á‡∞ñ‡∞∞‡±Ä ‡∞µ‡±É‡∞§‡±ç‡∞§‡∞ø ‡∞µ‡∞ø‡∞¶‡±ç‡∞Ø‡∞æ ‡∞®‡±Å‡∞Ç‡∞°‡∞ø ‡∞í‡∞ï ‡∞∞‡∞æ‡∞ú‡∞ï‡±Ä‡∞Ø ‡∞™‡∞æ‡∞∞‡±ç‡∞ü‡±Ä‡∞≤‡∞ï‡±Å ‡∞ï‡±ä‡∞™‡±ç‡∞™‡±Å ‡∞ï‡∞æ‡∞∏‡±ç‡∞§‡±Ç ‡∞á‡∞Ç‡∞ï‡∞æ ‡∞é‡∞Ç ‡∞∏‡±Ä ‡∞ú‡±á ‡∞µ‡∞ø‡∞¶‡±ç‡∞Ø‡∞æ‡∞∞‡±ç‡∞•‡∞ø‡∞®‡∞ø ‡∞Ö‡∞®‡∞ø ‡∞è‡∞° ‡∞ö‡±Ü‡∞™‡±ç‡∞™‡∞ï‡±Å ‡∞®‡∞µ‡±Ä‡∞®‡±ç ‡∞Ö‡∞®‡±ç‡∞® ‡∞Ö‡∞µ‡±Å‡∞®‡±Å ‡∞Æ‡±á‡∞Æ‡±Å ‡∞è ‡∞™‡∞æ‡∞∞‡±ç‡∞ü‡±Ä‡∞ï‡∞ø ‡∞§‡±ä‡∞•‡±Å‡∞≥‡∞Ç ‡∞ï‡∞æ‡∞¶‡±Å ‡∞è mlc ‡∞ü‡∞ø‡∞ï‡±ç‡∞ï‡±Ü‡∞ü‡±ç ‡∞µ‡∞¶‡±ç‡∞¶‡±Å ‡∞õ‡∞æ‡∞®‡∞≤‡±ç ‡∞™‡±Ü‡∞ü‡±ç‡∞ü‡∞æ‡∞µ‡±Å ‡∞Ø‡±Ç‡∞ü‡±ç‡∞Ø‡±Ç‡∞¨‡±ç ‡∞®‡∞Ç‡∞¶‡±Å ‡∞Æ‡∞Ç‡∞ö‡∞ø‡∞¶‡±á ‡∞ï‡∞æ‡∞®‡±Ä ‡∞í‡∞ï‡∞∞‡∞ø ‡∞ï‡±ä‡∞™‡±ç‡∞™‡±Å ‡∞é‡∞§‡±ç‡∞§‡±Å‡∞ï‡±Å‡∞Ç‡∞ü‡±á ‡∞ö‡±Ü‡∞™‡±ç‡∞™‡±Å‡∞≤‡±Å ‡∞§‡±Ü‡∞ó‡±Å‡∞§‡∞æ‡∞Ø‡∞ø ‡∞Æ‡∞ø‡∞§‡±ç‡∞∞‡∞Æ‡∞æ
Rammohan Patri	Nice
Puli Shekar	super now state political
Javvaji Mahipal	Election ‡∞ï‡±Å ‡∞í‡∞ï ‡∞™‡∞æ‡∞∞‡±ç‡∞ü‡±Ä nelako news Channel ‡∞Æ‡∞æ‡∞∞‡±á nuvvaa ‡∞á‡∞≤‡∞æ‡∞Ç‡∞ü‡∞ø video ‡∞≤‡±Å thisedhi
Dr venkatesh	‡∞∞‡∞æ‡∞ú‡∞ï‡±Ä‡∞Ø ‡∞®‡∞æ‡∞Ø‡∞ï‡±Å‡∞≤‡±Å ‡∞Ö‡∞Ç‡∞§‡±á
santhu bondugula	Dorala bharatam manchigane chupichindru Manchi Katha
Gangadhar Patel	Super anna edhi chusi aina prajalo marpu ravali super anna etu vanti video inka chey anna nv
Ashok Pallikonda	Like a KCR
rajesh reddy	Anna super nmatram taggaku dig faluts
Mashook Khan	Enkka kocham work cheyandhi anna
saida naik	Super
Ramana Babbi	Mallanna chusava nuvu
Gugulothu Naveen	Dedicated to kcr
veer vlogs	Super video Kani urilo bc lu lera
Rajashekar Sanda	Exalent
Nagaraju Battu	E idea vachina director sir super
Rahul Rk Gopal	arey mallana nuv enni chetta videolu pettina telanganaki manchi kcr vallane jargutundi congress kukkalu valla party adikaram unte baguntundi anukuntaru congress lo evadu mandu tagrarA tulasi tertam tagutara
R YNR	Kcr maaatale
prashanth andekar	This is kcr story
Shiva Reddy	Same kcr story
krishna krish	Super super bro
hareshwar reddy	Bongu laga undi Ipudu ilanti situation ledu uthigane enduku inka caste caste ani ekva chesi chupistaru ma village lo andaru equal gane untaru Mem reddy aina valu mama chicha ani pilustaru intloki kuda andari lagane vastaru Apudo thatha la kalam lo unde itla
DEVANAND NAGELLA DSS MAHARASTRA PRESIDENT	‡∞¨‡∞æ‡∞§‡∞æ‡∞≤ ‡∞™‡±ã‡∞∂‡±Ü‡∞ü‡±ç‡∞ü‡±Ä ‡∞¨‡∞æ‡∞ó‡±ã‡∞§‡∞Ç ‡∞¨‡∞æ‡∞ó‡±Å‡∞Ç‡∞¶‡∞ø üëåüëå
Bagari Pentanna	50 ‡∞è‡∞Ç‡∞°‡±ç‡∞≤‡±Å ‡∞Ü‡∞Ç‡∞ß‡±ç‡∞∞‡±ã‡∞≥‡±ç‡∞≤ ‡∞â‡∞ö‡±ç‡∞ö ‡∞§‡∞ó‡∞ø‡∞®‡∞™‡±Å‡∞°‡±Å ‡∞Æ‡±Ä‡∞ï‡±Å ‡∞à ‡∞∏‡±ã‡∞Ø‡∞ø ‡∞≤‡±á‡∞¶‡∞æ ‡∞á‡∞™‡±ç‡∞™‡±Å‡∞°‡±Å ‡∞§‡±Ü‡∞≤‡∞ø‡∞µ‡∞ø ‡∞é‡∞ï‡±ç‡∞ï‡±Å‡∞µ‡±à KCR ‡∞Æ‡±Ä‡∞¶ Video ‡∞§‡±Ä‡∞∏‡±ç‡∞§‡∞æ‡∞∞‡∞æ
chanti lingam	Irojullo kuda meeru inka DHORA ani matladuthunnaru ante KCR garini chusthe meeku entha thadisipothundho dhinni batti ardham avuthundhi endhukura vedhavabathukulu chavandira thoooooo
Pittala Prashanth	Super anna
sree sree	‡∞®‡∞ø‡∞∞‡±Å‡∞¶‡±ç‡∞Ø‡±ã‡∞ó ‡∞¶‡±ç‡∞∞‡±ã‡∞π‡∞ø
Venkat Lingampally	Super malllanana go a head
Yalagadula Lokeshwar	Good massage super excited
Prasanna Reddy	Jai kcr jai jai kcr
Vijay Karan	Truth of TRS and KCR üòÇ
viishnnu devaraneni	Chavandi kulam ane pichi me each nerve ekkuntundi siggu padandi ra kcr mistake cheste odipothadu scam cheste scam tho fight cheyandi kulam antaru endi ekadiki pothunnaru e modern competitive world shame full who are dropped the comment basis of caste india will never develop ante ila caste vallane political leader valla kadu chi siggu padandi inka caste chepkoni bathakaniki
jeevan sunny	Fantastic KCR real back ground
POWAR PRASAD	Sir very good
Naveen Kumar Manikonda	Mallanna Elections ayelopu ilanti vdios veelynanni ekkuva theesi amayaka prajalani maarchu anna
mahesh salluri	Trur story of bathala poshetti ‚Ç¨
pagidi suresh	Super
prasad kumar	100 ‡∞ï‡±á‡∞∏‡±Ä‡∞Ü‡∞∞‡±ç ‡∞ó‡∞æ‡∞∞‡∞ø‡∞®‡∞ø ‡∞Ö‡∞ö‡±ç‡∞ö‡±Å ‡∞ó‡±Å‡∞¶‡±ç‡∞¶‡∞ø‡∞®‡∞ü‡±ç‡∞ü‡±Å ‡∞ö‡±Ç‡∞™‡∞ø‡∞Ç‡∞ö‡∞æ‡∞∞‡±Å
Raja Sekhar	Super waiting for next episode
Kommoju Sravan	Superb concept and good script Mallanna keep going
king maker	üí† ‡∞ï‡∞æ‡∞∞‡±ç ‡∞ó‡±Å‡∞∞‡±ç‡∞§‡±Å‡∞ï‡±Å üöòJAI KCR üîπJAI TRSüöò ‡∞Æ‡∞® ‡∞ì‡∞ü‡±Å üí† üí† ‡∞ï‡∞æ‡∞∞‡±ç ‡∞ó‡±Å‡∞∞‡±ç‡∞§‡±Å‡∞ï‡±Å üöòJAI KCR üîπJAI TRSüöò ‡∞Æ‡∞® ‡∞ì‡∞ü‡±Å üí† üí† ‡∞ï‡∞æ‡∞∞‡±ç ‡∞ó‡±Å‡∞∞‡±ç‡∞§‡±Å‡∞ï‡±Å üöòJAI KCR üîπJAI TRSüöò ‡∞Æ‡∞® ‡∞ì‡∞ü‡±Å üí† üí† ‡∞ï‡∞æ‡∞∞‡±ç ‡∞ó‡±Å‡∞∞‡±ç‡∞§‡±Å‡∞ï‡±Å üöòJAI KCR üîπJAI TRSüöò ‡∞Æ‡∞® ‡∞ì‡∞ü‡±Å üí† üí† ‡∞ï‡∞æ‡∞∞‡±ç ‡∞ó‡±Å‡∞∞‡±ç‡∞§‡±Å‡∞ï‡±Å üöòJAI KCR üîπJAI TRSüöò ‡∞Æ‡∞® ‡∞ì‡∞ü‡±Å üí† üí† ‡∞ï‡∞æ‡∞∞‡±ç ‡∞ó‡±Å‡∞∞‡±ç‡∞§‡±Å‡∞ï‡±Å üöòJAI KCR üîπJAI TRSüöò ‡∞Æ‡∞® ‡∞ì‡∞ü‡±Å üí† üí† ‡∞ï‡∞æ‡∞∞‡±ç ‡∞ó‡±Å‡∞∞‡±ç‡∞§‡±Å‡∞ï‡±Å üöòJAI KCR üîπJAI TRSüöò ‡∞Æ‡∞® ‡∞ì‡∞ü‡±Å üí† üí† ‡∞ï‡∞æ‡∞∞‡±ç ‡∞ó‡±Å‡∞∞‡±ç‡∞§‡±Å‡∞ï‡±Å üöòJAI KCR üîπJAI TRSüöò ‡∞Æ‡∞® ‡∞ì‡∞ü‡±Å üí†
mudedla vijay	Super Anna
dhanunja dhanu	Elane undi Anna mallanna
SOCIAL MEDIA	‡∞®‡±Å‡∞µ‡±ç‡∞µ‡±Å ‡∞®‡±Ä ‡∞ö‡±Ü‡∞§‡±ç‡∞§ ‡∞ê‡∞°‡∞ø‡∞Ø‡∞æ‡∞≤‡±Å
siddu alex	Kcr chesina manchi panulu vadilesi endira malliga nee lolli
Sunny Jangam	Superb
Justin Brbire	Oscar wining story Natural ga vundi super
sp mlats	‡∞∏‡±Ç‡∞™‡∞∞‡±ç ‡∞°‡±à‡∞∞‡±Ü‡∞ï‡±ç‡∞∑‡∞®‡±ç ‡∞Æ‡∞≤‡±ç‡∞≤‡∞®‡±ç‡∞®
Srikanth Srikanth	Mundu unde pandaga nede
RAMESH TEJAVATH	‡∞Æ‡∞≤‡±ç‡∞≤‡∞®‡±ç‡∞® ‡∞Ö‡∞¶‡∞ø‡∞∞‡∞ø‡∞Ç‡∞¶‡∞ø
vasa harish	Mallanna good start but RR too much aipoindhi
Mohmad Afroz	k a c ha r a üë∫
Mahesh B yadav	pikinav thiy ra
naresh reddy	Are errrpipuka mallanna ayana chesindhi manchipanulu kuda chooinchu nakoadaka
MAHASENA	BC FC and OC are full of clarity and supporting TRS What about SC and ST 18 percent whom they will vote What s the use
sekhar nb	Super adorindi kcr bagotham 5minitlo artham ayyela chupinchau Jai congress
Anji Lanka	Super
Saritha Chandu	it s true
Srikanth Goud Pothagoni	Abba highlight movie
Thirupathi Divya	Nuvvu super mallanna
Kasim Md	‡∞∏‡±Ç‡∞™‡∞∞‡±ç ‡∞Æ‡∞≤‡±ç‡∞≤‡∞®‡±ç‡∞®
Subhash Das	Super screen play and direction brother Posetti manarisim super
laxman G	Ee mallanna gadu Rahual gandi uchha tagutunda roju malli gadu drink cheyada Malli gadu scamgress party kukka Broker gadu
BHUSHAN Bheemaram	Idk Nijam dr b r Ambedkar ichina otu hakkunu kapadali jai bheem
Shiva Boddu	Cheppu tho kottali na kodakallara Orvaleni yadavalu Ila pichi pichi video Poyi mee intla amma nanna or old people s ni adagandi trs govt nundi labam pondutune mee kula rajakeeya chesi ilanti pichi video chestnaru
SATYA	Chadi Gang Video
sudharshan kalvala	super Anna
Lokesh B	super anna
yugender balasani	S2 same kcr
Praveen Adepu	10 TV lo Mallanna Job peekesaru Veediki edhe Pani egaa 1st day 21k Next day 39k Again latest video no mood to WATCH I think better to find another JOB Mallanna KCR Govt meeda enni negative news chappina JANALAKU thelsu KCR em chesindooo NUVVU CHUPICHINA VIDEO ki E rojullo Janau ala DHAORALA kindha Pani chese kaalam pooindhi Inka nuvvu edho create chesdham ane ankunte Nuvvey NEGATIVE avtuav ‚úä
BURRAGADDA Bheemaiah	super
kattaah sruzzjannkumarr	‡∞á‡∞¶‡∞ø ‡∞≠‡∞æ‡∞∞‡∞§ ‡∞¶‡±á‡∞∂‡∞æ‡∞®‡∞ø‡∞ï‡∞ø ‡∞™‡±ç‡∞∞‡∞Æ‡∞æ‡∞¶‡∞Æ‡±à‡∞®‡∞¶‡∞ø ‡∞ï‡±Å‡∞≤‡∞Ç ‡∞á‡∞¶‡∞ø ‡∞≤‡±á‡∞¶‡±Å ‡∞Ö‡∞Ç‡∞ü‡±á ‡∞Ö‡∞®‡±ç‡∞®‡∞ø ‡∞ï‡±Å‡∞≤‡∞æ‡∞≤‡±Å ‡∞í‡∞™‡±ç‡∞™‡∞ï‡±Å‡∞Ç‡∞ü‡∞æ‡∞∞‡∞æ
Zahed Ali	KCR KU CORRECT MATCH AVATHADI
Vannelasuresh Suresh	Super mallana
Purushotham Arepally	‡∞ö‡∞æ‡∞≤ ‡∞¨‡∞æ‡∞ó‡±Å‡∞Ç‡∞¶‡∞ø
J Prathap	Super mallanna
Manasa Alli	mallannagaaru super üëåüëåüëåüëåüëåüëå inka kcr asalu baagotham gurinchi thelangana prajalaku cheppandi sir and mallannagaaru u r great
Ravi Laxmi	Super skit
RAVINDARR MOOD	‡∞á ‡∞µ‡±Ä‡∞°‡∞ø‡∞Ø‡±ã ‡∞ï‡±á‡∞∏‡±Ä‡∞Ü‡∞∞‡±ç ‡∞ö‡±Ç‡∞∏‡±ç‡∞§‡±á ‡∞á‡∞Ç‡∞ï‡±ä ‡∞∞‡±Ü‡∞Ç‡∞°‡±Å ‡∞™‡±Ü‡∞ó‡±ç‡∞ó‡±Å‡∞≤‡±Å ‡∞é‡∞ï‡±ç‡∞ï‡±Å‡∞µ ‡∞µ‡±á‡∞∏‡±ç‡∞§‡∞æ‡∞°‡±Å üòÇüòÇ
Javeed Hrd	Fact about KCR
PEWDIE PIE	Idhi Rajapet lo theesara
Mahesh Sarika	‡∞ö‡∞æ‡∞≤‡∞æ ‡∞¨‡∞æ‡∞ó‡±Å‡∞Ç‡∞¶‡∞ø ‡∞∏‡±ã‡∞¶‡∞∞‡∞æ
Srinu Srinu	super dup kcr
Fhhhvhvbb Chgfg	‡∞µ‡∞æ ‡∞∞‡±Ü‡∞µ ‡∞∏‡±Ç‡∞™‡∞∞‡±ç ‡∞ï‡±á‡∞∏‡±Ä‡∞Ü‡∞∞‡±ç ‡∞Æ‡±Å‡∞ñ‡±ç‡∞Ø‡∞Æ‡∞Ç‡∞§‡±ç‡∞∞‡∞ø ‡∞≠‡∞æ‡∞ó‡±ã‡∞§‡∞Ç
Uppari Satti	Arw badacow vere a leader tagada Avari daggariki podavu bhe
Dureseti Kalidas	Idi Gadila rajakeeyam neti rajakeeyam different
Shekhargoud Goud	‡∞®‡∞ø ‡∞™‡∞®‡∞ø ‡∞§‡∞æ‡∞∞‡±Å‡∞µ‡∞æ‡∞§ ‡∞â‡∞Ç‡∞¶‡∞ø ‡∞Æ‡∞≤‡±ç‡∞≤‡∞®‡±ç‡∞®
raachakonda dhanumjaya	Keka bro
Vishal dashing	Taagubothu jaati pita
prashnt mudam	Supper anna
Sudhakar Kotagiri	100 corect
Sharuk shaike	Kcr ki potiki vastunnadu brother
Srinivas C	mallana please continue like this
sreenu laoori	Super
B NARI123456	Anna Naveen gaaru the story super
Bpavankumar	Supper mallannaüëåüëåüëåüëå
geethaa a	background music taggiste baguntadi
Vadnala Vamshi	Anna next episode eppidu
Deepu l	Kcr nu dilute cheyadanike channel pettav mallanna thappu mallanna okasari alochinchu
Nirudeep Duda	Super bro
charith pinniboina	Yes same KCR story
Maripally Ramesh	‡∞Ø‡∞ø‡∞ó ‡∞¶‡±ä‡∞∞ ‡∞™‡∞æ‡∞≤‡∞®‡∞æ ‡∞¨‡∞æ‡∞ó‡±Å‡∞®‡±ç‡∞®‡∞æ‡∞¶‡±á ‡∞∏‡±Ç‡∞™‡∞∞‡±ç ‡∞µ‡±á‡∞∑‡∞Ç ‡∞™‡±ã
Ravikumar Aligeti	Ha dore telangana techindu telusa
UT VAISHNAVI	üôÉüôÉüôÉüôÉ
hari chary	Superb
Meghraj Abbagouni	No use this
pradeep kumar	Extraordinary bro correct ga teesav
Kishore Ganapaka	Mallanna garu good message TQ anna
Gangaram Gangaram	New Sub
raja abhimanyu	emo ankunna mallanna ni daggara chala matter undi
anupoju thrimurthulu	‡∞á‡∞≤‡∞æ‡∞ó‡±á ‡∞®‡∞ø‡∞≤‡∞¶‡±Ä‡∞Ø‡∞Ç‡∞°‡∞ø
sarwar biyabani	Super
A.SANGAMESHWAR BOBILGAM	super bro excellent
R S Siva Kumar	This perfect kcr biopic
m reddy thiru	Anna niku aa koteda dorikiendeüëçüëçüíóüíóüíûüíûAnna ni direction ki banchan inane nuv keka neüëçüëçüëçüëç
Tati Narasimha Rao	Super
Pendla Gangaram	suparnna
prabhakar chanda	Jai kcr
My Life	Super
Vankateswra Rao	Super brother same to k c r
vempati nagaraju	Real story
Suri Maharaj	‡∞∏‡±Ç‡∞™‡∞∞‡±ç ‡∞∏‡±Ç‡∞™‡∞∞‡±ç ‡∞π‡∞ø‡∞ü‡±ç ‡∞Æ‡∞≤‡±ç‡∞≤‡∞®‡±ç‡∞®‡∞æ
Naga Raj	Kcr and suman story
Chennaich Bagaya	Thu ami bathuku ra nedi smoking and drinking andira action Thu
Srinivas Amrad	Superb
Srujan Thalla	Anna üëåüëå
chakradher goud dasari	Pora makkeloude
narsireddy. komirelly	Anna super jannam eppatikina maralii
bagath singh	Kcr dalithudu cm anadu Kcr asalayna dalithudu
srini vas	Super Anna
Veeru Bukya	Dalithulu ante kcr sir ki istam ledanna Kondagattu sangatan jarigina tharuvatha okasari kuda vala nu kaluvadani ki pole Ap TDP nayakudu chanipoinapudu aa hadavidi antha intha kadanna
Gangster Nayeem Nalgonda	‡∞∏‡±Ç‡∞™‡∞∞‡±ç
shiva shankar	Same a KCR
DD Giri	Super
medipally naresh	Super
Sudeep Reddy Konatham	‡∞ú‡∞®‡∞Ç ‡∞Æ‡∞æ‡∞∞‡∞æ‡∞≤‡∞ø
Phani Shekhar Vundyala Reddy	Congratulationsexcellent
mahender edigi	Anaa niku dhandam samto sam kcr dhorala palana lagavundhi
Prasad Goud Kaleshwaram	Nice bro enka elaga cheyu
Swathisri 117	KCR
Chandramohan Reddy	Veediki gudda Baga balisindhi
pane prabhakar	Super hit
Anji Yadav	Super mallana
