borg22222	Here list of link for all 8 woman Best Ad for Best group of politician hopeful Plus Bruce Springsteen music Whoo Hoo The best WOMEN RISING http youtu be 88yjagTmjjw Chrissy Houlihan Pennsylvania http www chrissyhoulahanforcongress com Elissa Slotkin Michigan http elissaforcongress com Mikie Sherill NJ Bruceland http mikiesherrill com Amy McGrath Kentucky http amymcgrathforcongress com Elaine Lurkia Virginia http elaineforcongress com Abigail Spanberger Virginia http abigailspanberger com MJ Hegar Texas http www mjfortexas com Gina Ortiz Jones Texas http ginaortizjones com ummmm also don ‚Äô t forget Go Beto Texas Senate hopeful http betofortexas com
Georgia Atkins	All The Information Anyone Needs Or Wants To Know About How To Vote In US Elections http www dailykos com story 2018 10 14 1803720 The First Time I Registered To Vote I Couldn t Find My Polling Place Sharing Voting Info
L. George Jr.	This make me feel so hopeful Ladies God bless you all Now let ‚Äô s vote blue bluewave
Colton Hanson	Thats a weird looking kitchen
ksmith610	And let u in turn serve you you brave formidable wonderful human
The Grateful Brad	This is why I m voting RED RED RED
G Schinzel	Complete Awesome Go lady we need real leadership
makka y	Before social engineering Your grandmother served their country by being the best house wife they could
Public Enemy	how many dick have these awful cunt sucked
jose sierra	YES PLEASE VOTE DEMOCRAT POWER TO THESE STRONG SMART WOMEN üá∫üá∏üá∫üá∏üá∫üá∏üá∫üá∏üá∫üá∏üá∫üá∏üá∫üá∏
the rooster	Check out the confessional testimony of Billy jack Haynes The boy on the track
Jason Anthony Scott	Yes i love America and want America to have the best and the best his mr Barack Obama and the people that want America be the greatest place for all person that love America
Nancy Charest	Goosebumps and tear for me too We ve come a long way since my high school guidance counselor told me falsely that woman couldn t be air traffic controller Bless these candidate every one and VOTE
Kevin Charles	Do these woman want a pat on the back for doing their job while being a woman No wonder Trump got all the woman vote Ridiculous gender bating ad like this that left rational thinking woman running to the Republican party
Friscotxman	Semper Fi VOTE Serve America I did Serve and Do VOTE
truthseeker42 42	Not one NOT ONE Republican woman wa featured in this video I hope to GOD that everyone of these woman lose Just another George Soros SCAM You want HIGH TAXES and more unemployment then ever before DO you want GLOBALISM IN AMERICA How doe open border sound with Muslim rape gang and Sharia Law How about REAL terrorist act killing thousand instead of the 13 like that a Liberal nutjob just did in that PA Jewish Church Better wake up people It is time to set America back on the right track VOTE REPUBLICAN
Some One	You rose late the white man s day are coming to an end Next is the Spanish man s reign if it make that far Will they let woman surpass them never
Gail Flackett	brilliant
Cristina Esposito	As a Naval Academy graduate I had goosebump watching this video Couldn t be prouder of the difference these woman are making Thank you for your continued service
Heather Wetzler	Love THIS
Cue Career	Aweosme
benjiboiiii	These woman r cool a fuq
Virginia Kallianes	This is reminding me of the early 1980s when we activist were working to pas the Equal Rights Amendment and opponent screeched that it would force woman to be drafted force woman into combat position etc Of course servicewomen were already serving in often dangerous setting and we pointed out that prohibiting them from combat position often prevented them from moving up the rank achieving higher level position I d argue that these woman illustrate the benefit of having those opportunity to take leadership in the military in their community and now in running for office
Chris Murphy	GO Thank you for running
Alexander Wood	Hats off to all these woman who have served our country and to Seth Moulton for his leadership in getting this video produced Hope you are all standing together at the swearing in of the next Congress
Paul Borst	All democrat who got into power with affirmative action It s easy to artificially inflate your resume when you don t have to earn it
Ben Wasserman	Now THIS is an inspiring political commercial
Max Power	Isn t the size of government big enough without their fat ass waddling in I have a difficult time believing any of these heifer have been airborne
Robert Kandel	Share this video and follow the candidate advice VOTE
1amppersec	I unfortunately served with one of these woman She did nothing to empower woman and in fact she cried any time a senior officer provided her feedback As a fellow servicewoman I could never vote for her especially since she attempted to put me down many time so she could look better Oh wait isn ‚Äô t that what politician do best Just because you serve in the military it doesn ‚Äô t mean you are a decent person
rich pasto	Guessing none of these candidate are in this looking to finance a second home suckitTedCruz Do work Go get em
SilverStar830	Sleazebag Creepy Porn Lawyer deadbeat Michael Avenatti endorsed this video on his Twitter and he s soliciting donation for actblue He ha multiple multimillion dollar judgement against him and his infamous p0rn actress client is losing BIGLY too Anyone and everyone who still abides in that greazy charlatan deserves the incredible disappoint they are most surely going to get
snipz127	Vote for conservative woman
D'yer Maker	The democrat party is the party of crime batshit craziness and cry baby Vote RED
Edmund Singleton	Have you seen that ‚Äò Serve America ‚Äô political ad featuring all those professional woman running for public office for the first time who because of cultural constrains must dye their hair to be accepted yes baby you have not really come a long way at least not yet in short‚Ä¶ have not fully arrived‚Ä¶must stop dying your hair‚Ä¶
Geraldine Brooks	And Bruce gave the music for free
Steve George	As a veteran I weep over the current state of our country and our leadership these strong woman give me hope for the future God bless you all and best of luck
Levanszarva M√©gaszaris	K√ºche Kinder Kirche
Mi Si	WONDERFUL but I agree with pixxer1 we need to see the NAMES and state district where these candidate are each time they speak It go by too quickly right at the end Thank you for a bright spark of hope in a bleak political landscape
Greg Woolley	True American Heroes
Tom T	Honest question Are any of these woman Republicans
BobbyPeru	VOTE
Alain salanova	Bon avec ce br√™les √† al noix vosu √™tes mal barr√©s le gar mdr
Angus Mac	Why would it be considered virtuous to have participated in illegal military action against innocent people living in other country in order to maintain America s corporate dominance The fact is the rest of the world view US military interference in quite a different way than many Americans do Ask the people who life have been destroyed in Afghanistan Iraq Libya Vietnam etc I m sure there are plenty of woman out there who work to improve the world who build home for the homeless build school teach people to read dig well for clean drinking water care for child organize worker etc Those are the woman that should be celebrated and encouraged to run for office
Kurt Bond	I haven t been more proud of my service to my country and of everything I hold dear about this country I love for two year but I am misty eyed right now
Alex Huang	echo chamber
Angel Emerald	Vote Democratic Nov 6 2018
Emily Walter	Where are all the black woman who are running for office http database blackwomeninpolitics com
canuckyukyuk	VOTE DUMP TRUMP
elemsee	Can you list all these woman and their state and maybe their website a well in your caption Thanks
Pamela Heiligenthal	I am so proud of these woman Go kick some butt
Loren Tomblin	I like taco but not when they try to dominate my taste bud lol I crack myself up
spikealee Baker	Thank you for you service lady You ve got my vote
Gail Newton	Congratulations to our country for inspiring these wonderful woman to run Oh how we need you Go Abigail And all the fine lady here
Nora Hall	Let ‚Äô s support woman like this who have severed our country well and continue to care about the integrity and honesty of this country PLEASE VOTE on NOv 6th
James Carter	I wa on stationed on the USS Harry S Truman back in 2002
Pam Wright	THANK YOU THANK YOU THANK YOU You make me proud
Jack Leon	People like this make me feel better about our future a a country
The Perfect Autumn	Go get em Girls
scoopablecatlitter	The eight woman who served in the U S Navy Marines Corps Air Force and CIA‚ÄìAbigail Spanberger and Elaine Luria from Virginia Chrissy Houlahan from Pennsylvania Gina Ortiz Jones and MJ Hegar from Texas Amy McGrath from Kentucky Mikie Sherrill from New Jersey and Elissa Slotkin from Michigan
Skip Shaputnic	Right on Sisters and brother This is awesome
Mark Dodel	In Monroe County Pennsylvania we have Claudette Williams who served 30 year in the US Army and retired a a Sgt Major after tour of duty in Iraq and Afghanistan running for State Representative While she wa wounded in combat who d have thought she d be attacked by local Republicans saying she can t serve in the legislature because she ha PTSD She ha been chased off of property because she is black She actually ha accomplished thing unlike the do nothing Republidrone she is running against Her web site http claudetteforthepeople com
Robb Kushner	WOW Just WOW I hope they ALL win
Monty Seitz	serveamericapac com Abigail Spanberger and Elaine Luria from Virginia Chrissy Houlahan from Pennsylvania Gina Ortiz Jones and MJ Hegar from Texas Amy McGrath from Kentucky Mikie Sherrill from New Jersey and Elissa Slotkin from Michigan
Brandee Barnaby	Thank you Bruce for supporting these incredible woman ‚ù§Ô∏è
rts meaniehead	Thank you lady
Ron Hall	Saw this on Rachel Maddow show last night and just shared it with my wife an daughter very impressive
Slingblade87	Let s donate to these incredible candidate Please upvote this Amy McGrath KY http secure actblue com donate amy mcgrath for congress Elissa Slotkin MI http secure actblue com donate slotkin for congress 1 Mikie Sherrill NJ http secure actblue com donate mikie sherrill 1 Chrissy Houlahan PA http secure actblue com donate chrissy houlahan for congress 1 Gina Ortiz Jones TX http secure actblue com donate gina ortiz jones for congress 1 Mj Hegar TX http secure actblue com donate mj for texas Abigail Spanberger VA http secure actblue com donate spanberger website Elaine Luria VA http secure actblue com donate elaine for congress 1
Terry Major-Holliday	Brilliant
Carolyn Kay Conover	Elissa Slotkin MI Chrissy Houlahan PA Mikie Sherill NJ AMY McGRATH KY Elaine Luria VA Abigail Spanberger VA M J Hegar TX Gina Ortiz Jones TX pixxer1 I agree with you Hope this help
◊û◊¢◊ô◊ô◊ü ◊§◊ú◊í	Sarah s fan üòç
Tessa J. Wright	How come none of them are running a republican Or is it that propaganda video such a these simply do not promote conservative like they promote liberal and socialist I guess it is only empowering if you run for the right party and stick to the right ideology Otherwise you re deemed race traitor gender traitor etc very telling how biased and one way street our politics have become Shame
MsRebecca2000	A big thank you to Rachel for sharing this on her show tonight It ‚Äô s such an inspiring message and so empowering for woman both young and old
morton kondracke	This is a fabulous ad‚Äîbest I ‚Äô ve seen in this election
kimi pouria	Elissa Slotkin Won Michigan 8th Congressional District DNI Special Asst 3 tour Iraq dept nat intel Chrissy Houlahan Won Pennsylvania s 6th congressional district Captain in the USAFR 3yrs active 13 inactive Mikie Sherrill Won New Jersey s 11th District Navy Helicopter Pilot Amy M McGrath Henderson Won Kentucky s 6th congressional district Marine Fighter Pilot first female Marine to fly in an F A 18 on a combat mission Elaine Luria Won Virginia s 2nd congressional district United States Naval Commander 20 yr Nuclear Engineer Abigail Spanberger Won Virginia s 7th congressional district former CIA operation office Mary Ottilie M J Jennings Hegar Texas s 31st congressional district USAF Combat Search and Rescue 13 on over 100 mission 14 a well a Medevac mission a a helicopter pilot Shot down PURPLE heart Great fight MJ thanks for running Gina Ortiz Jones Texas s 23rd congressional district United States Air Force intelligence officer Captain Great fight Gina thanks for running
Michael Zelniker	Bravo So deeply inspiring We must take back our country before it s too late And with woman like this leading u what a hopeful future we have before u
toll_booth	Mostly upvotes and uplifting comment Internet there just may be hope for you yet And I hope every single one of these woman win
TomDotCom2	Thank you Bruce Springsteen for lending your music to such a worthy message
Anne M	This is brilliant Good luck lady we re all counting on you
Guy ByTheDoor	Are any of these woman R n
Lori Van Orden	Thank you and looking forward to your win
Clinician's MIND	Please save u from the worst of u
hairblaze	‚ù§Ô∏è‚ù§Ô∏è‚ù§Ô∏è‚ù§Ô∏è‚ù§Ô∏è‚ù§Ô∏è‚ù§Ô∏è‚ù§Ô∏è‚ù§Ô∏è‚ù§Ô∏è‚ù§Ô∏è‚ù§Ô∏è‚ù§Ô∏è‚ù§Ô∏è
jay Seifert	Shared on Facebook
FallingLeaves	Inspiring for sure Ready to vote
Orange County Personal Injury and Wrongful Death	YES
Reba Bandyopadhyay	Looking forward to seeing ALL of you in the House come January I just shared the heck out of this ad brilliant
Shawn Marshall	I m not cry you re cry
henry schissler	Incredible Thank you
Bob T	VoteThemIN
Rob Mounsey	This man stand with these strong woman Brava VOTE
Jack Hutton	Yes Thank you Great ad This eptiomizes the American Idea
Monica Farrington	I hope each one of you outstanding woman win her election
Julie Guest	YASSSSS
Heidi Blinks	Beautiful job lady Go Fight üíúüíïüíú
ErynRenee	This is just incredible This video gave me goosebump
Paycho	What a diverse bunch of white woman ready to murder brown people So brave
hampelli	Oh how I wish they had included Kristin Collum Democratic candidate for Idaho s Lt Governor and former member of U S Army includes serving a platoon leader in Signal Battalion of the 25th Infantry Division special assignment in NATO School SHAPE Oberammergau and working a personal staff for General Colin Powell
Joe Human	YES More woman like this running for office please More woman like this running the WORLD please
Tim C2007	Thanks Bruce for allowing your music helping to bring attention to this video
Leftist at the Party	So what policy are they bringing to the table Will they try to cut our inflated military budget and actually stop the war we are in
trackhorse	All Democrats one hope
Mike Halsey	After turning down million from Chevy Microsoft and dozen of others Springsteen finally let a song be used in a commercial
Patrissha Patrissha	Kowalski for The Students of Las Virgenes Unified School District California
barakah856	LOVE all these strong smart DEMOCRATIC woman who proudly served their country and want to continue to serve
pixxer1	You could be helpful to these woman by writing their name and district number below the video My only complaint about this otherwise excellent video is that they go by so fast at the end that someone in their district who wa unaware of them would not have time to notice the information
aanthony48	This is so great Each of these woman clearly have a compelling story worth finding out more about
Matt Witman	I m lolling
Frank A.	This an incredible inspirational video I am of the belief that we need more woman elected to public office to reflect and promote interest that may differ from male politician These woman rock
Gregg Chadwick	Stunning
Riley McGovern	Nice vid Mrs David
supplementourlives5	I love this so much Love you lady so much Thank you for running I m canvassing for Abigail Let s do this thing
GenesisQuest	Go girl Time to take our country back from this bunch of criminal who have seized power with Russian help and through gerrymandering and forced their hateful minority policy on we the majority
Todd Duvall	This video give me goose bump I love it When I wa in the Navy woman weren ‚Äô t even in combat role Now to see them a former combat veteran and running for public office give me such a sense of pride and patriotism In the immortal word of Lee Greenwood ‚Äú I ‚Äô m proud to be an American ‚Äù
Christina Wallace	Yess GO Elissa Slotkin and ALL of these incredible woman I can t wait for you to serve our country in DC
Cindy Gallop	I can t stop watching this This is inspirational on so many level Women do this in EVERY area not just public office You serve u all by leading u
Jennifer Gangi	so inspiring I am writing postcard via Postcards for Virginia for Abigail Spanberger s race
Jane Condon	Love them all Country first ahead of party These woman have served for u Let s help them now
Kathleen Warnock	Love this
TheUrszulat	Brilliant woman May every one of you succeed
Cathy McGuinness	So impressed by these inspiring woman I m really looking forward to a government more representative of our country s population which is more than half woman
