The Next News Network	Because YouTube changed their algorithm hit this link http nnn is Sub to N3 to subscribe to our YouTube channel then tap the bell to turn on notification for more report like this
mothman1967	Obviously we need Senate hearing on the matter a well a FBI INVESTIGATION But what about Cory Bugger He admitted in his college newspaper to groping an unwilling drunk female Moreover he ha been accused of ASSAULTING A MAN IN A PUBLIC RESTROOM The latter charge should be investigated by local authority for rape and should be investigated fully by the FBI a well since this is a clear violation of the man civil right Senate hearing should have already commenced on these allegation CONTACT YOUR SENATORS AND EXPRESS YOUR OUTRAGE
Deno Blankenship	This why the Democrats hate the truth the truth expose them a the hypocrisy they have become This Senator should resign immediately
Rob's Noize	POS 🖕😝😡
David Buzzin	🤓NEVER TRUST💩😝DEMOCRAPS 💩😝 EVER 👎💩👎😝👎💩👎😝👎💩👎😝👎💩👎😝👎💩👎😝👎💩👎😝👎💩👎😝👎💩👎😝👎💩👎😝👎💩👎😝👎💩👎😝👎💩👎😝👎💩👎😝👎💩👎😝👎
Ron Gruber	But it didn t happen over 35 year ago Cory Booker Keith Ellison this clown and you just keep on going down the list at one time I had a list with nearly a hundred liberal on it that it either been convicted or accused of their personal war on woman
Edward Takeaction Gba	A RED tide is coming in November Bye bye demonRats But of course 30 of their vote will be illegitimate
david trump	Kieth ellison cory booker also
ernie montego	This is not a position men need to support we need to stick together and not allow unsubstantiated accusation stand nor past action between married couple I don ’ t think we need to support feminist gynocentric law that can be use against all men
Bart Swihart	Hey democrap s are no good not a single one
peter morelli	I live in delaware Theres no way to get Democrats out here We need help
Neal Valero	Whare are the elevator screecher now
lakesideinc	well don t forget Cory Booker not only wa he accused but he wa arrested and charged
Jesse Ventura	Lol this keep getting better by day
John Walker	What do u say to a woman with 2 black eye You should have listened the first time Hahahaha Lol
cornflake73	If I were him submit his resignation or face arrest in office He should be one of those sealed indictment
Anglo Saxon	And wife who assault their husband too I must be BOTH way
SlingbladeJim	Good for them
daverjax	What s so SUppriseing bout the BLATNT Hypocrisy of the Left Remember Schumer Durban Feinstein and MORE VOTED TO AQUIT BILL CLINTON WITHOUT EXAMINEING THE WITNESS TESTIMONEY eah they SURE believed the Survivors GHEN Didn t THE Hypocryisy THY NAME IS FLEFTISTS
Jimmy Cain	Give a crap about spousal conflict gender identification race relation or any other stuff that ha nothing to do with making money Let ’ s make some money and mind our own business
Kathy Carver	I wa a victim of abuse while married I can tell you from experience that 99 of men who hit and hurt their wife continue to do so Only a very small number is able to stop thru intense counseling I m truly stunned that he admitted it and then appologised to the public like it s no big deal expecting it to be swept under the rug During my divorce my husband admitted hitting me then claimed it wa no big deal because at the time I deserved it I don t believe for one moment that he hasn t continued to be abusive in private He s another despicable politician that need to go It make me sick He s a millionaire​ I m thankful for these woman who have boldly come out against him
Kevin Hensley	It s real simple Mister carper if you believe Cavanaugh is unfit over unsubstantiated allegation then you I definition must resign for your own confession yours doe not have to be substantiated a you confessed and the truth must set you free from the obligation of office resign or continue to be the hypocrite you truly are I already know your choice a do the rest of u hypocrite
Ronald David Young	Vote the dems abuser out of office
Grace McKinley	And these hypocrite went after Justice Kavanaugh DEMONRATS everyone of them
Tomy Boyle	It s not the same thing everyone know if you are a Democrat the rule don t apply to them
Jay Tonry	Nice comb over you cuk pussy woman beater
Kevin. W House	👍
Richard Stoops	He feel qualified because a bunch of dumbass voted him into office
L A So Cal	Apologies dont make accountability Did he use tax payer monies to make it go away buy a doj get out of jail free card like hrc obama lerner strzok page mccabe holder lynch and comey We r so done with hypocracy and corruption
Daily Bread	Men dont know how and cant control crazy woman avoid at all cost j peterson MGTOW
Wade's idea	This disgusting uze just keep pouring out
White Rabbit	All one ha to do to see the real character and mentality of a Democrat is to watch them in some video listen to their angry hateful speech That s normal behavior for Democrats That s the reason so many of our jail and prison are full of them They have a disregard for law and civil conduct How is this Democrats behavior different from the Muslim Democrat Kieth Ellison They both deny it at first just like those Democrats doing time in prison Figures
Karen Lind	And of course he double standard Only democrat are aloud to get away thing like that oxygen thief s Democrats are such bully
Twila Dickinson	Get rid of the double standard equal prison sentence for Women
Skull Dwellers	Impeach impeach impeach all demonrats
Kathy Florcruz	I can t stand ID politics at all Dems use it Republicans who use it aren t helping VOTE DEMS OUT at every level
PHILIP WATSON 5	WHY DO WOMEN STAY WITH GUYS THAT BEAT THEM 🤦🏻‍♂️🤦🏻‍♂️
john haze	Maybe the b tch didn t do the dish
Manuel Perdomo	Double standard A demoRats will ask you what is that 😂😂❤️🇺🇸
Luis Feliciano	Let ’ s not forget Keith Ellison Dirty Bill Clinton Weinstein and the rest of this DIRTY ABUSIVE PERVERT DIMONcrats HANG THEM ALL
Miguel Flores	I Think is the same senator who campaigned For HILLARY Singing SHE WORKS HARD FOR THE MONEY Watch the Laughable VIDEO
Scott Serson	They know he s a Democrat right Lmfao
Steve Felten	What go around come around the Demonazis have opened up Pandora s box and now the truth about to destroy them
Eddie Wadkins	thank you lady s the one thing the dems weren t counting on is that woman have brain to
Holly Sigman	The loudest protestors seem to be the biggest hypocrite
Granville	This is awesome
chris pontarolo	Even the news wa wrong They said stormed the office but alls I saw wa one lady talking to what looked like an assistant at the front desk
1zippyman	so he and keith ellison can beat woman and the democrat do nothing and do not bileve those woman
Karen Sapitan	Resign scumbag
space man reviews	The chicken come home to roost LOL
Guylaine Martel	Black EYES Matter That s rich I like that a lot 😎
Hamamass !	No i really do no believe a Dem did do this or can do this They are saint This is a smear campaign sarcasm mode ON
Will Winters	I don t know who to give enough thanks to on this one OAN for reporting it TNNN for having the bravery to repost it since not even FOX ha the gut to do it anymore WCfDV for calling out a liberal or the WCfDV Spokesperson for admitting they supported Kavanaugh since there wa no evidence in his nomination you got ta admit that Womens Groups dont usually do that I guess top mark all around on this one
Boo Who	But sence he s a dem he s inoccent until proven guilty unlike republican who are guilty until proven inoccent Double standard rule for the dumb o crap libtards
Frida Lewis	Oh STFU
John Gibbs	Way to go lady Give them he ll
Spike M	Arrest Hillary Clinton She threw an ashtray at Bill and hit him the head and made him bleed
Upy 017	Big hypocrite Big part of the swamp
who	The swamp keep draining daily
Spirit Of Light	Time for Tom to own up his own medicine
Mike B	Good That also mean “ no muslim politician ” —since beating their wife with a stick is approved in the Islamic doctrine
Strieter Marine Survey	It s okay for Democrats because they are unhinged But not for Republicans they are to responsible
Sunny Skye	Oh look Women making a difference without being topless cussing uncontrollably and they don ’ t look like witch from a cartoon Go girl Fight the GOOD fight
phil unbekant	As a citizen of nj I encourage the group to do the same with Sen Cory Booker Spartacus need to be recalled
Larry Pritchett	Yes and more Women ’ s group should clean up their act and make sure that their is no Tripple standard in going after those who have been lawfully charged or they have admitted abusing woman Furthermore they should also go after woman who lie against men Let ’ s not leave anyone out Do I have to say it well here it is “ For All Have And Short Of The Glory Of God
Michael Johnson	You can t hold being a hypocrite against the congressman because he is a democrat
Harry Wong	TYPICALLY HIPPOCRATIC DEMOCRATS
Chirho Knight	I am so happy that demoncraps eat their own
Blazing light	How can this scum bag still hold office
Marisel Mart	BOOM The hypocrisy of the Democrats THAT S WHY ON NOVEMBER VOTE REPUBLICAN 🔴🔴🔴🔴🔴🔴🔴🔴🔴🔴🔴🔴🔴🔴🔴🔴🔴🔴🔴🔴🔴🔴🔴🔴🔴🔴🔴🔴🔴🔴🔴🔴🔴🔴🔴🔴🔴🔴🔴
Jennifer Christensen	The demorats are too stupid to realize that when they opened the can of worm against Judge Kavanaugh they were also leaving themselves wide open to face the same accusation The difference is that the demorats made up the accusation against Judge Kavanaugh whilst the demorat party is full of woman beater and rapist
The FU Crew Channel	Fair is fair correct What is good for the goose is good for the gander
Dougie FrogHopper	Another day another scumbag LIE CHEAT AND STEAL DOUBLE STD IS SOP 👩PUNCH EM IN THE FACE👊 OKAY FOR 💀👹💩US NOT FOR THEM
7878 stew	Where are the protester and CNN going nut
roy rosete	she is just helping drain the swamp
Bitter Clinger	Haha I have no sympathy for any of these crook Get them all
Scott H	GOOD
M Black	Can we find dirt on Gov Cuomo ny anybody please
Sportsfan7 M	He s a dim so it s okay
Duke Of Prunes	Chant with me everybody Hey hey Ho ho Democrat Senator Tom Carper ha got to go
dee76	That ’ s 6 dem senator with this history Sherrod Brown Of ohio the same thing
O K	Leftists beat rape and murder woman
Hand Solo	I m loving this report and hope more of this double standard realize it s a doubled edge sword
Angiolo Chiesa	WEL WELL WELL A DEMOCRATS IS ACCUSED OF BEATING UP HIS WIFE THOSE DEONRATS ARE HYPOCRITS JUST AS PREDICTED
AbsoluteTruth	Theater Women s group trying to regain credibility FemiFrauds They knew abt this long ago and did nothing
Fred Hunter	Nothing will change but good luck to them
Mark le	Democratic they are destroying this Nation value faith and tradition How can any one want any blue to sit in office MAGA and send all the Demo into the unemployment line
David Goans	So he can hit his wife and get away with it this man doe not blowing in office according to the Democratic procedure I think it s funny that they are turning on each other like piranha
MOODY V.	Tom carper need to step down he is a woman beater
Micheal Attar	WE NEED 7 F B I INVESTIGATIONS i bet u all CNN FAKE NEWS MSNBC FAKE NEW WILL NOT EVEN ACKNOWLEDGE THIS COMPLAINT
Mustard Tiger	GOOD
ShortbusMooner	Yep do say I say not a I do
Shelley Bayless	Good Go after Sen Crapper It s time for the Demo hypocrisy to end
Mike Mason	Wow Common sense and normal thinking from a surprising source Stranger thing have happened i suppose
Steven G Steger	We in Delaware are trying to get him voted out this November
RDC Tarantula	WHERE IS THE WOMENS GROUP AGAINST KEITH ELLISON THAT SCUM NEEDS TO BE HELD TO ACCOUNT THERE IS PROOF OF ABUSE
Da Nhl1	Normal democrat behavior
Annie: Lewis	Keith Ellison and Cory Booker need to go too
Jeff Strange	Yeah but he didn t mean it Hypocrisy and outright lying ha been going on with that Party a long time ago
SpaceFish	HE MUST STEP DOWN NOW
Mike Hill	Carper need to resign
Joan Smythe	What about Spartacus girlfriend
Santo Miguel	Maybe he s a moozlim following sharia law from the so called religion of peace
Paul Kersey	I don t agree with doing what the left doe That make u look a bad
Jan van der Meij	Alle dems are hypocrits also the left and libs and CNN
Attack Helicopter Jr	The Democrats knew that shit hit the fan
Real Newsforever	Wife beater are not Democrats Orange Man Bad
The frog	His liberal it ok
Tracy Goad	The Dems deserve this karma s a btich
me	He should be impeached just like what he want to do to Kavanaugh
M&M_RatPack	Epic End that double standard Down with Democrats
Nancy Stone	ONCE AGAIN A DEMOCRATIC HYPOCRITE HOLDING OFFICE YET ACCUSING ANOTHER W O REMORSE THE GROUP IS RIGHT ON HOLDING THOSE ACCOUNTABLE WITH THE DOUBLE STANDARD TO STEP DOWN GOOD CALL
Political Correctness Offends me	The left are too far gone to even care what hypocrite they are Truth is not even an issue for them control is I just added this video to a playlist in my You Tube channel titled Liberal hypocrisy The playlist is getting pretty long since there is no end to their hypocrisy
critical make Pawtucket great again vote Republican	😈🔫 that s okay it s liberal
funtoolbar1	No surprise there We all know demon rat are a bunch of hypocrite and projectionist
Eagle Legion	HOW DARE TGESE WOMENS ARE😅 GOOD JOB RED TSUNAMI ON THE WAY YAA FOR ALL
Elfina01	Good no more double standard Its about time they are held accountable
Michael Foye	The only way this witch hunt the Left ha started will go away is if it start hurting Democrat political figure too A few more of these and you ll see Democrat leader calling for calm and shifting attention to some other shibboleth of their own creation
God Bless America	What about demonrat Keith Ellison ’ s girlfriend being assaulted Nothings been done there either
Jamie Mezs	Could have been worse he could have left her to drown in a car like Kennedy did at Chappaquiddick
Joe Crocker	A woman after the truth and my own heart
Eugene Bigay. 1990 American Skaters	The same for woman politician who hit their husband or their kid get them the hell out of office equal right
Juan Figueroa	Is Fair what she requested
Lenny Leonardson	B E A UTIFUL
Wes Martyn	Following Donld Trumps rise to the presidency and I am not American and I didn t really like the man he ha shown the Anerican people his heart His love for his country THE SWAMP IS BEING DRAINED I have witnessed the pure unadulterated evil of the demonic rat party That you are and have been under a flag of war since 911 each and every demonic rat should and can be charged with treason Make it happen Cause what happens in America directly affect Canada GITMO FOR ALL OF THEM
Crazy Horse	How much you want to bet that cnn and msnbc spend 0 time on this story
roselyn rajoo	Hypocrisy Double Standard Senator TOM Carper must RESIGN NOW
domeright1	He won t last long once these lesbian man hater club get done with him
CLHART 62	Any man laying his hand on any woman in an abusive violent way and it not be self defense should be instantly neutered by their victim real men don t beat on woman coward do
West Kaintuck	In 33 year of marriage I have never hit my wife treat you wife like a Queen or someone else will
fatjellydonut glaze	HA HA🤪🤪🤪🤪
ANIKHTOS	ahahhaa democrat logic accusation for republican but free rapist for democrat why clinton is not in jail
Night Train	The first comment ha actually left me speechless
Ball ofgrime	I don t get this woman s group The video say they re against domestic violence that implies violence against both men and woman so why is it just a woman s group Why can t men join
Charles Dog	Honestly she wa asking for it
Jeffrey Jones	Dam fire his as
John McMordie	Let ’ s have an fbi investigation a hearing Protest burn shit attack democrat at restaurant attack at their place of work throw a childish fit outside of the hearing throw childish fit inside the hearing
Darryl Draven	Well another hypocritical Democrat in the news again
Mr Bawbag	I can ’ t believe I jacked off to Gary sexy voice 😘😘
