Fran	Se hizo justicia
David Correcher	JajajajajajajajajajajajajajajaüòÇüòÇüòÇüòÇ
Aimar 110503	Una pena esas √∫ltimas q tuviste al final de la primera parte de la pr√≥rroga √°nimo
Grobert95	29 0 yo no lo he visto
jl gmr	David v Gravesen like si quieren verlo
Diego Eduardo	Vaya robo 5 27 29
qosmovicion	Aaaaaaa
Estefan√≠a Saez	hola
Bryan Hernandez	Un partido Davidsp v Kolderiu ü§≠
RogueBoss	0 2 3 2 3 4 5 4 5 5 La falla de Cristiano todo falso te mato
ByLaserB	Se los tiraba todos al medio y nunca se quedo en el medio
Santiago Barrios	a mamar calvo
Pablo Ramada	A sido un gran partido el ultimo que perdiste fue mala suerte en penaltis pero a la pr√≥xima se consigue
Juan Manuel Escanez	Donde va con 6 iconos dice¬°¬°¬° Y el con 4 y CR la gente est√° malita tio
gustavo vender	Fuck EA
Nacho Pardo P√©rez	Aprende a hablar por listo
Sol Periko	lo siento pero si eres un puto crack y encima ese saber perder cuando el 99 del resto de jugadores estaria inundando el suelo con todos los lloros y toda la excusas chapeau
Giovannni Brizue√±a	Kolderiu v David
viscarrondo :v	Minuto en el cual ense√±a sus t√°cticas por favor
Javier Rocamora Romero	MUCHISIMO ANIMO NO TARDARAS EN CONSEGUIRLO SIGUE ASI CRACK
Youns Azzarouali	Y en el 5 5 hiciste mal el timefinishing Muy bien David
Kriller	Buaaa que cerca del 30 0 sigue asi crack
Jos√© Sestelo	Nuevo sub eres un espect√°culo jugando y tu calma me recuerda mucho a mi estilo que juego solo que tu te cascas 29 1 üòÇ
Moha TF	Muy sad men sigue intentandolo crack
Carlos	animo tio la siguiente seguro que si a seguir dandole ca√±a
Daniel Ausocua	Usas la 442 o la 4231
Hugo Gea Ovejero	eres un cabron
Elvis Sebastia	Te mamaste
Peter Mc Allister	la verdad que no e lo mismo perder 1 y ganar 29 que ganar 29 y perder 1 juegas de escandalo david y estoy seguro que lo conseguir√°s seguro mucho animo
Luca Garzeli - Trading Deportivo	Vaya exhibici√≥n de Vieira en el partido del 28 0 y del 29 0 Y luego dicen que el tr√≠pode era Makelele Gran v√≠deo
Miguel Rom√°n	Ahora mismo ere dioh
thebryn xd	Pelao animo
FIFCOD	De igual manera siempre lo hiciste bien √Ånimos Merecias ganar
mateo vanegas	Asco de juego un partido controlado para asegurar el 30 0 y el juego ayuda a tu rival sin manos
iiMaaGiiKHD	odio tu voz tio lo siento
Ismael Lopez	Te ha ganado un suscriptor ma muy grande
SANTAMARIA	El mejor partido que he visto
Adri√°n Rodr√≠guez Delgado	David en mi opini√≥n tiraste los penalty muy r√°pidos sin pensar y el te tir√≥ todos por el mismo lado te lo digo porque lo reflexiones q igual estoy equivocado te fallaron un pelo los nervios aun assi muy buena crack 1 saludo
minitapia crs	David cabeza arriba cada vez mejor GUERREROS
Jorge 51	Muchisimo animo tio eres un grande pronto lo conseguiras seguro crack
Lorena Gonz√°lez Ortega	te come la droga manue
Alberto Garc√≠a	pon el micro bien q no se escuchen los putos botones q rabia
Jonathan Hern√°ndez Pineda	Nuevo sub y vengo a quedarme eres un grande
Mati D Rod	Yo no podr√≠a jugar un partido as√≠ a mi si que me dar√≠a algo jaja e una pena Es el primer directo que veo de ti aunque ya conoc√≠a sobre ti jodido partidazo el √∫ltimo √°nimo que hay muchos fut champion ma por jugar el 30 0 estar√° ahi
Alejandro L√≥pez	Bro vi esto hoy y me lo disfrute nunca me hab√≠a sentido tan nervioso en un partido de fifa jaja perdiste el partido pero ganaste un suscriptor
Pi√±ita üçç	Djminutos v
OscarBasket 16	Que grande lo va a conseguir seguro dentro de poco el Fifa fue muy injusto
Joshua Acevedo	Acabo de entender que existen mejores youtubers que DjMariio
YoSoyDani!	Como jode que te ganen as√≠ enhorabuena igualmente crack
Sergio Zurdo Garc√≠a	David me gustar√≠a saber como de importante e y si usa tu o no el r1 para defender ayuda segundo jugador un saludo Me encantan tus v√≠deos
Juan Marcos Diaz	Eres una makina loko vaya partidazo
samuel tiburcio	Mirando bn el partido lo perdiste por tonto porque pudiste perder tiempo
Durken	Un poco aburrido este hombre
√Ångel Mont√≥n	√Ånimo t√≠o te lo mereciste
Silencer	Que pesado todo el tiempo cambiando t√°cticas formaciones poniendo pausa Parece un partido de B√°squet
David Avalos	DavidSp llorando por un 29 1 Y yo bien emoci√≥nado por un oro 2 v la verdad se lo merec√≠a pero esto e el Fifa
ieli 06	Que injusto el √∫ltimo partido
Lic. Ruben Perez	Bien jugado pero debes ser un puto guarro para ganar 30 0
Derecha Ganadora	Que suerte tener tanta calma Yo ya estar√≠a peg√°ndole de hostias a cualquier cosa
Marcos Rueda	Muy muy grande David La semana que viene el 30 0 est√° clarisimo a seguir asi grandeeeeee
Auxy	Animo la semana q viene ma tu puedes
Mariete_72 laguna alfaro	Animo David y gracias por representar as√≠ al espa√±a
Miguel Angel Egea Lopez	Cuando va ganando y se desconecta tu rival no te suben habilidad en Division Rivals Es muy injusto
alonsito	A alguien ma le pone nervioso el sonido de los botones
Luxito_CL	Wena peleao hijo la maraca que proximo fut champion lo concigues todo CHILE te ama washo kuliao
Jomi09hf	Eres el mejor David
Santiago Ramirez Uribe	Que pena de verdad que estubo apunto felicitaciones igual so un recontracrack me suscribo
gaston zarate	David un abrazo desde Argentina y decir que so el que me ense√±√≥ a mejorar y tener el nivel que tengo crack Saludos y vamos con todo el pr√≥ximo fut
TitoFos	2 28 35 el pedo m√°s √©pico del canalüòÇque grande David con la bocaüòÇputo Amo este directo marcar√° una √©poca un ante y despu√©s üòÇlike si t√∫ tambi√©n lo escuchaste
Jes√∫s Rold√°n	Me puedes decir que c√°mara llevas y que como la tienes configurada Muchas gracias Y mucho √°nimo crack eres el mejor sin duda para el pr√≥ximo consigues el 30 0
John Cecina	Buen directo maldito calvo de mierda Vamos por ese 30 0 en tu prox fu xampion
ruleshawn	Qu√© pena t1o an1mo Dav1dSP
Facundo Carena	Esto e un jugador de fifa no los demas grande pela
Sr LewanOsky	√Ånimo pich√≥n tarde o temprano te va a llegar el 30 0
Chema Cancino	Llegar√° el 30 0 escrito queda ‚ù§Ô∏è Me inspiras mucho y un 29 1 dif√≠cil de hacer
THE TIGER	ERES UN CRACK ANIMOOOO DAVID ERES UNA BEESTIA
Boris Nass	DEJEN DE JUGAR A ESTE JUEGO QUE ESTA TODO ARREGLADO NO SE DEJEN ROBAR EL DINERO
jAtA	DAVID Recuerda que para ganar siempre primero hay que perder y aprender de la derrotas no te desanimes
lluis royo caparros	Que mala suerte macho Juegas muy bien el 30 0 acabar√° callendo david
Leandro Cabezas	eres grande david te sigo desde argentina a por el 30 0 te amo peladito lindooo ‚ù§üòä
Gabrilo Princip	Grande pelao culiao todo chile te ama üòç
cvh cjhh	Eres un maquina t√≠o ya ver√°s que despu√©s de esto se viene lo mejor los que te vemos de hace tiempo sabemos que t√∫ eres de los mejores compitiendo El siguiente FUT Champions haces 30 0 Sabes que todos te apoyamos Sigue as√≠ üëçüèΩüëçüèΩ
Rambo jr	√Ånimo David eres un crack el 30 0 era merecido
xJMasHD	5 11 08 el lateral estaba solo contra el portero
joseluisitoXD	Esos fallos se pagan muy caros sobre todo jugando a ese nivel una pena porque mereciste ganar pero bueno mucha suerte q seguro q lo va a conseguir y muchas gracias por compartir esto con nosotros ANIMO
pistolo braulio	Como te puedes concentrar con esa mierda musica de fondo tio jajaj
Pepitoflow	Eres un pro player del fifa y un pro player callando bocas siempre te lo dire
El negro Tuma	Q groso feliz 29 terrible equipito tenes abrazo desde argentina
Antony FIFA	animo crack si guerra as√≠ solo te falta ese partido del 30 0 muchos quisieran siquiera ganar 5 o 10 o 20 seguidos no hagas caso de los hater o los que te apoyan s√≥lo cuando ganas y cuando pierdes no O te insultan sigue as√≠ y lograr√°s tu cometido
Mani Smith	podrias hablar un poco ma
Jaime Osuna Carmona	Eres m√°s grande que el d√≠a de el pilar La semana que viene te haces el 30 0 por mi cojones
fifachi	El √∫ltimo lo he vivido como si lo jugase yo Merec√≠as ganarlo √°nimo que har√°s un 30 0 jugando asi
Pablo M√©ndez	√Ånimo t√≠o eres un putisimo grande y ya ver√°s como el 30 0 te lo sacas con el nabo en la pr√≥xima joder üí™üí™üí™üí™üí™
Jes√∫s Moreno Ortega	Eres una locura jugando te mereces ya un puto 30 0 pero tienes un nivelazo qu√© flipas desde fifa 17 qu√© no te ve√≠a as√≠ de bien Grande mi KrilinSP‚ù§Ô∏è
Ptttb1	Que grande tio Una lastima haber perdido el 30 0 en penaltis üò© pero bueno el futbol e asi a seguir con ese nivelazo que llevas la proxima jornadas desde fifa17 no te veia con ese nivel tan alto Por cierto me he visto el directo por la ma√±ana y no me he podido ni tomar el cafe tenia el corazon a mil por horas madremia
iaoo09	animo david eres un grande
Cristo Miranda	Grande David mucho apoyo tienes un grandisimo nivel en este juego y confi√≥ en que har√°s muchos 30 0 en lo que queda sigue as√≠ que motivas mucho a los dem√°s
threze 86	eres un puto crack una ma√±ana dura en el curro despues de quedarme hasta tan tarde pero merece la pena verte jugar eres un espectaculo tio un abrazo fuerte y mucho animo para la prox ya vendra ese 30 0
javier89083 BB	No entiendo a la gente que cuando perdi√≥ le empez√≥ a insultar dici√©ndole calvo y cosas peores cuando se ha hecho un 29 1 y seguramente esas persona no lleguen ni a √©lite o ni siquiera tienen la play o el juego √Ånimo David que eres un crack
victor de diego casla	Sinceramente eres un makina
Matias Arevalo	Eri grande pelao qlo a la otra se viene el 30 0
Sjsjs Abajan	enorme david el ma grand de Espa√±a Que sirva como aprendizaje Eterno campeon
queipo GG	eres un grande david muchos animos la siguiente semana te ira mejor
Miki L√≥pez Pi√±eiro	Eres un m√°quina David no te ralles ya quisieran muchos repetir 29 1 con lo que llevamos de juego palante que ya mismo est√°s en 30 0
Ruben Garcia	Vamos David que tu puedes A por ellos maquina Amunt Valencia Un saludo de un Valenciano üòâ
thepepelucrak22	Eres un maquina enhorabuena tiiio üëçüèª
LuGM	Ojal√° tener la calma que tienes tu cuando los partidos y el equipo no van bien Sigue as√≠
Diego Ramos Cabrera	fuerte t√≠o manco tirando penaltis y par√°ndolos üôÑüôÑüôÑ
Marco Franco	Simplemente el mejor jajaü§ôüèª
aricaos tlou	Grande pelao sapo y la conchetumadre el proximo fin de semana haces el 30 0
Dorgengoa	√Ånimo David la calidad la tienes te va a hacer ma de un 30 0 y lo sabes
Miguel Morillo	EL PARTIDO MAS EPICO DE LA HISTORIA
Adrian Villora	No pidas perd√≥n gracias a ti por representarnos tan bien crack
LorDOkUpA	Ostia David que epico enhorabuena Molaria que pusieras un videobds tandas d penalty de tutorial pq este a√±o est√° muy jodido
AbuAbu Gamer	√ÅNIMO BRO He cantado el 5 5 como el gol de Ramos en la D√©cima una pena lo conseguir√°s seguro
Valle Medina Godoy	Minuto 1 30 50
Monster Persa	Una preguntilla de na e necesario acabar los 30 partidos de fut champion Soy oro 2 y me sobran do partidos pero con eso no llego al siguiente oro lo digo ma que nada porque me da palo acabarlo pero quiero que se me asegure la recompesas de donde estoy muchas gracias ü§ôüèº
rogelio gonzalez	Djmario a quedado elite 3 aqu√≠ mi reporte bye v
R jorjee	grande pelao ql el prox fc e tuyo tienes el aval de chile
Dani	5 30 00 tanda de penaltis para decidir si hace 30 0 o 29 1
Fernando Cba	Que grande eres te sigo desde tu 80 0 en fut17 animo Ya se dar√°
Victor Torres	Grande pelao kl todo chile esta contigoüá®üá±‚ù§nos llegaste al corazon
Felipe the demon	Jugaste la raja hermano vo dale eri re crack un abrazo m√°quina ‚ù§
Mati Paz	Aprende a callar bocas aquellos heater un 29 1 esta ma que logrado VAS A LLEGAR LEJOS ESTE A√ëO FUERZA CHIELLINI
This is music	He visto todo tu directo deivid ha estado brutal El proxime finde te los come
BaSTi Zapata	Fuerza Pelao el pr√≥ximo finde 30 0
ToP LaYerS	Vas 29 0
