Jainul Ansari	Chupana bhi Nahi ataa Jatana bhi Nahi ataa
Suraj Barman	Beautiful song
Zainab Wadood	Anu malik 😕
Irfan Ali	i love this song
Kitty a	Super song kitty
vs love	lovely
Aashir Md	So beautiful song
Pankaj Nayak	Aise gaane pyar ki ghaharai ka ehsaas karate hai
Khaizer Wasi	Shahrukh ha so beautiful song and movie good too see all song Great singer like this wow Aaj Kaal ka singer shame 9n them rap and all stuoid
Jahid Khan	top
mohammad rayyan	This song remembers me my childhood day really those were golden day no tension there in life I am lucky that I grew up in 90 that s why I like it very much in those day one side love story empty pocket real friend there
dinesh rana	Very lovely song
Vishnu Raman	Superb song 🤗
KRUSHI BHARATHA Online	Kya gaana hai suuuprr 90 s genaration
nice sona.	very
Partha Pratim	Ye song kumar sanu gata to aur bhi acha Hota
Gaurav Roy	One of the evergreen song
Jorjaman Khan	This song help me live
Sanjay Kumar	In 90 s it wa very common to most of the boy in small town even boy knew girl are also interested Feelings were awesome
Sultan Sk	Nice
pramod baloni baloni	Love u song Baazigar
bapan baul das	nice song
fais khan	This song belongs to every person who due to some unfavourable circumstance could not express his love at right time
Max Dean	Anu Malik in top form He hit the jackpot with Baazigar Damn what an iconic movie music soundtrack and direction this masterpiece had
nur Aalam	my choish song my mo 9752969577
Waris khan	Md waris khan
Pankaj Murchitte	These song are never died because of these are soul of every person
Siraj Siraj	kysahojanu
Raja Ahirwar	My faburate song
Aar God	Though that guy wasn t handsome than Shahrukh But while seeing in a 90 kid I felt Ladki oos bande ko mil jaye
hemuchauhan hemuchauhan	nice song
ईशवर चौहन ईशवर चोहन	Nice song
Sikander Dadhwal	Rathor Rocks
md kuddus ali	Iove song
Rajdeep Singh	Nice
Saurav Kumar	Ever green song
PadviGorkh Gorkh	Superhit vinod rathod
Jitendra Bada	One of my fav song
Satish Upadhyay	Vinod rathod one of the favorite singer
Satish Namdeo	n k k
Muskan Khan	Awsm song I just love it old song r always awsm
ASHISH TRIPATHI	This song deserves more than 100 million view
Abhi mishra	Still I love this song because of Vinod sir
Mudassar Tahseen	nice song
اكيرا HB	Sopar 💟💟👍👍 SRK👏👏👏👏👏❤❤❤❤❤❤❤ 😔😔😔😔😔😔😔💔💔💔💔💔💔💔
Ashraf Ali	Nice
Rakhi Bhol	Lovely💕😍
Dhiraj Dangi	Siddharth what a lipsing dude hat off i never felt that song wa sing by vinod 😊 😊 😊
mintu barman	I love this song
Debjit Rittik	💖wowwaa
Top Singh	hi
harshit pandey	Vinod rathod Bhai gajab bhut kam song gaey hai aur maximum all hit given by this man
Swapan Das	valo ganer s kinara
diki choden bhutia	I just love this
Imran Haji	Emotional song
Ratan Sen	Classic
Shovelware	I a so glad A R Rahman saved u from this crap
friend	This hathelipe actor SIDHDHRATH Ray is no more
Satyaprakash Dubey	Hatheli me waw
maneesh sharma	Remember my school day 😢😢
Pk Gautam	सुंदर गीत
Himat Bhanushali	Agar kumar sanu ne song gaya hota to
Vipin Kumar	very nice song
Sachin Kamble	S😢P😢e😢e😢c😢h😢l😢e😢s😢s
NOOR ANSARI ADVOCATE	lot of listing this song again and again
Waseem Syed	love is great
দেবাশিস কবিরাজ	Have sonbar lag6 so naeis बद्ध फदफलफधफ भदबध
daniyal lakhani	Yes
Asad Shoaib	nice song
Sudhir Prasad	Nice song
Karamala Nouhira	Nice song
Monu Monu	Nice video 😘😘😘😘
Amitabha Chakrabarti	The actor singing the song is Siddharth Ray he ha left u long time ago in 2004 FYI
Pratik Ghule	Nice song
Surash Soni	Suresh
Sarvar Khan	Very nice song
MD Aashik	Pahle ke jo gaane hote the unka matlab samjh me aata hai Lekin ab ke jo gaane hote kuch samjh me nhi aata unka matlab
Anas Sheikh	💔💔DARD HEIN DARD PYAAR NE AISE THUKRAYA KE NA AB KOI HAMARA HA HUM KISI KAY💔💔
Aarav Upadhyay	Seriously I am a speechless I have a no word ♥️♥️♥️♥️♥️♥️♥️♥️♥️♥️♥️♥️♥️♥️
nayyer Raja	very naic
Niraj Prajapati	💗💗💕💕😍😍💑💑👐👐
Aman Raza	hatheli pe tmhara naam likhte h mitate h
selim sabdel	nice song
Balram giri Goshwami	Wow superb hit Song
Amol Mahajan	very nice
niyaju niyaju	Nice bro love you
Sandeep Sharma	Best song
Raju kuruba	Evergreen song
Subitha Sunil	I love you suni
Фатима Бондаренко	Красивая песня SRKAJOL super 😙💖👍👏
Vinod M Bhusara Vinod M Bhusara	90 Soong is best Soong heart teaching Soong
Rayif 12	2018 is going to end n em here listinng dix song who else Hit👍
Sanjay Verma	very nice song
Dinesh Kumar	Aata Kya a
Umeed Khan	gjb baba
Sushil Toppo	Heart touching song
md mohid md mohid	i lovey song
Syed Khaisar	this song is best in 2018 also
P.kadambini Rao	I like this song so nice
Lokesh Dodiyar	I love this song Wah Maza aa gaya
Мардон РАЗОКОВ	Король индиа
Shireen Farha	best song
raju debnath	Hiii
Dinesh Chinnari	Evergreen song all 90 s song
imagic studio	still watching octo 22 2018
Ajay Tudu	Lovely song
Malik Asif	One of my fav song
Paul Panggeng	I love this song i like it
Tudu Babu	I love u srk sir
Hidden Feelings	छुपे छुपे से रहते हैं सरेआम नहीं हुआ करते कुछ रिश्ते बस एहसास होते हैं उनके नाम नहीं हुआ करते 👫 Love u jhalli 😍
Bharat Pradhan	Nice song
jitendra att	excellent
Md. Sadath Sadath	Nice song
anup mishra Dada	Who love this song
Seema Pandey	My favourite song
Aarav Kumar directory	Lovely song💓💓💓💓💓💓
Ravi Ghritlahre	Batna bhi nhi ata
Khadim Ali	Bhai ap k song naa mara bhai ko pagal kr dya hai
Zahid Khan Zahid	Nice
manish verma	Love is meaning and meaning is love not a song language language mean love
Prinsh Sonwani	best song
Syed Fazil raza Syed Fazil raza	Gud
Nitin Dimri	Vinod rathore wa 2nd best after kumar Shanu
মই আখমীয়আ ল'ৰা all time hit	90 Ka song s all time hit 💖 se
MOHAMMAD ALI KHAN	Nice song
sanjit sengupta	retro r grt
sinthi shah	Who is listening this song in 19th October 2018 at night 11 06 pm I love Vinod ji voice badly ❤
Nepa Mandal	Touch my heart
Jahidhasan Jahid	Nice
Aamir Khan	Beautiful song
Ayush Pokhriyal	Who listen this song in 2018 😘😘
Alok Kumar	My love song
Playlist ARG	I Love This song It wa a big hit along with kali kali aankhei bazigar o bazigar kitaabe bahutsi etc song of this movie
Maria Nisat	well
jyoti soni	Nice song I like it
Parikshit Soman	वो RUM और गाने मै छुपा वो गम
YOJANA CHAUDHARY	Evergreen song
Ratan Jaiswar	so sweet song
Gandham Ram	🌱🍯🌱🌱🍯🌱🐝🌱 🌱🍯🌱🌱🍯🌱🌱🌱 🌱🍯🍯🍯🍯🌱🍯🌱 🌱🍯🌱🌱🍯🌱🍯🌱 🌱🍯🌱🌱🍯🌱🍯🌱 🌼🌱 Hi honey 🌱🌼 ☁😊☁☁😊☁😁☁ ☁😊☁☁😊☁☁☁ ☁😊😊😊😊☁😊☁ ☁😊☁☁😊☁😊☁ ☁😊☁☁😊☁😊☁ 💤💤💤💤💤 ☁☁☁💤☁ ☁☁💤☁☁ ☁💤☁☁☁ 💤💤💤💤💤 ☁ Sleepy ☁ 🌱🍯🌱🌱🍯🌱🐝🌱 🌱🍯🌱🌱🍯🌱🌱🌱 🌱🍯🍯🍯🍯🌱🍯🌱 🌱🍯🌱🌱🍯🌱🍯🌱 🌱🍯🌱🌱🍯🌱🍯🌱 🌼🌱 Hi honey 🌱🌼 Good Night 💤🌙 😊 Sweet Dream 🌠🌠🌠🌠🌠🌠🌠 🍸🌹🌹🍸🌹🌹🍸 🌹🌹🌹🌹🌹🌹🌹 🌹🌹🌹🌹🌹🌹🌹 🍸🌹🌹🌹🌹🌹🍸 🍸🍸🌹🌹🌹🍸🍸 🍸🍸🍸🌹🍸🍸🍸 🍸🍸🍸🌹🍸🍸🍸 🍸🎁😊❤☺🎁🍸 🍸🌹🌹🍸🌹🌹🍸 🌹🌹🌹🌹🌹🌹🌹 🌹🌹🌹🌹🌹🌹🌹 🍸🌹🌹🌹🌹🌹🍸 🍸🍸🌹🌹🌹🍸🍸 🍸🍸🍸🌹🍸🍸🍸 🍸🍸🍸🌹🍸🍸🍸 🍸🎁😊❤☺🎁🍸 🍸🌹🌹🍸🌹🌹🍸 🌹🌹🌹🌹🌹🌹🌹 🌹🌹🌹🌹🌹🌹🌹 🍸🌹🌹🌹🌹🌹🍸 🍸🍸🌹🌹🌹🍸🍸 🍸🍸🍸🌹🍸🍸🍸 🍸🍸🍸🌹🍸🍸🍸 🍸🎁😊❤☺🎁🍸 ✨🌾 🌾 🌾 😏😏😏😏😏 😏😏😏😏😏😏😏 😏🕓🕓😏🕓🕓😏 😏🕓🎱😏🕓🎱😏 😏😏😏😏😏😏😏 😏😏😏✔😏😏😏 🌀😏😏😏😏😏🌀 😏🌀😏😏😏🌀😏👍 👉🌀🌀🌀🌀🌀🌀 🌀🌀🕐🌀🌀🌀🌀 🌀🌀🕐🕐🕐🌀🌀 🌀🌀🌀🌀🌀🌀🌀 🌀🌀🌀🌀🌀 👟 👟
Rahul Chat	Om SaJaL Shradha Om PraKhar PraGYa Om TaT SaT GaYaTrI MaTa Om TaT SaT SaraSwaTI MaTa Om TaT SaT SaVITrI MaTa
NARAYAN Baghel	My best song
Vastav Madridista	official friend zone song
SUNIL SHAW	हथेली पर तुम्हारा नाम लिखते हैं मिटाते हैं
Ali Zaid	purani yadeen
chamandeep bhatia	i love this song this song is my life one part
prasenjit debnath	Excellent song of 90 s
Dola Barik	heart touching song 💕💕💕👌👌👌👌👌👌😃😃😃😃😃
shubhangee Dixit	What a music lyric and voice 😍😍😍 beaitiful song
sunny srivastava	this is the national anthem for one side lover s 😜😜😀😀😀❤❤
kirtikumar karade	Rip sidharth ray
Sweet Heart	Nice
Mahi Solanki	plz dipu come back I really miss you
Goldi dhillon	Awsome Power
Saroj Ahirwar	melody song evergreen
Bilal Khan	Blall
owaish sultan	super
Shalini Murmu	Love this song
Mir Ilyas	Who is listening this evergreen song in or after Oct 2018
Atul Dholkiya	i love this song
Karan Kumar	My favorite song bro
Gopigoverdhan Gopi	Hi
Angel Angel	Lovely song😎😎
Aarohi Adakmol	Superb song
milind rathore	Vinod Rathore great
Noman Khan	kh
take help bhaskar Meena	Padna bhi nahi aata Likhna bhi nahi aata
Nowshad Pasha	Nowsad
Sagar Singh	Nice song
Akhtar Hussain	Kya ganaa hai beuitfull
deep Jyoti	chahat me dilbar ki kadar diwane h😍😍😍👌👌👌👌💑🌹🌹🌹
naagraj jaat	Ye song jab bhi sunta hun to mere samne wale pyar ki yaad aa jati h yr Yr hum log golden era m peda hue the jo 90 tha such ae golden sach hi kha hathli p tumhara naam likhte h
Raju vitkar	Very nice song
Erchhagan Roat	Lovely song
Md Zakir Shaikh	priya smbhalo piyaar ko
Pawan Verma	Super
Toqeer Ahmed	विनोद राठौड़ जी का प्यार भरा सूंदर गीत
Jinjariya Dhruv	Vah Vinod ji vah
arya vedanand Kumar	wow great song
muskan Jamal	Mast song
Meena Dutt	बहोत पयारा गीत हे।
Praful Rankja	Maharaja
Sonu Jaiswal	Super
kunal kathe	Loved it But I personally love Pankaj Udhas s version 😍
RAJJAK HOSSAIN	Sweet song
Kamran Ullah	A masterpiece by great Anu Malik
Umair Aziz	Chupana bhi nhi ata jatana bhi nhi ata hme tumse muhbt hai btana bhi nhi ata 💓💔💟💝💘💗💚💞💖💕💛💗💑😘😘😭😭😓😓
Kumar music creations	so much soug
LALIT KK	In 90 s apni to aaj bhi life whi par h ab to kat rhe h
yakio nilo	Still listening this song 11 10 2018
Bivas Joyswal	i lv th sog
Vardeep Gill	Who is listening this song at the moment
Pritam Rajbanshi Pritam Rajbanshi	sach kahoon to la jababb
sai kumar	Super sad song like it
kiran rai	Best song Arun
Mantu Kumar	Very nice
Mahadab সুমন	Good song
Sandeep Yadav	Ye song Kumar sanu ji ne gaya hota to bahot bada hitt hota
OLD Songs Tv	zuban pay baat hai lekin sunana bi ni ata
jitendra kori	Hii my febret song
Vijay Chavan	జీవితం గురించి కూడా తెలిసి ఉండి ఒక రోజు నేను బాధ పడ్డాను రాసిన కథ ఇది మన
in visible	2018
Syed Akbar	Super duper
Mangal Hemram	lovely song
Amit Roy	90 s kid are in the middle of golden generation and fake generation
Amit Sanar	Wah lovely song
Kuldeep Singh	kash mein usko bta pta
Shashikant Sahu	Osm song
Kamal Mandal	nice song
solankikaran solankikaran	miss you
Sandeep Singh	i remember ed
Abhishek Tyagi	SAALA KYA ZAMANA THA YOU TUBE NE AAJ KA BANA DIA THNKS UTUBE
Dabanshu Pramanik	fit back Enarge
Barik Pradeep	My favourite song really bro heart touching
Runam Singh	So sweet song
Rakesh Sahu	Shreedas sahu
john bhattchrryaa	I think this one nd darr over the best movie of S R K everyone like his all love story film but those day S R K always try to experiment but now he play safe
Xubin Ahmed	Nice
Dhirendra Yadav	Sahi Hai Yaalo
Tajim Ansari	TAJIM
Md Alfarhad Hussain	ever green song
shyam vishwakarma	nice song
mitun podder	90 song r very special
Kaseer kaseer	I Love you
arpita mitra	Awsmm ever green
Parash Kumar	Ihe Topl
Santosh Kumar	Haveanicesong
Aaliya Praveen	wah gana h supar
Sonik Sharma	vinod rathod is best singer after abhijeet
Sourbh Kumar	Nice song
Kalyanbrata Bose	Lovely song i love this song
Naseeb Shaikh	Wawa good mai laik hakim md
Ram Purti	💔
Sayantan Mandal	Listened to a lot of male and female cover by various YouTubers But Vinod s voice is legendary even better than Pankaj s version of this song
Muhammad Usman	One of my favourite song Vinod rathod 💓💓💓
murad ali khan murad Ali khan	Good singer Vinod Rathod
KIREETEE MUNDA	Wah superhit ati sundar song video
Patel Vipul	Fantastic song I love song
pagalpanti ki hadd	Koi kissi see pyarr Kare bahut Parr koi samjh nai PTA our dill tode ke Chala jata hai
Harvinder Singh	O ya ya
heeralal sharma	Best song sung by Vinod Rathod
SyedAnsar HussAiN	MY CHILDHOOD GROWS WATCHING AND LISTENING KUMAR SANU UDIT NARYAN AND ALKA ❤❤
Ankit Kumar	wow nice Remember the pas time in childhood
nilesh nagvanshi	mast hai
john cena	anu malik😀😂
Asies DasHi	I Love ❤❤❤💘
Sunil Uikey	May febret song
Pramod Upadhyay	Very nice Song
Anay Khanra	The best to me
Ankit Kharia	old is gold
SYED NAQVI	nice song
Mannat khanam	Chupna v nahi aata jatna v nahi aata
Muhammad Uamar	Mi farwat song
Dhillon Chawinde Wala	Kya song ha bahi mast
Ningaraju raajakumara	Wow
ashhu sudhanshu	All time favourite
Rupasi mohanty	Sweet song heart touching song
Sunny kumar Topiya	nice song bro
Djratan Ree	Mast pic video ji
Asif Ali Detho	1 10 18 lisning
Acharya Neelam	yaar song bahut sweet hai but mujhko video dekh kr hassi aati hai 😝😝😝😝
Nilkantanandhi Ark	I love very much this song
Bubai Halder	Nice Singer 😃😃😃😃😃
Ratanlal Meghwal	Nice song
Pramod Pandit	Lovely best song
Subrat Sahoo	Nice song
KotiChennayya	side hero becomes hero all of sudden
Ankit Sri vastav	Supa song
manoj kumar	Shahrukh khan song are awesome This is real king srk
Shivank Pandey	mst song
sunita sunita Katariya	UB oz 0
Sameer Pasha	Osm so beautiful song 💖💖
Abhishek Kumar	My favret song
Neeraj Sharma	Wonderful song
Punit Shakarwal	love song
SANJAY KUMAR PAUL	nice
SUNITA KUMARI	I love this song
Md Saif	Nice wow
Poonam More	evergreen song👍👍
Meenu Meenu	Supperrrrrr
Toofan Sheoran	Even though so heart beat
moli anand	i like this song
Pappinder Singh	Nice song
Mangesh Gaidhane	mangesh
Tonmoi Tinni	💖💖💜💜💝💝
R J Sanas	Churan hero
kabir mirza	ayesha khan said the real comment
Vishnu Jadhav	My Fevret
baba42042	🖒😍
Gopal Maity	nice song
Ram Gupta	Nice song Sunita
Dhirendar Choudhary	I love this song childhood song
BHAUKUMAR RATHOD	I love this song
Raju Naskar	Hi
anwar shaikh	E
Razia Chand	Nice song
moshin Khan	Nice
AFSAL FASALUDEEN SOFIA	Chupana Bhi Nahin Aataa
Siraj 1787	Really miss my old day
AJ Production House	who is listening this song in 26 Sep 2018
Tarun Tarun Ji	O Some Song I Like This Song
Anurag Gupta	Nice song
Er faizan Fayaz	Nice song
Malik Ayub	Lovely song
Abir chatterjee	what voice Vinod Rathod ha awesome
Tofick tofick	soooooo super song
Entertainment ChasKa	Pure Bollywood Gold Songs
Sabir ali	ali
Mamata Parida	Vinod rathod great singer 👌👌👌
Avijeet Das	So nice song 💚❤😘😘
Thameem Ahsan	Vinod rathod one of the greatest legendary singer his voice give goosebump
Routhu ganesh	Surer song
Malati Patra	vare good
Akeel Ahmad	I love song
Satyabana Bhoi	My fv song
jiban karmakar	Kumar sanu better suit for this song
Armands Kalniņš	Super
Rokiya Jayesh	I miss you kinjal may love
Vishnu Nerlekar	Nice song
CHAND COMEDY CENTRE	I love this song and singer
VEER PAL	Hart touching song
Suparna Sasmal	People Nice song
golu kumar	I love this always evergreen
bibek chatterji	Director duo s abbas mustan r really superb
Prasath super	too
Gaurav srivastava	💗💗💗💗
Sumona Ghosh	you are best singer vinod rathor Sir
Chetan Sharma	👌👌👌👌👌👌👌👌👌👌👌👌
Dipak Dey	Very heart touching love song
Rituparna Paul	Who made kajol an actress
Anil Kumar Singh	Soo lovely song
Ayesha Khan	You are here because you are 90 kid agree Thanks god I grow up hearing this not Honey Singh or Badshah
JITENDRA Kumar	Nicely song
Tabishofficial	2018 September who else come here for old is gold
SHANKAR KALE	I love 💔 Aasha 💔
subhajit Gayen	chori chori chupke chupke tumko Dekha karte hai haale Dil batane se Na Jane kyun darte hai
Abhishek Yadav	Nice song
Aman Singh	The audio and video both are very nice
Mohan Joshi	Gana sune to mare ansu agaya 6296683510😭😭
Upesh Kumar	Thanks you friend
Reema Ray Reema Ray	Heart breaking song
Vijay Rai	Hame bhi nehi ata hai jatana
Nida Fathima	Wat a combination Anu Malik Shahrukh Kajol and Vinod Rathod awesome 90 song
kundan kumar 12345	So nice song sanu g😢😢😢
Mangesh Muddalwar	nice song
Pr Ashalatha	Vinod Rathod and Anu Malik on screen But the song touch our heart on the feeling of inspector
ALPESH PATEL	👌
Radha Kunwar	raja hindustani
Ritesh Aashiq	i love this song it is my fevraut
Ashok Naik- Chavan	Nice song
subhash maravi	Superb
Chiranjib Rao	Nice song
sureshrandive Sureshrandive	Nice snog sir
Aliya Khan	Nice song
Vishal Sidhu	Thanks sir
AADILafsar Malek91068939q9	afsAr
amresh singh	g
Ravi Saini	Very nice song
Fikri Achmad.Faiza	Jadi terkenang jaman dulu saat masih belia selalu tersimpan di hatiku 😗😗😙😙😚sweet memory
Mithun Kumar	lyric are understand by the one who may not get his love😔
Chandan Das	my favourite song
Smar Smart	2018 September
Shree Ram Sahani	I love you srk my love
Raju Singh	Nice song
Dr Wagay	Wowwww the muzic the voice of vinod ji the lyric all touch the soul itz fantafabuls
Pankaj Dhiman	Nice song
Sabir Mondal	Nice
Bharati Pandit	Wow 👌👌👍👍
Laeba Khatoon	Bhut hi pyara song hai I love this
Alok Ranasingh	nice song i love this song
Saba Zahid	Sweet👍🏻
ASIF KHAN	Sharukh my fevret
Md Maheboob	very nice
Venkatesh Kadam	The Great Anu Malik s melody Orginally this song sing by pankaj udaas later that wa that much perfect later malik saab ade the song with Vinod radhod it become very POPULAR Vinod rathod is a brother of Shravan rathod duo Nadeem Shravan Rathod
Ritika Manrow	Davinder kaash tum kabhi meri taraf bhi dekhti galti se hi ek baar
Nilesh Mil	most likely
Sujit Dey	nice song
Faizanmalik Mrmalik Faizanmalik Mrmalik	Osm
V P Yadav	nice song
Kuldeep singh tomar kuldeep singh	this singh kajal ke lia
Akram Khan	Sala mami dely sunta ho
Karan Singh	So sweet song
Gobinda Puran	Nice song
MANOHAR KUMAR	Lovely song
Kalingapatnam Mahesh	mera hal bi vaysi huvata
Hnuuman Prasad	09415037381 new delhi in now🇨🇮🇮🇳🇮🇪
RAJESH GUPTA	2018 anybody is here to listen this beautiful song
vijay selot	Very sad song😭😭😭😭😢😢
Zubair Tariq	Bht hoob
Ashish Garg	Nice Song My Favourate Movie Baajigar And My Favourate Hero Shahrukh khan
Ashish	👌
Sandhya Jaison	Outstanding no ward in9os music
Sanjana Sanju	Woww
Priyam Ghosh	😍😍😍
Pushpendra Dwivedi	Very nice Anu Malik
Girish Jain	Nice song
Sohel Kadva	Super song
Akash Kumar	Love song
Samser khan	I love song
tanuja oram	Ever green
Anup Borle	वा क्या मस्त गाना हैं।👍👍👌💐🎂
Basavraj Balkile	BasavarajBalkeli
Kebal Dhibar	Nice song
Sachin Vadnere	very good
Nida Junejo	Kajol kali
aditya thakur	Fantastic song and evergreen
Saheb Mirza	Lovely song
Anu Sharma	very nice
K.Rameswar Dora	So Beautiful Song Such Me Hame Bhi Jatana Nahi Ata Ke Pyar Kese Karte He
Nazi Alieva	Супер песня
jaidul sk	Lovely
miMd arman	Very nice 💖🌹
furkan sTud!0	The 90 choreography of song wa so pure Awesome song and music
ANKIT MALIK	nice
Ananda Konai	Nice video I m sarada
mohammad tairaz	1995 memory ✌️✌️✌️✌️✌️yaad
Pirti Bhaladhye	Nice song
Neelam Devani	Every time I listen old Bollywood song it s reminds me my childhood I really miss those day 😥😥
I like srk n kajol so much dar	remember my childhood day when I listen this song
Priyanka Halder	B
Mohamed Mashok	Akaum Billa Hada Ganni Miya Miya Yati Kalaf Ya
shradha rakkhita	Mast
Raja Rakesh Ramesh Dalvi	My Family Affairs
Kishor Nandi	Lovely song
Faizan Khan Kapoor Royal Faizan Khan Kapoor Royal	mast pic
Flower Zahra	very good old is gold
BALASAHEB JAYBHAYE	l miss love
Manik Das	Manik🕉🇮🇳
Psquared	Legendary song the first of it kind friend zone anthem For many who watched the movie back in the day they thought they were SRK but a they grew and now they realized they were actually the inspector the friend zoned dude
JubairAj Khan	Fantastic❤️🇨🇮🎂😍
Ehtesham Alam	Love in 2018
Manirul Islam	Nice song
Kanchan Dey	2018
Rajesh Das	Anu malik you are best nice camiestri type song
Radhika Nag	Beautiful lovely song
Sabi Khan	Fantastic song
Goriabori ME	Nyc song
javed ali	anwar
Pulak Hazra	fantastic song 😌😌😌
Sonumagotra. Sonu Sonu	अजीब है 💘 महौबत का खेल 💔 किसी को हम ना मिले 💔 कोई हमे ना मिला 💔miss you anu 🌹🌹🌹🌹🌹🌹🌹🌹🌹🌹🌹🌹🌹🌹🌹🌹🌹🌹🌹🌹🌹🌹🌹🌹🌹🌹🌹🌹🌹🌹🌹🌹🌹🌹🌹🌹🌹🌹🌹🌹🌹🌹🌹🌹🌹🌹🌹🌹🌹🌹🌹🌹🌹🌹🌹🌹🌹🌹🌹🌹🌹🌹🌹🌹🌹🌹🌹🌹🌹🌹🌹🌹🌹🌹🌹🌹🌹🌹🌹🌹🌹🌹🌹🌹🌹🌹🌹🌹🌹🌹🌹🌹🌹🌹🌹🌹🌹🌹🌹🌹🌹🌹🌹🌹🌹🌹🌹🌹🌹🌹🌹🌹🌹🌹🌹🌹🌹🌹🌹🌹😂
Ifraim Qureshi	Padhne Me Nahi Aata main
Sonal Jha	Kajol jitna Sundar koi nahi hai
Abi Zu	What a beatiful kajol at that time
Amit Lohar	Lovely song
Manzoor Azad	Nice song
Mohamad Ismail	Ok
Raj Bariha	Nice song
Sharik Salmani	Really nice song
Nirmal Kumar	love u this song
Fakhra Shah	nice
kunaso channel	All commenters say Srk vinod why SIDHARTH left
N. K. Chauhan	¤¤¤¤¤¤¤¤¤¤¤¤¤¤¤¤¤¤¤¤¤¤¤¤¤¤¤¤¤¤¤¤¤¤¤¤¤¤¤¤¤¤¤¤¤¤¤¤ The quality of his voice and singing underlies the fact that he is able to sing the highest pitched song with the maximum loudness without losing the timbre quality of his singing voice because none of the new generation singer is able to do this miracle Almost all of them attain the highest pitched voice by narrowing their vocal fold opening a a result of which their voice becomes narrower or feminized nearly like a female It show that he attains loudness by mean of increasing air pressure using his strong diaphragm and in technical language we may call it loudness increased by energy or intensity of voice Mahendra Kapoor Lata Mangeshkar Manna Dey Yesu Das Asha Bhosake Hem lata are the example such a type of singer If a male singer narrow his voice at a higher pitch he turn into a different singer nearer to a female singer resembling a joker or queer and the song turn into a stupid stuff ¤¤¤¤¤¤¤¤¤¤¤¤¤¤¤¤¤¤¤¤¤¤¤¤¤¤¤¤¤¤¤¤¤¤¤¤¤¤¤¤¤¤¤¤¤¤¤¤
Appu g	nice song is my favourite
Nikhilkv Kv	all time favorate Emotional song lovely from kerala srk fan
Akshay Kumar	A1 song
Priya Wathore	Superb song👌👌
Risban.suvanallah Khan	sukriya vaijaan
Neeraj Dwivedi	Nice song
Amjad Arshad	Mr Ray died in very young age
Archana Ali khan	Nice Lajol Srk
Нурлан Изабаев	👍👍👍👍👍👍👍👍👍👍👍👍👍
Priyadarshini Sahu	Abhijeet sir is the best singer
Rahul gupta	i love first scene here anu malik asks all to come with them but instead they turn backward
Jyoti Jha	Mast hai Bhai😃😃
Ariadna Lindao	Muy linda musica sharuck kajol♡♡♡♡ love
Adv SUNIL KUMAR	Always relevant
Lloyd Dias	Anu Malik in his prime
Ranjan Nath	hi 🎙️🎼🎼👀🎸🎹💞🎷🎶🎙️💔💔💛💜💔🎸🎼🎼🎼👂👌
Mirnazir Hossen	Osm😍song
Simran Jan	I love this song👏👏👏👏👏👏👏👏👏❤️❤️❤️❤️❤️❤️💗💗💗💕💕💕
Narendra Thakur	Nica song vinod bhai
Ahmedbloushi Ahmedbloushi	😘😘😘😘😘
rehan rock	I love you sharukh kajol
Manimozhi Gopal	the main attraction of this song is siddharath ray super he will be alive in so many heart forever 👌👌👌🌹🌹🌹
Iqbal Bagasrawala	Very nice
anis rahaman	My most most fav song of Srkajol
Deshan Patel	Sushi you miss understood me
Ajay Dagur	by
Faiz Mohd Khan	Josh Movie All Song Baadshah All Song Upload Same Video Quality Like Baazigar
Amit Kumar	I love song
rajat musical	Wah vinod ji rathod apne purani yadein tazi krli
AMAR KUMAR	hii
Haya Khan	Lovely song
arjun nayak	Farddu
Bunti Katara	Srk song Evergreen song
ismail shekh	Super song sir
Shadab Akhatar	Fantastic song
Trisha Das	Remember my childhood day I ❤ this song so much
JHB. Net	Nice song
Love statuas	Waaoooi Lovley video song new
Ajitkumar Sardar	awesome song
Tapas Das	Beesr song Baajigar
prashanta kumar	Really vry vry nice song this is my fav song tnx 4 anumallik sir nd special tnxxx vinod sir jiii aur Venus company
Ajay Vaghela	7265885344
HAMED KHAN	Please upload koi mere dil se puche song
Sudama 8383807112	Nice song 😍 😍 😙 💖🌷👍
DHAVAL PITHWA	Super song
Salman Khan	Remember my childhood day Fantastic song love from Pakistan
raja rakesh	Vinod rathod 👍
Chand Ali	geret
Status Queen	Fantastic song 💖🎇🎆🤞✌️👌 SRK Fan Like 👍 here 🤞✌️👌👌
Great Things CDR	Best Song Baazigar We used to listen to this song a lot in childhood
Arijit Bhattacharjee	VERY nice SONG Dil ko chutya hai
Tumhara Pyaar	Nice video
Aman Khan	Nice
papu love sangeeta	Woo Kiya gaana he
Dhritimay Sarkar	One of my fav 😘
Raj B Meghani	Wow Vinod Sir Super Hits Song
Music School	ye gana mai bahut bajata hu abhi bhi
