Marlon 85	Classic tune
Angelika Kallenbach	Leider G E I L ❤❤❤❤
Elena Nikol	Yes yes amazing 😉
Rado Timers	🔥🔥🔥
Giulia Caos	Lenny
Seggae Lover	What an artist 👏🏼👏🏼👏🏼👏🏼😍
Jun July	Poor old boy Lenny had to to it all by himself
Beverly Davis	Cool song Lyrics are ✔
TwiztedGenius	RighteousCosmicFunk
Lloyd john Lyons	Lenny Kravitz is amazeing and produce great music and love how it ’ s produced very different compared to the new artist in the industry Lenny all about proper guitar drum and what ever else Lenny us where a the other artist are just doing it from computer music software and not proper instrument and Lenny us all of his skill to produce and write new music plus produce beat with software plus instrument or no software Where the Flying V wonder if he kept it because that ’ s guitar that he used to produce are you going to go my way which is a superb song and the beat is cool that should be kept until he decides to make new song with Flying V and mama said is super dope not sure what guitar Lenny used I think le Paul but not sure
fullimmerzion	Da alcune inquadrature ho appreso quale potrebbe essere un regalo appropriato in occasione delle prossime Festività un bel paio di scarpe col tacco
Murad murad	Vocal lenny Bas guitar lenny Elektro guitar 1 lenny Drums lenny Ritms lenny Mannnn idol
pa0135	Fenomeno
Patsy Carmon	your mom would be so happy and proud of your excellence in your music career you ve done well💯⭐🌟😎💃🏌👌👍✌👊💋💕💖💗💚💛💜💫💝💞 this is a beautiful song and I can not get of it it s awesome and I love it video is HOT
Натали Мальцева	❤ люблю
Alex	What is the model of car he s driving
Jacqueline Wolfslag	LOVE IT Love his music 😍😍😍
Kevin Eduardo	Alucinante
John Edward Rosero Villegas	Tiene mucho de draco
Евгений Воробьев	Lenny I m from Russ you good my brother
earthbeat	fantastic song and video well done
jeremy	Who is the 25 fucking shit dislike 😡
Karin Martens	Nice ❤️
joshua black	Very Prince esq of him to do the video like that to remind u all he can do everything
Cover Guitar Tab	Yeah Big Lenny awesome musician and great tune
El Oficial Santos	💜🎼🙏🏻
gaspalermo	I WAS ABOUT TO SAY THAT UHHH SOUNDED LIKE MICHAEL JACKSON UNTIL I SAW THAT PICTURE 2 46 THANK FOR THE RECOGNIZEMENT LENNY
Jerry	More Lennys le Lil Pumps and all that trash
Wilhelmien Brons	😍💖😍💖👍🏼👍🏼👍🏼👍🏼👍🏼👍🏼
Peggy Honeycutt	Lord have mercy What a MAN💕💕💕
Paige Smith	L💙VE🎙🎹🥁🎸🎷🤘🏽
KarenSesteaga	I LOVE YOUUUUUU FOREVER❤️
Lisa Solina	SEXY AS HELL😚GREAT TUNES💗
muriel mottet	Thank you Lenny Kravitz 😊 🖖 👍
Manuel Argote	If you wan na talk to me Know that I am planning to see Yeah yeah hey hey I don t want this thing to be Staining my reality yeah yeah Don t lift me up To turn me down I just want a lover Baby stay with me on the floor Talk with me let me go Got to keep below Talk with me let me go Got to keep below Don t lift me up To turn me down I just want a lover Baby stay with me on the floor Talk with me let me go Got to keep below Talk with me let me go Got to keep below If you bought the fantasy It s murder in the first degree yeah Yeah Is my sexuality Creating such a tragedy yeah Yeah Don t lift me up To turn me down I just want a lover Baby stay with me on the floor Talk with me let me go Got to keep below Talk with me let me go Got to keep below Don t lift me up To turn me down I just want a lover Baby stay with me on the floor Talk with me let me go Got to keep below Talk with me let me go Got to keep below ooh I m so tired of playing this crazy game Someone s always left out in the rain Is there a chance that we can make it uh Just keep it real cause we can t fake it yeah Cause you and I can t take this anymore We ve got to keep our foot right on the floor There s no more secret no more lying Baby I m really really trying To get to love Don t lift me up To turn me down I just want a lover Baby stay with me on the floor Talk with me let me go Got to keep below Talk with me let me go Got to keep below Don t lift me up To turn me down Baby stay with me on the floor Talk with me let me go Got to keep below Talk with me let me go Got to keep below ooh Don t lift me up To turn me down Baby stay with me on the floor Talk with me let me go Got to keep below Talk with me let me go Got to keep below ooh Lenny Albert Kravitz
Doggo Drum	He also made coffee during recordins while playng maraca
Nakidim75	I didn ’ t loose my time this time Great song
TROY	Inspiring Love
Katharina Gossmann	My hip love your rhythm 💜 Thank you for that Track lenny
Katja Jentsch	Awesome to see Lenny working in the studio playing all the instrument There should be a studio version of all of his song 😍
TEA 4CHRIST	🔥🤦🏽‍♀️
John Mc REASON	Excellent work Lenny I suggest you contact me I have a lot of good idea of musical creation see you soon 🤗🎶
Traci Waller	All I can say Lenny is that you truly are a Master musician I will always enjoy this song and now this amazing video that captured so fantastically your creation I will admit that my favorite part of the song is the guitar riff You have always been able to add cool element that make your music unique which is really your imprint Most importantly is how your band is able to recreate your sound in concert
Arek Płocicki	just low this
Gabriel_88033	Bravo Lenny
Linda Johnson	I love but
The Lifestyle	Man amazing blessing to u again you never stop surprising and inspiring Long live L K
Jas Bataille	Long time I didn t heard a chorus that solid Just wished the verse wa at this same high level it s a bit below Great song overall
Frenchette Sherman	Wow The Bahamas is truly an amazing paradise I loved seeing you exemplify why you are an iCon Lenny with incredible gift You are going to inspire musician and music lover for Centuries I attended your concert in Sf Ca Keep me Coming 👑💠💟💠💋👆🎸🏆
Jorge Arreaga	cuando la música nace de ti haces de todo para componer y brindar una linda melodia
Foofoo	No word for this soul Love love love ❤️✊🏼
RoxyB 1973	I luv Lenny Kravitz 😘😘this is another jam keep em coming Lenny I ’ ve always listened to your music 🎶 so talented 😊
Horus	Thanks Lenny for all your music ❤️💪🏻
Annde dillez	Juste magnifique ❤️❤️🌹
Maya Rose	So CD ist bestellt D freue mich
Рустам Исмаилов	Still Best
Bill Kiely	nice
Lucilene Zorzim	Maravilhoso como sempre muito boa essa música Amo demais😍😘
Marcia Lamb	Are you kidding 13 dislike what is wrong with you people
Red Planet	This beat ready for repeat
Jeff Indigo	Brilliant
Ricardo Flores.	Awesome Low
Mery Fragoso	I LOVE LENNY KRAVITZ😍😘
Gem. In.I	💜
James Murff	I dig it man Live seeing the behind the recording vidz
Claudia Valero	Cosa hermosa miamor Beautiful creature
Alcée	Was this video filmed in Paisley Park It kind of looked like one of Prince ’ s studio I also saw Linn LM 1 Drum machine
chris guitar style	very nice song
Tiago De Brito	I miss the girl with a beuatifull hair
Dream Catcher	A one man band 😎😍
Agnieszka Spanicciati	♥️
Dalieboo F	Oh damn 😍 I already loved the song and I ve been a fan of LK for over 20 year but his mastery of those instrument on display and then those close up shot of his lips😶 I m so gone right now 😏 uh uh uh
Dani Ela	It s a great musical composition I love this song and l love him 😍🤤
johnny bgoode	He s holding a joint right
Brando Mallqui	2018 🎶
Wendy Kahn	Just when You think Lenny Has delivered his Best He Shows up MORE Powerfully ✪❣️🌏Ui❦ R🌈With YOU❣️✪25❢🎱❢366‼️₮ℏ🅰️ȠƘ ¥ǾƲ Ƒ◉Ɍ 🎼ℏ🅰️℞ℹ︎₪Ǥ👄
Stas Shustov	Those who put thumb down are stupid freak
Kai Owen	Genius at work Thanks for sharing sexy Lenny love it ♥️🌹🎶🎸
CELINA BRITOS	TEMONNNNNNNNNNNN
Francesca Crea	I love you so bad
Astronaut2005	Excellent video
Lulu Raven	Love it Raw and real 😎🎵🎶
stonelova	THE BEST MAN
Lila Brigit	Yes yes yes ❤️
Pedro sena	The hottest man alive
el osoruso07	Amazing music Lenny Kravitz rule
Abyavin	Que exquisita y chingonsísima rola maestro Kravitz QUE VIVA LA MÚSICA DE ORGASMO Y QUE VIVA MÉXICO Jajaja
Angela McCoy	Thank you again Lenny Kravitz I absolutely loved it Let love rule May G D Bless you
lieb	Amazing love u lenny
Il Faro - Cantautore	Video fantastico 👍
Linda Costa	Superbe Chanson et musique Lenny J adore comme d habitude Et merci pour cette petite touche de Michael Jackson cette petite touche de magie comme tu le dis dans te interview
Andres Manosalvas	every single instrument is played by him such a great and magnificent musician it is lenny my favorite singer now
Danni Michael	One of the best LK s track ever Congrats and thank you
Paul Trinh	Great video that showcase all his talent Well done keep on Rock ’ n
Lena Möttus	♡Oh♡Thank♡You♡♡For♡You♡Is♡♡♡So♡Very♡Kind♡♡And♡So♡Very♡♡Sweet♡To♡Be♡♡Recommend♡♡♡♡Me♡All♡This♡♡♡For♡Me♡Oh♡♡♡Yes♡♡♡♡♡♡ My♡Honey♡Bee♡ ♡To♡Seeing♡You♡♡In♡You♡In♡♡♡♡Your♡Working♡♡♡Progress♡On♡♡♡Your♡Music♡♡♡♡And♡To♡Also♡♡♡Your♡Song♡♡♡♡And♡To♡See♡♡♡And♡Listning♡♡♡On♡Your♡So♡♡♡Truly♡Very♡♡♡♡Good♡Song♡To♡♡And♡To♡Be♡♡♡Seeing♡All♡Of♡♡Those♡Different♡♡Instruments♡♡♡♡You♡Are♡♡♡♡♡Playing♡On♡And♡To♡Hearing♡♡♡♡How♡Your♡♡♡♡Music♡And♡♡♡♡Lyrics♡Is♡♡♡♡♡Groveing♡Out♡♡♡From♡Your♡♡♡♡Creativity♡Is♡♡♡Truly♡Flowing♡♡♡Out♡From♡You♡♡Oh♡It s♡So♡♡♡♡Very♡Beautiful♡♡To♡Seeing♡And♡Listening♡To♡♡♡All♡This♡I♡♡♡♡Truly♡Love♡All♡♡This♡And♡As♡♡♡You♡Know♡To♡♡That♡I m♡Also♡♡Are♡True♡♡♡♡♡Creative♡Woman♡And♡Lady♡To♡♡Like♡You♡Know♡To♡Right♡ ♡Thank♡You♡♡♡ ♡My♡Brother♡♡♡ My♡Honey♡Bee♡♡My♡Sunshine♡♡♡My♡Cutie♡Pie♡♡You♡Is♡The♡♡♡Cutest♡And♡♡♡♡The♡Sweetest♡♡ ♡Man ♡And♡A♡♡♡True♡Gentleman♡♡Oh♡Yes♡To♡♡♡Me♡You♡Truly♡♡Are♡This♡And♡♡So♡Very♡Much♡♡More♡Than♡So♡♡For♡Me♡Oh♡♡♡Yes♡ ♡My♡Cutie♡Pie♡My♡Honey♡Bee♡♡My♡True♡Love♡♡Thanks♡To♡♡♡♡Our♡Heavenly♡♡♡Father♡In♡♡♡♡♡Jesus♡Name♡♡♡God♡Don t♡♡♡♡Wasting♡Any♡♡♡Time♡Ever♡ ♡And♡God♡Is♡♡♡Always♡Have♡♡♡A♡Very♡Strong♡♡Reason♡For♡♡♡♡Way♡God♡Is♡♡♡Sending♡True♡♡♡Dreams♡Oh♡♡♡♡Yes♡Always♡♡♡♡And♡Because♡♡♡You♡Is♡The♡♡♡One♡God♡♡♡♡♡Haveing♡Send♡♡To♡Me♡So♡♡♡♡Very♡Times♡Oh♡Yes♡Amen ♡I♡Needs♡And♡♡I♡♡Most♡Let♡♡You♡Know♡♡♡♡About♡This♡ ♡And♡I♡Have♡♡♡Let♡You♡Know♡♡That♡Sometimes♡It♡Can♡Take♡♡♡Little♡Time♡To♡♡Right♡ ♡And♡We♡Not♡♡♡Gets♡Younger♡♡♡Amen ♡And♡I♡Think♡♡♡You♡Know♡♡♡♡This♡To♡Right ♡ ♡And♡I♡Hope♡♡♡That♡We♡Don t♡♡Will♡Miss♡All♡♡♡Of♡Those♡♡♡♡♡Blessings♡We♡♡♡Bout♡Have♡♡♡♡Got♡Until♡Now♡♡All♡This♡Is♡♡♡♡Also♡So♡Very♡♡Truly♡Special♡♡♡To♡Right♡OK ♡ ♡I♡Hope♡This♡♡♡Won t♡Take♡To♡♡Long♡Now ♡So♡♡Please♡Let♡Us♡♡Start♡Soon♡So♡♡Let s♡Love♡♡♡♡Truly♡Rules♡♡♡♡On♡Oh♡Yes♡♡ My♡Honey♡Bee♡ ♡My♡Sunshine♡♡♡My♡Cutie♡Pie♡♡So♡Let♡Us♡♡♡♡To♡Always♡Be♡♡Looking♡On♡♡♡♡The♡Inside♡♡♡♡There♡Is♡The♡ ♡True♡Beauty♡♡♡And♡It♡Always♡♡Comes♡From♡♡♡Inside♡Of♡Us♡♡ ♡And♡Shines♡♡♡♡All♡The♡Way♡♡♡Out♡Right♡ ♡You♡Know♡All♡♡This♡To♡ ♡My♡Sunshine♡♡♡My♡Cutie♡Pie♡♡My♡Sweetest♡♡♡Sweetheart♡ ♡One♡Picture♡♡♡Can♡Show♡A♡♡Lot♡And♡Black♡♡And♡White♡Is♡♡Gives♡Mush♡♡♡Deep♡And♡♡♡♡Mystery♡Etc♡I♡♡Love♡Black♡And♡White♡Pictures ♡♡One♡Picture♡♡♡On♡Someone♡♡♡Is♡Not♡Always♡♡Saying♡All♡It s♡♡Just♡Show♡♡♡♡Little♡Of♡Us♡ ♡And♡Our♡Easy♡♡Is♡The♡Mirror♡♡Of♡Our♡Soul♡ ♡So♡Please♡We♡♡All♡Need♡To♡♡♡Work♡On♡Our♡♡Inside♡Every♡♡♡One♡Of♡Us♡ ♡No♡Matter♡If♡♡♡You♡Got♡ The♡♡Look ♡Or♡Not ♡♡We♡Need♡To♡♡♡Doing♡This♡All♡♡Of♡Us♡ ♡So♡I♡♡Only♡Want♡To♡♡Give♡Little♡♡♡♡Good♡Help ♡To♡♡All♡Young♡♡♡♡Womens♡And♡♡♡All♡Men s♡♡♡♡♡And♡To♡All♡♡♡Ages♡Womens♡♡And♡Men s♡To♡♡In♡A♡Time♡♡♡♡When♡It s♡A♡♡♡Crayz♡Pressure♡♡On♡This♡Area ♡♡So♡Keep♡On♡♡♡This♡Good♡♡♡♡Work♡Every♡♡♡♡One♡ ♡And♡To♡Keep♡♡Smile♡And♡To♡♡Them♡You♡Are♡♡Meeting♡And♡♡♡They♡Mostly♡♡♡Will♡Be♡Smile♡♡Back♡To♡You♡♡ D ♡ ♡Some♡Of♡Us♡♡Have♡Been♡ ♡Spokane♡To♡♡♡Someone♡Who♡♡Have♡ ♡The ♡♡ ♡Look♡ And♡♡♡♡The ♡One♡ ♡Only♡Live♡On♡ ♡The♡Look♡ ♡And♡It s♡Just♡♡So♡Sad♡To♡Be♡Spokane♡For♡A♡While♡ And♡To♡♡See♡How♡All♡♡♡The♡Beauty♡Is♡♡Just♡Kracks♡Into♡To♡So♡Very♡♡♡Many♡Peaces♡ ♡All♡Beauty♡Is♡♡Gone♡And♡It s♡Never Feels Good At All ♡So♡Please♡I♡♡♡Only♡Try♡To♡♡♡Help♡Little♡ ♡Especially♡In♡♡♡This♡Time♡♡♡♡When♡It s♡So♡♡Crayz♡Times♡♡♡There♡Is♡To♡♡♡Many♡Young♡♡♡Peoples♡And♡♡♡They♡Don t♡♡♡♡Have♡Any♡One♡♡Grove♡Up♡To♡♡Give♡Them♡Of♡♡There♡Time ♡♡♡Or♡Give♡Them♡♡Good♡Advise♡♡♡To♡Them♡And♡♡It s♡Also♡The♡♡Most♡Hard♡♡♡♡Time♡To♡Be♡♡♡Teenagers♡And♡♡There♡Is♡So♡♡♡Very♡Much♡As♡♡Going♡On♡♡♡♡♡Around♡And♡♡♡Inside♡The♡♡♡♡Body♡To♡At♡♡♡Same♡Time♡ ♡Then♡When♡♡♡♡Those♡Years♡♡♡Is♡Over♡It♡♡♡♡Feels♡So♡Much♡Better♡ ♡Please♡One♡♡♡♡Thing♡Always♡♡♡Keep♡In♡Your♡♡Mind s♡ That♡♡♡Don t♡Never♡♡♡Forgot♡How♡♡♡It s♡To♡Be♡A♡♡Child♡And♡♡♡♡How♡It s♡To♡♡♡Be♡Teenager♡♡♡It♡Always♡Very♡♡Important♡To♡♡♡Remember♡ ♡♡♡And♡To♡Give♡♡♡Them♡Of♡Your♡♡Time♡And♡Good♡To♡Get♡♡Little♡♡Help♡On♡The♡♡Way♡To♡ ♡And♡Every♡♡♡♡Child♡Is♡A♡So♡♡Beautiful♡Gift♡♡♡From♡God♡♡♡♡Amen ♡And♡It♡Also♡♡♡To♡Very♡Many♡♡As♡Are♡Feeling♡♡Lonely♡On♡♡♡♡Mother♡Earth♡♡♡And♡This♡Is♡♡♡No♡Good♡ ♡So♡Please♡We♡♡All♡Can♡Come♡♡Together♡To♡♡♡Also♡Start♡To♡♡Be♡Making♡A♡♡Good♡Cheng♡♡♡So♡Please♡All♡♡Sisters♡And♡♡♡♡Brothers♡Let♡♡♡Us♡All♡Help♡♡♡To♡Be♡Finding♡♡Out♡Many♡♡♡♡Very♡Good♡♡♡♡Things♡For♡All♡♡Of♡Those♡So♡♡Yes♡Please♡♡♡♡Together♡We♡♡♡All♡Gets♡So♡♡♡Very♡Mush♡♡♡♡More♡Stronger♡♡Happyer♡Feels♡♡Better♡It s♡A♡♡♡True♡Win♡Win♡♡Situation♡Oh♡♡♡Yes♡All♡So♡♡♡Very♡Many♡♡♡♡Truly♡Good♡♡♡♡And♡Positive♡♡♡Will♡Come♡Out♡♡From♡This♡Oh♡♡Yes♡So♡Let♡♡♡Us♡Startup♡♡♡♡This♡Together♡ ♡Low♡It♡Can♡♡♡Be♡Like♡In♡♡♡♡Those♡Ways♡♡♡And♡Mush♡♡♡♡More♡To♡ ♡Yes♡I♡Think♡♡♡You♡Know♡♡♡♡This♡To♡Right ♡♡My♡Sunshine♡♡♡My♡Sweets♡ ♡Sweetheart♡♡♡♡My♡Missing♡♡♡Puzzle♡Bite♡In♡ ♡My♡Life♡You♡♡♡Is♡The♡Right♡♡♡One♡ ♡All♡Glory♡Price♡♡Thanks♡To♡♡♡♡God♡In♡Jesus♡♡Name♡Amen♡♡♡God♡Bless♡♡♡♡You♡ ♡Im♡Yours♡♡♡♡♡Sincerely♡Only♡♡Yours♡Faithfully♡♡Your♡Baby Honey XOXOXO
Tainá Ferraz	2 47 i knew this scream
magicriver77	Best song the year 😍
vegasbob	Great tune song
Jovan Jovanovski	Woow😮😮
Emiliano Haldeman	Love it
Jorge Atokesi	Great
TheSemtexCow	Love it sound a good in the studio a live
Edwin Torres	Genio
FLORICELA AVILA	wonderful lenny Kravitz i love you
Giovanna Diomeda	Bellissimaa ✨👌💖👑💘🧚Grazie Fantastic studio woow🎛️🎹🔊🎙️😍 this is the most beautiful 👍
Dina Papavlachou	You are an amazing singer songwriter composer with a very distinctive voice and so incredibly hot hot
Projekt CUDO	Making of D Thy this Kidos D
MichaelPanterAJackson 2017	I love you Lenny
쭉쭉빵빵	Lenny Kravitz👍🏼😍😍💖💖💖 ho😗🎶
Marika e il mio piu grande sogno andarci Nocera	Wonderful
Gveir	That Michael Jackson tribute at the end is sweet
Paul DeRosa	THAT is amazing Lenny love it
gerard yatcilla	Love it
Eddie Garzón	That ’ s what I call a REAL MUSICIAN
Алиса Оганесян	Ну как же круто а Ну просто
Artur Arsenal	Great video great song Lenny is a legend
Ericka y su Marilyna	Te amo Lenny no dejes de sonar nunca Gracias x todos estos regalos musicales Linda vida
Silvia de Elera	The best of the musician
Farid Ismail	We want more video of Low
Tezone Mihai	Listening on repeat Awesome track
CJM Inc	The best Love love love
Light Star	is Ska
Qwerty Qwerty	Thank u very much for song We feel realy hard work of it Cosmic
Albert Alibekov	The best of the best
VR 81	🖤🖤🖤🖤🖤🖤🖤
Monty Baluni	This is the best song
iolloi123	Круто
Awen 62	Wow I d love to be in this Studio 😍💜🙌
Tracy Greenhough	Talk with me let me know if I can kiss your Cupid s Bow Fab song 🌸💖⚘
siarkaa85	Great 😍 This voice 😍🍷
KIYA EMPRESS	Can this not get any better🔥🔥🔥🔥🔥🔥🔥💖💖💖💖💖🔥🔥🔥🔥
Aga Galan	I love this song 😍
Anne-Kathrin Lippold	i love you
Tammy Toney	Perfection
txcowgirl 1905	Love me some Lenny always
Joni Lozano	Geniooooo
snaipuly	Чувак ты крут надеюсь порадуешь нас ещё чем то новым в скором времени 😎💣👌🎙🎼🔊❤
Dara Santana Alemán	Lenny 😘
IndianHoney	
Therezinha Esashika	Lenny I miss you💖
Pernille G.	Still so sexy amazing song wow 3 3 3 3
ᵏ𝔒ᵏ𝔒	Another divine song using the sound and lyric in your passionately language scanned « low » by your voice that s gorgeously involved in this musical arrangement for making the tongue and body do wild uncoordinated movement H😜T
ashanty records	Te amamos Lenny we love you for ever i promise 🖖🏿👽
Dani Gere	Music polyhistor
sarah felice	Sempre mio marito Grandissimo
Matthew Paluch	2smooth
Vochero	Muy buena canción Esa fusión con Michael Jackson e genial “ Billie jean ”
Melissa Hedges	Roller Rink Jam yay babey 💖🌈🌞😙😍
DIY Glamour	Yes Yes Yes
Justin Raap	So awesome that Michael Jackson is on this track
Cee Win	Incredible babe
Amy R	I listen to this over and over Never get old
Yadira Norzagaray	Chulo 😍😍😍😍Eres mi novio aunque no lo sepas jeje 😘😘😘🌵🌼🌵🌻🌵🌷🌵🌿🌵🍂🌵💐🌵🌹🌵🌸🌵🌾🌵🍀🌵🌺🌵
José Augusto dos Santos	BOM MUITO BOM
