miraç ünlü	Kabuuuusss abiii
Güzel Günler	İyi de sorun zaten orada kitap okurken normal bi video izlerken hatta senin videolarını izlerken bile bu istek geliyor Kaç kere senin videonu izledikten sonra oraya yönlendim Bunu bi eleştiri olarak alabilirsin
Omer Ceylan	My lady ha been dried
Kaf Kas	bi elmalı biskrem değil
1-800-000 -LOVE U	educated ear sahibinin sesi değil aslında eğitimli kulak değil mi
alaimisema	Çok önemli bi konuya parmak basmışsın kardeşim video nun başında tebrikler
mehmet han	harika ya D
scarp trap	En iyi türk youtube kanalı
Rosenberg	2 girl 1 cup mıydı o Öğğğğ
Fell	yazık lan
Onat Arslan	0 39 Remixadam Elon Musk
BORA GLRR	Volkan Öge gelsin
Şebnem Ecem Koçak	Babakok neredesin
Sibirya Kurdu	KIÇINI KALDIR DA VİDEO AT YOREKOK
Lumi	Konuğun mikrofonu neden bu kadar kötü
Litofer	Babakok lütfen şu selçuk hoş denen andavalla ilgili video çek
Bukalemur	ne demek tek lavaş çift lavaş
xDxBxPx xDxBxPx	criticism education
SpieDigitalTV	Abi ben de senin gibi videolar çekiyorum bi bakar mısın
Profesyonel Boksör	yorekok seni evden cikmayan sivilceli şişko asosyal uzun sacli bi pislik saniyodum
cerpment •	Baba kok şu kanalı eleştirsene http m youtube com channel UCuMDZEjfFMVqW8bcuqonzSg Bu kanalı izleyenler 9 yaş altı minecraft bağımlısı veletler Ve bu adam trendlerden düsmüyor Ve sana söylüyorum 5 saniye içinde cringe duygun 78 kat büyüme gösterip gözünden kan yerine kusmuk gelecek Ve konular hep aynı yani değişen tek şey karakterler ve yerler 1 meraba arkadaşlar ben metin tuvaletim geldi tuvalete gidiyom sıcma efekti aa telefonum çalıyo Lan ben niye tuvalete telefonla giriyom neyse alo alo metin ben porno izlerken amuda kalkıp aynı zamanda popeyes tavukları yiyebilen granny Sevgilini kaçırdım eğer onu almak istiyorsan ebemin oğlunun cenazesinin kaldırıldığı mezarlığa gel seni bekliyirum hihihi lan sevgilim lan orgazm olma sesleri hih hığ granny seni varya 2 meraba arkdaşlar ben metin videoyu likelamayı unutmayın Arabayla gezek biraz aa telefon çalıyo alo alo metin ben 78 derece kafasını döndürürken su içebilen baldi Oğlunu kaçirdim brazzers şirket binasına gel ve oğlunu kurtar lan olm bi granny bi baldi ni salın la with the flash tv oyunculuğu baldi sen bekle Not bu arkadaş nefes almadan konuşma yeteneğine sahip Ve eğer videoların cringelik puanını söylemem gerekirse salih reyiz nah çekerken ablasınin onu durdurmak için yaptıgı yuz ifadesinden daha cringe 1 leyin görsün
Nightmare 16	Iyi oyunu elestir
mhmt tp	yorekok soğuk savaşa katıl
Yusuf Çay	Arkadaşlar yorekom bir trafuk kazası sonucu hayatını kaybetmiş sanirim yoksa bizi asla videosuz bırakmazdı BABAKOK VIDEO AT LAAAAAN
Özcan Gökmen	youtubesenindir mösyö pikselans
Andaç Eker	Sarhoş kafayla izledim kafam iki katına çıktı
kutay kanat	Hadi koca g tlu bir video at artık
KapTan K2	http www youtube com watch v 7dqYMrZmdJ4 şuna bi bak şişko ruhlu cenabet herif
Yüce Güngören	Şu erkan tana bir el atın 1
mustafa aydemir basketbol	BABAKOK mutlu BABAKOK mutluluktan çıldıracak
ahmet emir	Yorekok abi bu olaya da bakarsan iyi olur http www youtube com watch v 88UJl qu2Fg
Asim Huseyin Yuvak	Abi birsonraki videonda T series ile pewdiepie arasindaki abone yarisinin youtubede surekli farkli kanallarla cikmasini konu alirmisin
oktay dayı	FURKAN TURAN
Cübbeli Pikaçu	VİDEO AT PİÇ
Hannibal Lecter	Bizim ablalar da orda bizim ablalar bizim ABLLAAALARRRR Biz dağları delerekk şirine ulaşıyoruz bir ferhadız biz ferhadız biz FERHADIZ şirin de millet Educated ear
Jendeuk Corn	Lütfen bak lütfen diyorum Anlatacağım şu gereksizi bir elden geçir Gram haz etmediğim o başlık ile alakasız ne varsa toplayan 2 dakikalık videoyu 10 dakikaya çıkaran ve videoyu çekerken gözlerinden dolar işareti fırlayan Ben Kpop kanalıyım diyerek sadece BTS EXO ve Twice videoları çeken Selçuk Hoş Bence boş denen gram hoş olmayan insanı bir gör Saygılar teşekkürler
nilhan bacaksız	nasıl bir kralsın ya 3
Japon Askeri	2 yıl önceki sesin daha iyiydi abi
Forgotten Reaper	Outroo şarkısı plz
Harun SEZGİN	Müthiş içerik
Arda Onur Taner	babakokfirarda
kerem korad	LAAAN TWO GIRLS ONE CUP izletiriyo amq bende müziğini ezberlemişim
Hüseyin Açar	Kelimeler yetersiz Muhteşem bir mizah anlayışın var Kusursuz denecek kadar
Life Rules	Efso
mümin coskun	onlar nasıl fontlar ve font renkleridir ya fontlardan dolayı odaklanamadım size
Berkay Koseoglu	Nargile tayfayı karşına aldın
Ramazan yılmaz	Bu video kesinlikle daha fazla izlenmeliydi
Can Bozok	SABİTLENDİN
RedquireY - Aras	ULAN TİKTOK U ELEŞTİRİYON TİKTOK REKLAMI YAPIYON MORUQ
Arda Atik	Bence porno izlemeyin demek yerine insansı pornolar izleyin ve dozunda 31 çekin demek daha doğru olur Erika Lust ı öneririm bu konuda Porno yönetmeni kendisi ve xconfessions adında bir serisi var Her bir filmi kısa porno filmlerden oluşuyor Duvara vurmalı kafasını sürtmeli pornolar izleyeceğinize sevişme videoları izleyin sorunsuz bir deneyim olur bence
Murat Er	5 38 şarkıdan anladım küçükken izlediğim lanet iğrenç bir video
Oğuz Can Çelik	vidyoyu 2 dakıkada kapatıp ted konusması açtım
oyun gemisi	gallesyorekok
Ga Vat	montajı keşke educatedear yapsaydı
Yakup Kuru	Babakok bize BTS tostu yap
BOSS NANO	5 27 link atmayan iyi insan degildir
Tom riddle	daha çok rteklam ekle tıklıyom hepsine
Last Gaming	Uzun adam değilmi yaaa
Yok Satan Nihilist Bakkal	bende sabah akşam TED konuşması dinliyorum sonrasında bana kattıklarının desteğiyle mütemadiyen 31 çekiyorum
Tayyar Adaleti	yorekok akbilsesi alınca mutluluk hahaha hani su korku filminde adamı oldurmeden onceki karekterin gulusu ha ha ha birgün videomu gelir babakok yapma her gun video istiyom
alphan kılıçaslan	8 52 annadım abi
Adventure Player	31çekip geldim
geyiks	üyekok sinirli çocuk eğliyorsunuz valla
Meriç Deliktaş	Oğuzhan Uğur u görmek isteriz
Kamer Said MOR	İNCİRLİ BİSKREM Mİ VARMIŞ
IŞIKLI TOSUN BABA	Kıçını kaldırıp viedo at 6 gün oldu mk
Sinan Yuksel	Kim ne derse desin educatedear in üstüne video remix yapabilen adam yoktur Kendisi her ne kadar remix adama karşı mütevazı olsa da bu durum değişmez Keşke bırakmayıp devam etseydin be real ❤
Yasin Aktaş	video at artık sikik
Emre Çetin	My Lady ha been dried
Zilzop	cinselliğin mantık geriliği yaptığını düşünüyorum 31 çekince duygu seviyem azaldığını ve mantık bakış açımın yükseldiği sanmm 31 çekme sayımı artırıyor bir bensel gerçeklik yaratıp ona inaniyorum
Çağlar Keser	Between two fern imsi bir içerik olmuş biraz ama olmamis
Zehra Gencay	Soguk savasa katil
Blizzard	Deep Turkish Web olsun lütfenn
Hostile Cucumber	it s the eric andre shooooooooow
Game Power	senin abonen neden artmıyor homofobik
piksel olan	deep turkish web al
nekibu	sağdaki pornocu
_ fiveacii _	knk sen o profil fotonu değiştir xd
aegalaxys3	Ulan gerçekten öldü mü yoksa diye düşündüm Michael Caine için En sevdiğim oyunculardandır ödümü kopardın boş yere
Berkan Y.	THE ERIC ANDRE SHOW
Enola Gay	Yorekok cok bozdu
Black Mesa East Sığınağı	yorekokun dediğinin aynısını yazdım Snake are you alright talk to me SNAAAKEEEEE
aladdin altuğ	3 41 neden bu kadar komik lan
Hayvan Herif	Sesinin tonuna hayranim Yörekök Cok derinlerden geliyor
musluk suyu	Lutfen canlı yayın açarmısın gerçekten çok keyifli oluyor
Arda Ergün	beynimi büken bi program oldu emeğine sağlık iyi ki varsın hocam \m
Turab Biçer	aga educadetear ı bırakıp base 42 ye devam ediyon da remixlerini özledik real
jo	Süper video 👍🏻
Samed Can Palaz	Allah için daha fazla video at
Ziya Dedebaş	Acayip kötü bir Eric Andre parodisisin yorekok
Fatih Gündoğdu	Her 10snde bir kahkaha attım muazzam video olmuş ya BATESMOTELPRO ve DEEP TURKISH WEB de gelmeli
Sayko 360	doruk abi yorekok abi
Mizah-ı Twitch	Kardeşim Bu aralar çok Kalemdermeşerepsin
Sevket Çınar	Eric Andre show lan bu D
Underswap Papyrus	6 06 Johny Johny yes papa yedin mi götüne yarrağı yes papa
Oguzhan Alpakut	Eric andre kok
Ercan Duman	Wtcn ferit sirt sirta izle
Hakan K	Adamı diri diri toprağa mı soktun gönlünde mi öldü yoksa Long live the Michael Caine
Türkler Komünisttir K*rtler ise Emperyalist	8 18 amq çinlisi
umur dalyan	2 girl 1 cup kesindir
Hüseyin Tokel	5 10
Atakan Kapar	Günde en az 2 posta
Ömer İntepe	Bence oldukça elit bir sohbet olmuş
H Tınkılıç	Hayat yorekok izlerken karşına tiktok reklamı çıkması gibi
Ubaid	Aw hell no
Mehmet Gülabi	TİKTOKU ELESTİRMENE RAGMEN NEDEN KANALİNDA Tiktok reklamları var Babakokkkk
Çelik Görgün	abi yaklaşık 2 yıldır senin kanalını biliyorum ama şu ana kadar sevdiğim tek içeriğin bu oldu house of babakok devam etsin inş
Elite Bey	Video at abi
Efe Hacıoğlu	açtığın video umarım 2 girl one cup değildir
Yiğit Aykurt	Abi fındık ailesinin videosunu yapar mısın çok CRİNGEEE
arda osoydan	Mustafa Kemal Atatürk gençlik size emanet Atatürk bu sözü gidip sosyal medyada dans edin diye değil afrinde vb ülkeyi koruyun diye demiştir ALLAH c c zina en büyük günahtır der ama heryer zina yapılıyor yapmayın umraım bir kaç kişiyi akıllandırmışım
Utku Erke	MY LADY HAS BEEN DRY
Murat Derse	Tic toc videoları görmüyorlar lakin videolarını izlerken tic toc reklamları çıkıyor 😂 hayat
Ata Tanyeloğlu	Biraz eric andre sanki
hiç kimse	Layq 👍
UZAKURT	Senin orada ne işin vaağr geri dön d
Talha Boz	patur putur u da bekleriz
Uvuvwevwevwe Onyetenyevwe Ugwemuhwem Osas	Doruk abi kardeşim izlerken gördüm youtube tonguç akademi 8 sınıf tüm dersler konu anlatım canlı yayınında 2005 li çok cringe bir chat var bir el atsan iyi olur abi
Dulken	KASINTI
exoriente lux	bi video izlemiştim bu porno bağımlılığı ile alakalı siz porno izlerken beyin dopamin salgılıyor ve sizin o videodan zevk almanız azaldıkça yeni sekmeler açarak dopamini arttırmak istiyorsunuz bu porno izleyerek olur türk dizileri firikikleri izleyerek olur yada sahilde bikinili kızılara bakmakla olur aslında bunların her biri sizin porno anlayışınıza göre şekilleniyor şimdi her neyse asıl meseleye geleyim şu çıplak birşekilde yemek yiyen adamı görünce birden aklımda canlandı aslında buda bir çeşit porno şu adama bir bakın ya sarın sarın baştan izleyin herif resmen boşalıyor mk yada sosyal medya bağımlılığı beni herkes görsün bağımlılığı beni herkes merak etsin bağımlılığı aslında bunlar bir çeşit porno hepsi sadece senin beynin yapay yollarla dopamin salgılasın diye
Mücahid Durgut	s baya kötü abi ona bi bak istersen
pinaxmei G.C.	adama neden o videoyu izlettin ki ya 💩
Zeynep Sarikaya	Knk bayadir vidio yapmiyodun
Aytug Avci	Neden buradasın boğaç Neden educatedear
Mirhan	michael caine i niye öldürmüş lan bu
Eren Sorucu	uyumadığım bir günün sabahında denk geldim bu videoya kahkalar attım ve uykum açıldı devamı gelsin yorumları okumuyorsun zaten neden yazdım bilmiyorum
Godric Gryffindor	bobiler örg dimi bu
Ahmet Deniz	Eric Andre Show a burdan selamlar
Game'N Bro	yorekok ile konuşmaya gelen insanlar neden hep silah zoru ile getirilmiş gibiler
Arda BAYYURDOĞLU	Eric andre show geçişlerinden kurtulmazsan ay adam geçmişten gelip ağzına 73 derece sıcaklıkta extra shot sour cream dirty mocha dökecekmiş Ha bir de bu mesajı 25 kişiye daha göndermen lazım artık
Franklin Clinton	Murder house
Ahmet Sefa Bulut	Bu piano sesini nerde olsam tanırım
Recep AYER	Ahh bomba olup patlayasım geldi
Alp Er	3 49 tam olarak ben
istisnasız-oyuncu	keşke şu yorum tutsada
Bahadır Doğan	Yemedik Caine
Salih Sürücü	Video başlamadan önce tiktok videosu izledim 😭
Turker	müthiş konsept hahahahaha helal olsun ya 31 ve albert camus çok iyiydi
Kızgın kedi	DUURUT DUURUT BEN SENİ ÇOK SEVMİŞTİM YOUTUBE AMA SEN BENİ HİÇ SEVMEDİN YOREKOKUN BİLDİRİMLERİNİ KAPATMIŞSIN
Adil Burak	Bir daha o geçiş müziğini duymak istemiyorum yetheeer
Stheno Fors	kalitesiz video olmuş hiç ayrıntılara dikkat etmemişsin yakıştıramadım
Vanilla Ding Dong	Olaaaaaay
süvari bey	H A U S E O F B A B A M U K
Ebru Kurdaş	Federal tik tok halkının hayatımızda önemli bi yeri var onlar hayatlarına Son vermeden önceki son videolarını yapıp katliam yaratıyorlar
Özlem k	5 46 bu 2 girl 1 cup müziği
Abdullah Acar	sondakiparça edit inini ismini alabilirmiyim
enes yazici	Yengen sulandı köz getir söndürelim serii
JOHN CRISTOPHER FAN	My lady ha been dryed akskkdkfkfksllalalsömfkglgkblkblgövölv
Hitleri seven Komünist	Bidahakine Mode Xl gelsin
aLp	Yemegime ara verip yorum yapıyorum Edu ile enfes olmuş helaaaal
Sedat yilmaz	Michael Caine ne ara öldü lan kaçırmışım
Gtown Niggu	Dünyayı tiktokçu krdşlrm yönetsin ooo nananaaaaa ooo naanananaaaaa
Mustafa Kemal Can	Ben kalendir meşrebim
oguzhan colak	ending güzelmiş
murat evliya	Boğaç gibi bu mecrada senelerdir kaliteli icerik ureten birine sorulabilecek en guzel sorulari sordun gercekten Koskoca 10 dakikalik videoda adamin 2 kelime etmesine izin vermeyeceksen ona doğru düzgün sorular sormayacaksan ve tamamen konuğunu aşağılayarak komedi kasacaksan bunu boğaç gibilerine yapma konuştursan fikirlerini duygularını v öğrenebileceğimiz bir adamı absürt komedi niyetine kelimenin tam anlamıyla harcamışsın
Sercan GÜNEY	hala alber camus u düşünüyorum otuzbir çekerken mi
abdullah kocak	Eric Andreye selamlar
T.D. TIRPAN	senin tiktok programını izlerken hayatımda izlemediğim kadar tiktok reklamı izledim üzgünüm
dukka mendakka	Sodyum günlükleri
Çağrı Tuz	Hoş
Cris Formage	Kanal güzel de babakok her şey bir yerden alıntı yani Kanalın kendisi iDubbbzTV TVFilthyFrank ve leafyishere karışımı E bu vidyodaki format da Between two fern ve Eric Andre Show karışımı Hani her şeyin bir başka yerden kopya edildiğini görünce pek de bir komedisi kalmıyor
Ahmet ÖZ	0536979 07 39
Kedicik	Haşmetli yaşıyoooooo
Sadık Ortaç	Kumbara dolar dolmaz karıya gidek
Roy Miller	5 11 yıkıldığım an dostum sen süpersin
yiğit kızılay	neden eric andre show müziği ve geçişleri
Enes Demir	tam 31 çekmiştim üzerine bu videoyu açtım üzgünüm
Umut Yamaç Koman	9 36 mesaj geldi sandım la
Orkan Çil	Umarım Boğaç konuşurkenki uğultu bilinclidir
Haliye Özgürkuş	Nargilenin duzeneginde su var yenge icemeyince kuruyor
Kudret Yıldırım	Zach galifiniakis between two fence Iceriginin turu ordan calinma yorekok
h1pers	konu tiktok kanserine gelince tiktok reklamı çıkması da ne biliyim yani biraz sanki böyle derler ya hani
One Love	That s the way aha aha i like it
TheIbrahim1907	House of pain
Sarp E	abi neden kulağını karıştırıyorsun
Yarım gorani oynayan kuş	Sadık Topragı getir
kagan tan	daha fazla house of babakok gelsin
fat black man	v i c t o r y r o y a l e ş a p k a s ı
Çiğdem Nur Kulaksız	YHOFC
BEONHAS VİDEO	Deep wep turkish i getir ancak sen getirirsin
Ege Anlı	Bugünkü konumuz 31 ve pornonun dünyaya etkileri
okuyom ben yaaah	Vikipedia yasaklanio ama tiktok reklamda youtube over
Mustafa Talha ÇINAR	TEOMAN dinleyin
Thraldes *	Le Case De Kok
Ponçik OJJ	31 çekesim geldi
Osman Bey	2 bob 1 kok
yunusemreUfuk	Her şey boktan bir eleştiri ile başladı
MİXED	Are You Ready
Karambit TV	yttyyt
BuŞuO planetvrvrvrı	Neler dedi ve adam niye terk etti
öykü - G	Bu videoyla bir aydinlanma hissettim
Yusuf Bahadır Olgun	Çok iyi olmuş
Greexez 8899	Videoyu izlerken tik tok reklamı gelmesi
Equinox	8 18 de ki gülüş ne öyle D
Baki Güneş	MUAZZAM
Furkan köroğlu	Güzel olmuş bu arada ucuz kurgu diye bir şey vardı onu da hatırlamanızı rica ederim Doruk bey
GRKN- rezi	hugola
Sas Sad	Eric Andre Show
Buğra Kağan Altıkat	Annemle izliyordum abi Allah belanı versin
EREN DUMAN	birdahaki konu ölmek olosun
sad af	Ecükeytiyır
meraba televole	wtf yarıda tiktok reklamı
Tuna Çakmak	HOY
RoCoKo	outrodaki şarkıyı shazam da soundhoud da bulamıyor bulan birisi varsa yazabilirmi
InkSwapSans TR	AMAN AMAN NERELERE GELDÜM
gorsel Guneysoy	güzel devam
Mehmet Alper Korkmaz	kokain masasına hapşurmak gibi
Erdem Budak	your aunt is blented my brother
Asaf Yılmaz	Devam
ertuğrul emre bendekalsın	Bildirimler gelmiyor sikicem
ozan arend	Eric andre izledigini tahmin etmistim
İbrahim Atalar	YENGEN HARMAN OLDU LWLDLDDLLDLSŞSEŞFŞGLLEKW
Clash Gamer	sonuna kadar izleyen bordo berelidir
ahmet bilgin	YKS ALES TUS KPSS ve devamı olan bir insan Ne 31 i Gezecek zaman bulamıyor sonra beyin mavi ekran 😀
crylord37	5 46 nerde duysam tanırım videonun adı 1 cup 2 girl 1 Boğaç
Captain Game	Abbas yanbasani cagir ve aNa sKm konusunu isle
Ossibabak_YT ,	Yorekok Baba belgoturk Yeni Video atti maskeli adamin gereckt yuzu Yinee MOMO var
Furkan Karahan	aghhh my boner
manyak oyuncu	Oh ye babakoks house
Gazapizm'in Muâllâsı	Abi süper amınakoyim ya
Strabenflıttecem Weiterfahren	15 yaşındayım 31 cekiyorum sigara iciyorum qwqwqwqwqw
Pewchu	türkiyenin en iyi edit kanalı olabilir D
sinamatik Evren	HOUSE OF BABAKOK YOREKOK STAR BEBEĞİM
Duck Guy	The Eric André Show Kok edition şimdi hizmetinizde
Arena Team	BEĞENİN GÖRSÜN KONUKLARIN ELLERİNE ABSÜRT BİR NESNE VER ONLA DEVAM ETSİNLER KONUŞMAYA D
The ŞAPLAK is coming	Victory Royale şapkan legendary BABAKOK
Lyd	7 24 Yorekok oha mq
Burak Kodaz	6 40 Cod 4 çıktı zaten
Beyzanur Doğan	ne izledim ben biraz önce
Mertcan Yıldız	Bunun nasıl yapılıcağını göstermişsin babakokkk
Mehmet çetin	Dostum bu işi yapıyorsun
Yiğit Efe GÜLLÜ	Hayatımda gördüğüm en faydalı video
Mahir Karasoy	İlk defa boğaçın olduğu bir videoda eğlenmedim
Selenay Kurtkan	K A L E N D E R S O H B E T L E N D İ N İ Z
Tuğba Ç	Nerdesin be platoniğim gel de birlikte izleyelim Babakoku
A優素福	Bugün komik manyak intro yokmu
Eren Soytürk	Renk ver la sohuh
miro tankian	CAN SUNGUR GELSİN
Hulk Ekmek	TutmaZ
Onurlay Belasını Arıyor	Tiktok videoları izlerken 31 çekiyorum
Furkan Kaya	Enes baturu getir
Fuckosentez	Kendisi Educate ear
Lasivece	Seni izlediğim için teşekkürler
TAHA ZEYD NAYİR	Oynayan video kürdan videosu
Şafak Toker	İkiniz porno izlediğinizde ordakileri gerçek mi sanıyodunuz yani gerçek hayattaki gibi Eğer böyle sanıyosanız zekamız aynı değil Küçük çocuğa bıçağın zararlı olabilceğini söylersin ama bıçağı yasaklamayız demi çünkü gerekli Bu da öyle
Rozenans	biri 4 51 de başlayan tiktok yorumunu kesebilir mi
Davut Karaman	Diğer bölüme Porçayı çağır efsane olur
onatov onatoviç	ERIC ANDRE Mİ OLDUN ŞİMDİ
Yasin ATEŞ	Yengen harman oldu kardeşim seri serii
ADOLF KADİR	164873035
mail sarac	omg wtf
Adana Ball	9 22 şarkı çok güzel d
EmirAhmet Arda	arkada ne var kerimcan onedio professional educattedear
LORD VANDHAR	2 35 Ayberk neyi düşünüyor bir türlü anlayamadım
Janberk Ünal	anladım ağbi
Alperen Eker	Enes patirputur v amca evden kovma serisi acil
Moto garaJ	kalender abi kendıne ıyı bakkk senı sevmeyene guaj boyalı mercımek corbası ısmarlıycam instagram BAYPİS10 beni bul acil D kanalıma abone olmadın lan 2 senedır lider takıpcın benım D
Carnage	höhrööhö educatedear qalp yorekok eheoçhöhöhö
James Clerk	Micheal Caine gerçekten öldü sandım senin yüzünden
Irfan Coskun	Sesini değiştirebilmek için üst üste s bindirmemeye çalışıyorsun O nedenle birlikte program yaptığın insanlar sen konuşurken konuşmamak için kendini kasıyor Ama bu durum güzel bir sonuç doğurmuyor Educatedear gibi samimi ve neşeli bir adam bile ka katı oturuyor Genel olarak doğal bir diyalog gibi durmuyor Takibi keyifsiz bir süreç Bu sesinle ilgili olay yüzünden samimi ve eğlenceli bir sohbet programı yapman bence olanaksız Gerçek sesini kullanmamanı anlıyorum Bu konuda haklı olabilirsin Ama o halde daha eğlenceli bir sohbet programı formatı bulmalısın bence Mesela konuklarınla yan yana oturup konuşmak yerine Messenger ile yazışabilirsiniz Hem ironik olur hem de ilginç bir görüntü ortaya çıkar MSN zamanlarımıza götürürsünüz bizi Not Burada yazıştığın sohbet programı için bir sponsorluk bağlantısı bile kurabilirsin
Miray Algan	Daha uzun olsa su lanet videolar nolurdu sanki
fataltragedy	harika olmuş asfsdssffdsgh
Burak Özdemir	İzlediği video 2 girl 1 cup değil mi
sanal hunkar35	bu videoyu izleyipte şu şişkotayı rüyasında gören ey bizansın genç yüzü like at yoksa gırtlağını alırım
Yusuf Çelik	Babakok çok güzeldi verdim bi dislike
DaddyBassBelly	erik andre
Deniz Bey	Niyesiyahbeyazyabiyon
Behram İstanbullu	İNCİRLİ BİSKREM Mİ Hayatımda yediğim en b ktan şeylerden biri affedersin kusmaya gidiyorum
veni vici fıtıfıtı	EDUCATEDEAR O Brother Where Art Thou
Herbolog XX	8 13 fetişimi harekete geçirdin Ye beni babalock
Berfu Öztürk	Eric Andre gibi olmuş çok ta güzel olmuş
Metehan Arabaci	Devami gelsin diyenler
Dante Alighieri	olum çok iyi lan D
Mobil oyuncu Tunahan	Özcan showu eleştirsene
Mta Serkan	Sondaki müziğin adı nedir
Gökalp Durmuş	Kuşum Aydın değil mi o ya videodaki
ras sc	Çok iyi lan
Eda Elkoca	😄😄😄
MG-ONUR KILIÇKAYA	2 gril 1 cup
Melik Sah Tokur	Seri kapanış müziğinin linkini getir
UMUT ÖÇGÜDER	çakma geekyapar
Berk Çapar	eric andre bunu beğendi
Cahit Meray	2girl1cup mı
Cafer Balta	Aaaaaand it s the eric andre shoooow
Sinan Polat	michael caine ölmedi
EXORCISTT	devamı gelmeli kok izlemesi keyifli
hakan uzungöl	bu format güzel devam et
Adolf Soner	Outro
Smile Entertainment	Michael myers 😘
Onur Aydemir	Başlığı görünce istemsizce aklima House of Nature ve Elif Aybuke Koçak geldi 20 defa daha izledim tşk babakok 3
Miray Kuru	Sansürlenmiş video hangisi
Salim bağış	Batesmotelpro nun diğer üyeleri ile tekrardan bir projede yer almanı epey istiyorum Neden onlarla değilsin artık seni onlarla göremiyoruz sebebini tahmin edebilsem de tam olarak o kadarını bilmiyorum Birlikte bu işi yapmanızı isterdim En azından volkanı bu bölüme çağırabilirsin Belki onlara da faydası olur 😔
Kayra5138	Le harmaned yenge face
ege çakır	ene baturu davet eder misin
citizen alpi	Naysli dan
Sadiye	Two girl one cup bu müziği nerede olsa tanırım
taner no.	İzledikten sonra 31 çektim
Ahmetcan Özkul	L E F A C E T H İ N K E N A B O U T K Ö R İ N S T A F F L A N D I N
Troll Face	Babakok Buluşması yapalım
Rahadke Kolpa	Neyse videoyu kapatıyımda 31 cekeyim
Jujul Jaja	Jahreinin gelme ihtimali kaç kokbaba 😊
Berkay Karaçay	Şimdiye kadarki en iyi video olabilir muazzam bir ikili
Yasin Egemen	House of eduyore olsun hep boğaç olsun
Murathan Dil	Dinleyelim bakalım Teoman
Mustafa İBAÇİFLİKCİ	Yorekok kamera karşısına geçme cesaretinde bulundun ne zaman gerçek sesinle video çekeceksin
Ahmet Cengiz	Aşırı iyi video
Enver AYDIN	videonun sonunda çalan şarkı nedir acaba
fıstıkezmesi	deep turkıshweb gelecek ben soylım buraya da yazım bi cok kısı merak edıyo bence
jesus christ	Ya amınakodum yıllardır aklıma gelmiyodu müziği duyunca yine dehşete düştüm amınakoyim
Ebral Gomez	En sevdiğim 2 şahıs💙 Educatedear önceki videolarına bayılıyorum💙
Meyra	8 29 daki müziğin ismini bilen var mı
İsmail Çetinkaya	Boktan bir gün geçirdikten sonra şu içerikle karşılaştım Teşekkürler Babakok İyi ki varsın
Bekir Karakulak	michael caine öllmedi lan
Muhammet Duman	Edu yu ağzında acısız kanatla hayal ediyorum
Nuh özdemir	Edcukeytıdiyır şeklinde okunur adam diye yaz tamam tamam yapmayacağım
Esen Mansuroğlu	aralıksız 98 dakika boyu gülebilirim
tuncelcel	2 bölüm aleyna tilkiyle olmalı
çakma Dytto	gene muhteşem videoydu ✌ardı gelsin🌙
Zeynep Kısa	Mastürbasyon bağımlısı olan bir bey vardi okuduğum kitapta Ne zaman aklına mastürbasyon yapmak gelse evine koca koca taşlar götürüyordu Terapi için Siz de oyleyseniz evinizi taşla donatabilirsiniz Öylesine bir öneri jfjfjd
Murat Can Akdeniz	sansürlü video 2 girl 1 cup
Ziya Doğramacı	Bunu izledikten sonra 31 çektim
Adele Basar	her 31 dediğinde azdım
halil haya	yorekok bırak türkçemiyi katletmeyi
Nordalion	Eric Andre show of YouTube Turkey
Can Bulut Altin	boğaçın eski videosu two girl one cup
TG Eyup Kerem	Sen ne diyon nerde ay yanlış yermis
Yaren Deniz Özşahin	Sen nasıl bir kalitesin yaaaa
A.K.A Manyak Şişko	Bir süre götürür bu seri
Yusuf Bozkaya	5 40 ta 2girls1cup açıyor sanırım D
Hain Costak	Mükemmel
sisifos 2	Merhaba arkadaşlar ben yorekok
Enes Hesperos	İnş devamı gelmez hadi bakalım
Hugh Lauire	Sansürlenen video 2 gırla 1 cupmiydi 16 yaşımdayken izlemistim muzik tonundan anladım
Yaşar Altun	Can sungur
MambaRebellion	5 10 dk daha uzun olabilir
Enes Yeşilkaya	between two fern ü özlemiştik bu iyi oldu d
Aykut Yücesoy	Bu vesile ile umarim yorekoku post42 ekibi ile soguk savasta görme sansimiz olur
Hami ORAK	Boğaçın ciddiyetsizliği ve babakok tarafından youtubeun derinlikleriyle tanıştırılması Mükemmel bir bölüm
Efe Üngördü	Yorekok bozdu abi yeeeaaa Diyenler gelmeden
Ömer Tekin	Sıçarken olayları daha derin düşünebilmek
Panchostra	Eric Andre Show
Ali Eyup	İyi araklamışsın eric andre showdan
kubrickscalling	Babakok sonda çalan şarkı nedir Yengen kurudu yeminlem
Talha Tuğla	Tüm kanser konuları toplayıp iyi bir konuşma olmuş
Mert Toprak	Yorekok Soğuk savaşa diyenler 👍🏼
М.М KARAKAYA	Outro şarkısını bilen var mı
Ahmet Selim Ozturk	nice eric andre kardes
Emre Ozgen	David linch seni çok etkilemiş baba
bu kim lan	Bu koka naptınız lan Adamı hiç içten gülerken görmedim
Zümrüt Orhan	Abi harika video olmuş eline sağlık YouTube denen ne üdüğü belirsiz bu karadelikten bizi çıkarıp halen anlamlı esprilere gülebilen gençler yetiştirdiğin için çok teşekkürler babakok Serinin devamını bekliyoruz
Copycat	Bu videodan sonra ruh sağlığı hastanelerinin gelirleri arttı
Ferhat Aslan	Babakok çok sinirlendi ve sakinleşmek için aç karnına iki gün Tik Kok videosu çekmeye karar verdi
Hah Hahha	İlk defa yorekokun bir videosu boyunca gülümsemedim bile 👌🏿🖕🏿✨
Mehmet Fürkan Öztürk	Niye Boğaç a 1C2G izlettin ki sen şimdi s s
Efe Seymen	We will be right back
Yağız Hasan KÜTÜÇOĞLU	Sonda çalan şarkının ismi nedir
Emre Aktürk	Bir daha ki konuk batesmotelpro yakışır
inside dead	Cok iyi olmus❤
bülent öztürk	Koklar buluşuyor
Oğulcan Şahin	babakokun trollünü anlayıp sürdürebilecek nadir adamlardan biri educatedear ilk bölümün onunla olması iyi olmuş
Tunahan Onaran	1 07 yakalandım sandım
Chln Sl	2 kızlar ve 1 kap
Yakup Doğan	reyiz deepturkishweb ekibini çağır
Koalstoff	Hazır konuk almışken 15 20 dk tut da keyfimiz yarıda kalmasın Kuruyoruz sonra
Ozan Erte	Hiiiiii 😱😱
Hayri Parker	İkinci konuk fero olsun
HaydarT.	Abi çok cringe yaa
Efe Umut Güldal	micheal caine ölmediki ya hain yorekok
Shamkal Oğuz	Soğuk Savaş Yorekok
Ruslan Jafarli	Çektiyin videoyu sikeyim
Mehmet Köseler	duman duruken teoman mı dinliyim bi daha düşün D
burak elçi	Muhteşem
Oleg	Educatedear x yorekok fanart yaoisi istiyorum
Ahmet Yürük	kusacam
Serhat TÜLEK	İncirli biskrem harman oldu
Hıgh Tower	Of the rising sun
Random Things Around	Oooaaa bak bu çok iyi olmuş
One Above All	Aşırı we ll be right back müziği var Overdose olmamak söz konusu değil
Bismarck	2 girl 1 cup wtf
Kadir Alkan	A k a lüfer
Mert K	michael caine batman basliyor kara sovalye ve yukseliyor filmindeki alfred rollerini oynamasiyla ve bu filmde yapmis olduğu seviyeli ve cok komik mizahlarla kalbimde yer etmis birisiydi Allah rahmet eylesin mekani cennet olsun DIPNOT Christian bale kadar rolune en iyi uyan bir batmana bu kadar uyumlu bir yardimci gerekirdi zaten Soylemeden edemedim
Göktuğ  Köksal	uzun zaman sonra güldürdü
mehmet yurttaş	Her 31 de para atsam sanırım ekonomimize katkı sağlayabilirm
Ahmet Turgutov	Sardı Sarıyo
Yigit Öz	ilk bölümden harika konuk hharika konular süpersiniz
Emre Gülen	Aradaki geçiş müziklerinde Eric Andre Show un müziklerini bilerek mi seçtiniz sayın Yorekok Adamsınız
Ahmet Kürşat	Ulan gereksiz sansürle tanıdım seni vay be yıllar
tarık topçuoğulları	Daha çok video at götünğskrm
Enes Malik Arslan	Dünyayı yorekok yönetsin
özgür duru	YouTube yi kurtaracak seçilmiş kişi yorekok
Berke	Moa ladey ha bane dwraid MOAYT
Burak Özcan	half life intro yorekok outro
Fraserr HD	Abi bildirimler gelmiyor
Fatih Doğan	Between Two Ferns ve The Eric Andre Show karışımı bir şey olmuş Çok da güzel olmuş Sizleri tebrik ediyor ve başarılarınızın devamını diliyorum Yorekok Bey
fatih alperen	hepsi iyi hoş da Michael Caine i niye öldürdün onu çözemedim
PATATES ARASI KUMPİR	Hugolayla da yap bence
ismini vermek istemeyen mahmut	31 çekmek istiyorsanız kumbaranıza para atın diyonda para olsa atacaz
96eyagli	güzel sohbetti real soğuk savaşa da bi uğra
Nuriya Kurdaş	Job of the harman
TEK TAK TİK	http youtu be b4vQDQa1Zoc
RedSall	LORD OF BABAKOK BİTCHES
yiğido 0001	Biri eric andre izlemiş babaaa
Ferhat Yildirim	Enis Kirazoğlunu da çağırabilir misin
Pluton Baykuslari	O melodi hala kafamda çalıyo
mikasa ackerman	Hshshhshs sonuna kadar izledim yaa çok güldüm sjsjsjsjsjjs
Serhat Elcin	Ah riley reid elsa jean
Can Erkin	your local eric andre
Cihat Demirel	MÜKEMMEL
Skailbour	send bob and vagana
Jon Osterman	Bitirim İkili
Büşra Maya	2 Sevdigim youtuber yan yana
volkan salman	Seni izlerken Marvel alemindeki mavi kree Ler gibi oluyor ten rengim yada otobüste gaz çıkartan yaşlı teyzenin yanında oturuyor gibi görüşmek üzere
衙 ცԾՈ८uķ 浳му	Baslı Kok ❤️ educatedear
Beyza Nur	Hmm tuz
omer yildirim	real kesinlikle devam etmelisin izlerken gülmedigim saniye yok
OG Loc	5 38 two girl one boğaç
Ali Önal	sondaki şarkı beni etkiledi
Ali	rahatsız edici bir edit beğendim 👍
NameliNime	3 28 2 tane yaşlı KADIN var amca seninki takma mı
Muhammet İsmet Kazak	İşte şimdi kendime geldim
Seaque	Porno izliyorum Pornoların gerçek olmadığını da biliyorum film gibi izliyorum onları 1 yıldan uzun zamandır tabiri caizse 31 çekmiyorum ama izlememek en iyisi tabi
Egemen Boz	Michael Caine Harman Oldu Köz Getir HADİ TİKTOK İNDİRELİM
servet özmen	Yorekok😏
Albus Percival Wulfric Brian Dumbledore	5 40 2 girl 1 cup
KreatıF FikreT	Boş yapma moruq ya sen kimsin nallahım
NoThİnG lOsE	yorekokun dediği çoğu şeyi anlamıyorum sanırım cahil bir orosbu evladıyım
iron man	5 40 taki video two girl one cup
mehmet play	2 girl 1 cup
uweknow da wae shje	Bu videodan sonra ciddi ciddi 31 çekmek istiyorum
okan yılmaz	Eğvle eğvle para atmaktan kumbara patladı okumadığım kitap kalmadı dinlemediğim teoman müziği kalmadı
Romalı Abi	Micheal Cane Öldü AAAAA AĞZIMA SIÇIN AAAAAAHHHHHH
Abdulkadir Özgencıgor	Eric andre show Yorekok version Masa kırmak lazım olmaz öyle işin rajonu bu
Ay Adam	Beni hatırladın mı lan şişko
Fatih Aytar	Schengen Harmanoğlu
Emre Ç.	Siyah beyaz olmasına ayar oldum
Sabri Tugay Üstünay	5 50 2 girl one cup Eric Andre de yapmıştı Orjinal ol biraz taklitçi olma d Şaka şaka seviyoruz seni babakok
Batuhan Kirli	Bu seri devam etmezse buraya kusarım
ahmet said	İncirli biskrem yok ama bim deki incirli kurabiye var olmazmı
SkullKid	one man one girl two girl one cup
canerdhdj tc	O T U Z B İ R L E N D İ N
Soner Sedefoglu	The eric andre show tadında olmuş 😍
şaka zam	Seri gelsin
Pez Elma	Michael Caine ölmedi ki neden 1933 2016 yazıyor
Oyun Konsolu	O video 2 girl 1 cup muydu Lütfen o olmadığını söyle
MarserJared	Eric Andre
Ertuğrul Kalyon	Son bölüm de garanti ebes batır gelecek
kuş tüyü	Neden bildirim gelmedi ki😑
Enes Kaleli	cowboy bebop geçişleri beni tatmin etti sadece geçişleri izledim siz de çok geçişliydiniz tebrikler
arda_SG	ne izledim ben
lolGaming HD	Lan YOREKOK AMCA
Tina Dungze	seems like eric andre but not it is more like caner omur show
whitewriter	Yiyosa ingilizce kültür demeye çalışın ne kadar zor biliyo musunuz
GereksizPerma35 Bilal	İncirli biskerm yiyenlere kalp yazdım sandınız demi biz kalpci tayfa değiliz
Mert Sari	00 18 Subliminali de yediğime göre artık videoya geçebilirim beyin ayarları yapılandırılıyor 1 0101010101010101010101010101010101010101010101010101010101010101010101010101010101010101 0101010101010101010101010101010101010101010101010101010101010101010101010101010101010101 0101010101010101010101010101010101010101010101010101010101010101010101010101010101010101 0101010101010101010101010101010101010101010101010101010101010101010101010101010101010101 0101010101010101010101010101010101010101010101010101010101010101010101010101010101010101 0101010101010101010101010101010101010101010101010101010101010101010101010101010101010101 0101010101010101010101010101010101010101010101010101010101010101010101010101010101010101 0101010101010101010101010101010101010101010101010101010101010101010101010101010101010101 0101010101010101010101010101010101010101010101010101010101010101010101010101010101010101 0101010101010101010101010101010101010101010101010101010101010101010101010101010101010101 0101010101010101010101010101010101010101010101010101010101010101010101010101010101010101 0101010101010101010101010101010101010101010101010101010101010101010101010101010101010101 0101010101010101010101010101010101010101010101010101010101010101010101010101010101010101 1000 Beyin ayarları yapılandırıldı beyin koklar ile uyum sağlamasına geçildi videoya geçiş tamamlandı
Emirhan Yücel	michael caine öldü sandım abv you recock
Bera Furkan	İncirli biskrem
Berke Solmaz	eric andre show a benzemis baya begendim
Napolyon Kiraz Kompleksi	E R I C A N D R E S H O W L A N D I N
Emir Yümnü	abi neden ya
murteza güler	Çok iyi olmuş Keyifle izledim
Sefa Adar	E K E Y ne demek E k e yAnkara gücü D
Fatih Düz	Eric Andre ye benzettim Yorekok tanır mı bilmiyorum ama
Tuncay West	2 girl 1 cup
estonya	peki sonraki videonda kimi seçiceksin
Canberk	Eğer bu serinini devamı seri bir biçimde gelmezse Babakok Server larına saldırı düzenleyeceğim
İnsan GT	Boğaçlandın
Mühim Değil	Güzel video olmuş izlettiriyor Daha iyi içerikler bekliyoruz
Metehan Tekayak	Аdamsın babakok
Kaori Kanzaki	Best unexpected collaboration ever
gezegendegezen	4 33 kesinlikle gonzales hamster a benziyor
x x	Piano tile
Hasanali Ayhan	ABİ YORUMUMU BEGENİRMİSİN GERÇEK MİSİN DİYE MERAK EDİYORUM KRALSİIN
Kerem Demirel	Edu kat eder yore koklar
Serhat Şanoğlu	2 34 😂
Yusuf Altunbaş	Ted konuşması moruk ya kültürlüyüm
majesty John	Video gelir bir ara değil o video her zaman gelmeli ara verme
International Tv	abi ekranı siyah beyaz yapma normal yap bidahakine
Maryam Torabi	Bu seri efsane olacak
Ahmet Yusuf	Babakok yavaş yaş kısıtlamsı alcaksın
Ardıl Külekci	arkadaki şarkıları yazabilecek olan var mı
İsmail Hakkı UĞUZ	5 46 iki kız bir kupa 0 bok vallahi yok
Burak Srbs	YouTube seni bile değiştirdi be bilader eski tadı tuzu hiç vermiyorsun elveda babakok
Turgut Buhurcu	Very cringe geciriyom
selman bağrıyanık	İzledikleri videoyu merak eden bi ben miyim
karolin	yes papa
Mustafa Oğuzhan ÖZTÜRK	Neden İncirli biskrem
Dame Junge	3 44 😂
Batuhan Bakıroğlu	İlk kez bir videonu sonuna kadar izledim ondada teşekkür aldım Nerelere gitsem kimleri siksem bilemedim şuan
Kenan Oral	Neden
İsmigen Cotazalek	gelişir bu arada bu kanal
A random girl on the internet	gerçekten kulaklık takmak gerekiyomuş sofranın ortasında başlattım
JES! TERN	Olm fortnite çektim sandım fortnitenin şapkasını gitmişsin
*Forever Blink!*	YouTube seri zil bildirimi getir karşiim
Teoman Adacan	Seni Soğuk Savaş ta görmek dileğiyle babakok
Abush Shebo	harika content
Cause of my euphoria	8 19 cute♡
Ömer Faruk Aksoylar	serin format
halil ibrahim koçak	morakok mabim 3
Turner Meme	Mukbang yanlış okudun eheheheh
holycanzcrumb	0 50 ye kadar eric andre esintisi vardı müzik gelince tam anladım
JollyJoker	Oi Mait
İbRaHiM ŞaHiN	Aaa boğaç abi
Siverekli	Albert Camus adamdır
Demir Uğurlu	Mukbang video better than yorekok video
яusted รtrafer	your lady ha been dried
Goktug Bora Soylamis	Çok fazla Eric Andre Show u anımsattı
Mehmet Can Kara	Abi ben otuz bir çekmek istediğimde otuz bir çekiyorum ama porno izlemiyorum ve bu benim gerçeklik algımı etkilemiyor
Emre Akbulut	Ne izledim ben
Babamın Silahlari	M ü k e m m e l olmuş
Dj Yenici	son 100 yıldır kumbarama para atıyorum
ehvenişer hüdayinabit	arkayada mile devi koymuş kral
YUSUF	kokshow
Anime & Game	N ı c e V ı d e o panpa
Mertcan ellialtı 05081972	sizbizimçekoslavakyalaştıradıkşarımdansınyorekok
Le Vitaminsiz	Kokx talk by Educatedear from Salih ’ s brain
Beyzanur Demir	Offf mükemmel yorekok love yuuuu
Batuhan Karakaya	hayata bakış açım değişti teşekkürler Y O R E K O K
Erkam Sagdic	565 yorum galp at
FARADAY	Abi biraz çalışılmamış veya zorlama olmuş gibi bence aohbet daha samimi olsa çok güzel olurdu ama biz senin dk da bir suratını izledik
yusuf_ sekerci	haftaya Frida Kahlo gelebilirmi babakokcuğum
Mithat cem Köktürk	çok erotik bir video acilen kaldırılması gerek
Tobey Maguire	Mükemmel lan
Erhancan Yiğitbaşı	Süper seri ene baturu konuk al d
DOLAR düşürücü faşo	BU BOKU BEĞENİN 💩 ÇÜNKÜ O BİR BOK
Emre Aytaç	İlk yengen harman oldulandınız
Zehranaz Yılmaz	Steve job a sevgiler 😁🌻
Orkun Bey	5 37 den itibaren oynayan videoyu direkt şarkıyı duyunca anladığım için kendimi kötü hissediyorum
Haydar Abuzitin	Yorekok real efsaneydi seni izlerken ilk önce hayatım sorgulayıp gözümün önünden geçirdim ve geçirirken şunu fark ettim ben otobüse binip yer bulamayan yaşlı teyzeler gibi hissettim ve azgın amcaların altına girmeyi bekledim
Murat Demir	Yoreklendiniz
Mustafa Karagöl	Güzel olmuş aynen devam karşim
Samet Taşhan	Riley reid ❤
ahmet kerem yılmaz	Abi kumbarama para attım sonra albert camus kitabı okudum sağol ama isteğim hiç azalmadı
Yunus Emiroglu	Oooo babak naber yaa
Selam Aleykum	Igrencsiniz
Laithah	gülerken house of babakoku görüp bi düşünüyorum
Onurr Sanver	Neyse gidip 31 çekeyim
Argus'un Krallığı	Nedenini bilmiyorum ama bu videoyu açarken gülümsedim
Ahmet Õmer Õndiraz	The Eric Andre Show gibi olmuş iyi iş
Nesrin Erdoğan	My lady ha been dried 💦 ksdşdkşss
crab man	8 24 teki çözümlemelerin cidden doğru kelimesi kelimesine artık kok burcuyum 3
pesimist oyuncu	Yada 31 çekebiliriz
Tuğrul Tuncel	Olmuş
Neval KUTLU	Houseofbabakok
cg	Allah seni alsın yov ne kadar komiksin
Meryem Eray	Herkes güzel yaratıcı yorumlar yazıyor Ben ise hayalet izleyici olmak ve seri beğeni atıp çekmekten başka bir şey yapmıyorum Affet Babakok
sCATman	Priceless
MUTLU ÇALKAYA	İiiiii di babakokkkk
Deyişuk Jr	Özledik seni reyiz
Mücahit Kaya	Başarılı
Nihat Imrak	abi 4 menü nedir ya SAKAT BIRAKIR
Jordi El Nino Polla	Ben ne izliyorum amınankoyim
İbrahim Palaşoğlu	Ayakta duran Hannibal eksik
feyza vaveylai	10 09 bakıs ıdkdkd
Gökay Kurtoğlu	ben ne izledim diyorum şuan en azından iki eski analog mizahşörleri izlemek iyi ki varsınız
DarkEar	babamın maaşını elime geçirdiğim an kumbaraya attım saol babakok
Aliihsan Haşhaş	Big bang teori şarkısı duyunca duygulanan
ByPersians	Sen ulke icin cok yaratlisin o yuzden Saka lan saka videolrun mikemmel cringden arinmisssin ama seni cogaltmamiz lazim
Mr. Cringe	Post sosisvesalam
Ahmet Kemal YILMAZ	Ne idüğü belirsizler
Yusuf Kucuk	Efsane olmuş böyle devam et
H B	04 28 neye benziyor sence üzücü bir hayata ŞDNFŞWĞFÖEĞCMGÇNĞDMFKDNFÇÖVÇD
OLD MAN WOLWERINE	M Ü P T E Z E L L E N D I N
Pussy Slayer	Eric Andre show havasi olmus BEGENILDI
Hello Negibor	4 05 yemek yiyordum lan yemek
Itachi	holy shit caine
Ayşegül Şafak	5 50 2 girl 1 cup
S.Bahadir Turker	Abi neden reklamlarında aleyna tilki var
When Music Talks...	MY LAYDY HAS BEEN DRIED BRING SOME EMBAH PLEAS
buse aydın	my ladie ha been dried asdfg
Mustafa Karpınar	Hahafhhj
Muhammed AKAN	4 51 o kadar iyi açıklamışki içim rahatladı
MThan	Daha az kanser koy
chin chin	Eric Andre den content çalmak iyiymiş kokcum
Furkan M.B	Yine aydınlattın bizi babakok sokuşturamadıklarımızdanmısınız
Strawberry Field Guard	2 KOK 1 CUP
NEQOLAİSER	sanki bu videodan önce bi video daha vardı bişeler mi oldu izleyemedim bea I
Arda Albayrak	Olm tipin çok tatlı la
Doğukan subaşı	Emma watson 3
sekseverler derneği	Remix adam senin tırnağın olamaz abim Sen komikli remixlerle youtube türkiyeyi ele geçirmişken remix adam pipisiyle oynuyordu
Empire Of Game	Tiktok dünyada gördüğüm en en en en en en en en en en en en en en en en en en en en en en en en en en en en en en en en en en en en en en en en en en en en en en en en en en en en en en en en en en en en en en en en en en en en en en en en en en en en en en en en en en en en en en en en en en en en en en en en en en en en en en en en en en en en en en en en en en en en en en en en en en en en en en en en en en en en en en en en en en en en en en en en en en en en en en en en en en en en en en en en en en en en en en en en en en en en en en en en en en en en en en en en en en en en en en en en en en en en en en en en en en en en en en en en en en en en en en en en en en en en en en en en en en en en en en en en en en en en en en en en en en en en en en en en en en en en en en en en en en en en en en en en en en en en en en en en en en en en en en en en en en en en en en en en en en en en en en en en en en en en en en en en en en en en en en en en en en en en en en en en en en en en en en en en en en en en en en en en en en en en en en en en en en en en en en en en en en en en en en en en en en en en en en en en en en en en en en en en en en en en en en en en en en en en en en en en en en en en en en en en en en en en en en en en en en en en en en en en en en en en en en en en en en en en en en en en en en en en en en en en en en en en en en en en en en en en en en en en en en en en en en en en en en en en en en en en en en en en en en en en en en en en en en en en en en en en en en en en en en en en en en en en en en en en en en en en en en en en en en en en en en en en en en en en en en en en en en en en en en en en en en en en en en en en en en en en en en en en en en en en en en en en en en en en en en en en en en en en en en en en en en en en en en en en en en en en en en en en en en en en en en en en en en en en en en en en en en en en en en en en en en en en en en en en en en en en en en en en en en en en en en en en en en en en en en en en en en en en en en en en en en en en en en en en en en en en en en en en en en en en en en en en en en en en en en en en en en en en en en en en en en en en en en en en en en en en en en en en en en en en en en en en en en en en en en en en en en en en en en en en en en en en en en en en en en en en en en en en en en en en en en en en en en en en en en en en en en en en en en en en en en en en en en en en en en en en en en en en en en en en en en en en en en en en en en en en en en en en en en en en en en en en en en en en en en en en en en en en en en en en en en en en en en en en en en en en en en en en en en en en en en en en en en en en en en en en en en en en en en en en en en en en en en en en en en en en en en en en en en en en en en en en en en en en en en en en en en en en en en en en en en en en en en en en en en en en en en en en en en en en en en en en en en en en en en en en en en en en en en en en en en en en en en en en en en en en en en en en en en en en en en en en en en en en en en en en en en en en en en en en en en en en en en en en en en en en en en en en en en en en en en en en en en en en en en en en en en en en en en en en en en en en en en en en en en en en en en en en en en en en en en en en en en en en en en en en en en en en en en en en en en en en en en en en en en en en en en en en en en en en en en en en en en en en en en en en en en en en en en en en en en en en en en en en en en en en en en en en en en en en en en en en en en en en en en en en en en en en en en en en en en en en en en en en en en en en en en en en en en en en en en en en en en en en en en en en en en en en en en en en en en en en en en en en en en en en en en en en en en en en en en en en en en en en en en en en en en en en en en en en en en en en en en en en en en en en en en en en en en en en en en en en en en en en en en en en en en en en en en en en en en en en en en en en en en en en en en en en en en en en en en en en en en en en en en en en en en en en en en en en en en en en en en en en en en en en en en en en en en en en en en en en en en en en en en en en en en en en en en en en en en en en en en en en en en en en en en en en en en en en en en en en en en en en en en en en en en en en en en en en en en en en en en en en en en en en en en en en en en en en en en en en en en en en en en en en en en en en en en en en en en en en en en en en en en en en en en en en en en en en en en en en en en en en en en en en en en en en en en en en en en en en en en en en en en en en en en en en en en en en en en en en en en en en en en en en en en en en en en en en en en en en en en en en en en en en en en en en en en en en en en en en en en en en en en en en en en en en en en en en en en en en en en en en en en en en en en en en en en en en en en en en en en en en en en en en en en en en en en en en en en en en en en en en en en en en en en en en en en en en en en en en en en en en en en en en en en en en en en en en en en en en en en en en en en en en en en en en en en en en en en en en en en en en en en en en en en en en en en en en en en en en en en en en en en en en en en en en en en en en en en en en en en en en en en en en en en en en en en en en en en en en en en en en en en en en en en en en en en en en en en en en en en en en en en en en en en en en en en en en en en en en en en en en en en en en en en en en en en en en en en en en en en en en en en en en en en en en en en en en en en en en en en en en en en en en en en en en en en en en en en en en en en en en en en en en en en en en en en en en en en en en en en en en en en en en en en en en en en en en en en en en en en en en en en en en en en en en en en en en en en en en en en en en en en en en en en en en en en en en en en en en en en en en en en en en en en en en en en en en en en en en en en en en en en en en en en en en en en en en en en en en en en en en en en en en en en en en en en en en en en en en en en en en en en en en en en en en en en en en en en en en en en en en en en en en en en en en en en en en en en en en en en en en en en en en en en en en en en en en en en en en en en en en en en en en en en en en en en en en en en en en en en en en en en en en en en en en en en en en en en en en en en en en en en en en en en en en en en en en en en en en en en en en en en en en en en en en en en en en en en en en en en en en en en en en en en en en en en en en en en en en en en en en en en en en en en en en en en en en en en en en en en en en en en en en en en en en en en en en en en en en en en en en en en en en en en en en en en en en en en en en en en en en en en en en en en en en en en en en en en en en en en en en en en en en en en en en en en en en en en en en en en en en en en en en en en en en en en en en en en en en en en en en en en en en en en en en en en en en en en en en en en en en en en en en en en en en en en en en en en en en en en en en en en en en en en en en en en en en en en en en en en en en en en en en en en en en en en en en en en en en en en en en en en en en en en en en en en en en en en en en en en en en en en en en en en en en en en en en en en en en en en en en en en en en en en en en en en en en en en en en en en en en en en en en en en en en en en en en en en en en en en en en en en en en en en en en en en en en en en en en en en en en en en en en en en en en en en en en en en en en en en en en en en en en en en en en en en en en en en en en en en en en en en en en en en en en en en en en en en en en en en en en en en en en en en en en en en en en en en en en en en en en en en en en en en en en en en en en en en en en en en en en en en en en en en en en en en en en en en en en en en en en en en en en en en en en en en en en en en en en en en en en en en en en en en en en en en en en en en en en en en en en en en en en en en en en en en en en en en en en en en en en en en en en en en en en en en en en en en en en en en en en en en en en en en en en en en en en en en en en en en en en en en en en en en en en en en en en en en en en en en en en en en en en en en en en en en en en en en en en en en en en en en en en en en en en en en en en en en en en en en en en en en en en en en en en en en en en en en en en en en en en en en en en en en en en en en en en en en en en en en en en en en en en en en en en en en en en en en en en en en en en en en en en en en en en en en en en en en en en en en en en en en en en en en en en en en en en en en en en en en en en en en en en en en en en en en en en en en en en en en en en en en en en en en en en en en en en en en en en en en en en en en en en en en en en en en en en en en en en en en en en en en en en en en en en en en en en en en en en en en en en en en en en en en en en en en en en en en en en en en en en en en en en en en en en en en en en en en en en en en en en en en en en en en en en en en en en en en en en en en en en en en en en en en en en en en en en en en en en en en en en en en en en en en en en en en en en en en en en en en en en en en en en en en en en en en en en en en en en en en en en en en en en en en en en en en en en en en en en en en en en en en en en en en en en en en en en en en en en en en en en en en en en en en en en en en en en en en en en en en en en en en en en en en en en en en en en en en en en en en en en en en en en en en en en en en en en en en en en en en en en en en en en en en en en en en en en en en en en en en en en en en en en en en en en en en en en en en en en en en en en en en en en en en en en en en en en en en en en en en en en en en en en en en en en en en en en en en en en en en en en en en en en en en en en en en en en en en en en en en en en en en en en en en en en en en en en en en en en en en en en en en en en en en en en en en en en en en en en en en en en en en en en en en en en en en en en en en en en en en en en en en en en en en en en en en en en en en en en en en en en en en en en en en en en boş şeydir
Murat Üzel	Videodan sonra gelen anlamsız incirli bi biskrem yeme isteği
martin Schreibenwerologtransilowski	muvaffakiyetsizleştiricileştiriveremeyebileceklerimizdenmişsinizcesine
Elif	Babakok Andre Show
qlows kkk	Video güzelde inşallah renk körü değilimdir
Stop it Get some help	Çok iyi olmuş kskdbskdjajskjflskd
Yunus Çiftci	two girl one cup videosu o D
Tarla Faresi	ulan herif yaşıyo neden öldürdün bi de 2016 da
Salih Demirel	yorekok seni neslimizin boktanlığından bizi kurtaracak siber bi şövalye olarak görüyorum
Samet Basaran	Daha fazla bekliyoruz video BABAKOK
Ferhat Kuru	Sesin Montaj mı
Deadpool Game boy	Yorekok ve Educatedear mı Mom Get the camera
Fatih oyunda XXx	bende gitmedi youtube
oğuzhan çalışkan	eric andre nin daha sakin olanı
Deniz Gençtürk	Bence izleyin ve çekin
Alper Şimşek	Bu sefer de eric andre teliflicek
SASİ FANBOY	Yorekol
Wantonsergea	Abi lütfen bts elestir bikrtim su bts den
Hasan mert şimşek	Babakok why so Eric Andre
Habbo Really	Gülüyodur heralde 😅😅🤣
Enes Okyanus	Ses kalitesi gittikçe kötüleşiyor Aynı hayatım gibi Bu videoyu neden izledim ben ya
Yutubçu	el kokado sohbet zamanı kalıp atarmısn adamım
Fırat Yılmaz	Harika konulara parrrrmak bastın
Just Play Games	3 47 Yorekok but with mental breakdown
Nlh Krky	Dekor fena qardeshimm
Ahmet Çankaya	yorekok kendi batman filmini çekmelisin
Furkan Türkcan	Neyse gideyimde bi 31 çekeyim
Huseyn Memmedov	Tolga cevik gelsin next bolumde
yavuz selim ALTUN	Ne izledim ben
The Royal Whistle	müthiş bir içerik olmuş umarım 1000 bölüm gider
Betmen Motovlog	ruh hastasi D
Miraç Adaş	işde bu
Paradoxy 2023	A K A Sahibinin sesi
Parkour secption	O video neydi acaba merak geldi
SwctPass	Birdahakine beni alarmısın
Ömer Kahraman	Bu videoyu heycanla açtığım için kendimden utanıyorum
Burak Samed Doğu	abi adam ölmemiş ki niye öldü dediniz ayıp değilmi yav D
san paste	France pig
Mustafa Niyazi	ilk başta subliminal mi koydun abi D senden beklemezdim yaw
Deniz Antigone	meme review 8 56
WONG	video yu izlerken 31 çekmek CSDEAFDRVGTHBGERTHGWERTHG
Kaya Alp Tütüncü	Amatör izliyordur
Alex Ruthbone	Epilepsi uyarısı niye yapmıyorsunuz Gözlerin birbirini sikti
Slade Wilson	2 koks 1 wow
Ece Aksoy	Bomboş bir videoydu Muhteşem
VictorySniper	yorekok deep turkısh web le viddeo çek bence sikiş amcıklı olsun
Yağmur	Boğaç abim be
Ömer Kızılkaya	Güzel olmuş artık her 31 çekmek isteğimde bu videoyu açıcam
Sami E.	Abim çok güzel olmuş ama Pewdiepie ya saldırma olayı internet şakası Hintli olan T series kanalı onu geçmek üzere diye platforma olan gelen bi saldırı
MFG Master	Efsane
EtsizÇiğKöfteOlmaz	bu ikisini bir odaya kapatıp sabaha kadar konuşturmak lazım
Yusuf Kaan Erdoğan	Mouse of babakok so Soryyy
özcan arslan	onur nerden vuracağını iyi biliyorsun he
BulaşıkSüngeriSüngerBob	Le bababok
Bulut Koç	K A R D E Ş İ M Y E N G E N K U R U D U S E R İ K Ö Z G E T İ R
Children waiting for the day they feel good	outro
Lucifer	Sonraki bölüme Jahrein i çağırır mısın
DJ Esqaliže	8 29 müzik ismi lütfen
Rage 2	HoB
haci baba	bi soğuk savaş patlar hee
kangal	tiktok izledikçe 31 cekıom 31 cektikce ted konuması dinlıom
Seri Köz Getir Kardeşim	BABACOCK
Herhangi Biri	bir sonraki house of babakok bölümüne seri getirilmeyen közü konuk al
Kill Zone	31çekmeisteğiduyuyorum
Mirzan	Lan yorekok öyle olduğunu sanıyorsun ama hiç eğlenceli bir eleştiri kanalı değilsin ama biliyorum bu durum zerre kadar sikinde değil aynı şey benim için de geçerli
UĞURCAN GÜRPINAR	O değil de Editleri en kaliteli olan tek youtube kanalı
jont	Bu video benden daha aşağılık ☠️
ERTUĞRUL ÇILDIR	YA ŞU BAHO ŞEYSİNİ YAPMAYIN ÇOK SEVİYE DÜŞÜYO SONRA JAHREİNE FALAN SARMIŞLARDI ÇOK REZİL OLMUŞLARDI
Diagonal BrambLe	damn son where d you find this
Polizei	yengen K U R U D U kardeşim seri K Ö Z
Ahmet Aksu	Abi bugunden itibaren o 31 cekmeyip para atma isini yapacak ve gelismeleri buraya yazacagim
Furkan Şenel	KARDEŞİM SERİ VİDEO GETİR İZLEYİCİLER KURUDU
Ali Balta	Baba supersin
Mehmet Yavuz	Outro da çalan şarkı nedir bilen var mı
zEEp	Eğitimli kulak
Prometheus	Can sungur gelsin Efsane olur
Gayem Malta	Özlüyoruz ❣
Sarper Dönmez	Bkz Yengen harman oldu
Keyfimin Kahyası	Video çekimini yaparken kestiğiniz yerleri de video sonuna ekleseniz daha iyi olur aslında
TeflonTepsi	tu görl van kap
s1	2 kral 1 video
ADOLF HITLER	Kendi yorumumu arıyorum moruq
Rexla	ilk defa az renkli video sonunda gözüm açık izliyeceğim epilepsi hastasıyım aynı anda 1 den çok renge bakınca epilepsim tetikliyor mağlum yorekokun videoları pavyon gibi ışıklı mışıklı gözüm kapalı izliyorum hep sadece s
Yunus Emre	Efsanemk
Tesla Bey	2 Sap 1 kok
Fikir. Kaya	Baba dogru yolda ooh yeahh p
Oğuz Kaan Cüni	YORERIC ANDRE VE KONUĞU
Burcu	Cok eğleniyorum seni izlerken babakok gözümüz yollarda kalmıştı
Mehmet Cengiz	Beynimi yaktıgın için tşkler kalp at C
gren gren	Mesela doruk yavuz ted konuşması findux 31 kumbara diferansiyel denklemler
Bruce Wayne	babakok eric andre seviyor sanırsam
Oyuncu avı	abi efso olmuş hayattan ve nuggettan mahvolmus ruhum çok büyük bir acıyla izledi
tayyip oksuz	Kalitesiz talk show lara örnek olması umuduyla
Berat BAKI	PRİM DEVRİYESİ GELMELİ BENCE 1
Utku Aslan	Ted konuşmasını Ted kolejliler mi izliyor
Soldier Elite	Daha bi saat olmuş 400 yorumu da ben atıyım düz saýı olsun
Devilevils	tam 31 çekecektim bu video bana hayatı sorgulattı teşekkürler yorekok ve educatcatcacasdad
Fatih Kaplan	Sonunda be babakok ♡
Sinan Coşkun	Educattedear Y O R E K O K L A N D I N
Nuri Külahcı	10 dakikanın üstünde yengen harman oldu lütfen seri devam etsin yoksa seni macbang yanlış yazmış olabilirim videosunda ki kılların arasına sokarim
Recep Emre Ada	Tek dikkatimi çeken yorekok un sürekli çarptığı çiçek ve mum
Erdem Teker	o muhabbetin orijinali kardeşim seri limonlu soda getir yengenin boğazı kurudu boğaçın dediği gibi közle ıslanmanın yada kuruluk gidermenin alakası yok kurumasının sebebi de fazla nargile içmesi
Ömer Benian	1 cup 2 girl Sansürlenen video
Mobil Oyuncu	Micheal caine ölmedi
A-Social Man	EducateEar
Mustafa Kılıç	35 dakika
Ömer Yurdunol	yengenkuruduközgetir
Emre Öksüz	Abi yemin ederim şuana kadar en çok güldüğüm kabus oldu D D
Engin Göksuakar	𝐄𝐃𝐔𝐂𝐀𝐓𝐄𝐃𝐊𝐎𝐊
Enes Kaya	ADAMKOK
Hetaro	H O B
TastyGamersTv	Yorum
Pipildek	09 05 meme review
Comolokko Man	Hosbulduk
Nakro Nakroth	Desperado da calan music esnasinda yorekok adeta Quentin Tarantinolandığını hissettim LİKE A BOSS
BİZİM FAKİRHANE	gzl olmş krdşm bıravo
Turk Astronout	ok
Faruk Aydın	Tedx izledikten sonra patlattım bi tane xD
crowding out	Yorekok hocam montunla bir dean winchester olmuşsun sorması ayıp nereden aldın yakışmış yani paylaş bizimle saygılar
Ömer Faruk Göktepe	Abiiii
Şehirdeki İnsan	aldığı konuktan çok kendini ön plana çıkaran tek program tebrikler
ÜLKÜCÜ BOZKÜRT	yorekok un gerçek adını biliyorum
ömer balkış	Senin sayende zengin oldum
ツtaylan winner	HENTAIIIIIIIIIII WEWWEQWQEWQ
Kaan Ergin	Videodan hemen porno açtım ve ağlayarak 31 çektim
Batuhan yıldız	2 Cocks 1 Ear
Godly Or Godlee	güzel video he bu arada eric andre devam ediyormu bilen varmı nerden izleyebilirim o 2 girl 1 cup yerine 2 kid 1 sandbox felan gösterebilirdin tam çalmışsın be abey
Barış Güler	Michael Caine ölmedi Ki sen bunu zaten biliyordun
DeaD inside	Ne boktan manasız ve gerksiz bi videoydu
EFSANE SARAN	turkish eric andre show
Sorry For My Bad England	Asya şarkılarının kliplerini inceler misin
sıla	Keşke 3 saat falan olsaydı çok kısa oldu bu babakok 💜
Usame Çağtay	Sende mi Yorekok
limonun sikilmiş diğer yarısı	Her 31 çekmek istediğimde kumbaraya para arsaydım şu an tramp ayak parmaklarımın arasındaki siyah kiri emcikliyo olurdu
EREN POLAT	İYİ TAŞAK GEÇİYORSUN TANIMADIĞIM HALDE NEFRET ETTİĞİM KİŞİLERDEN YOUTUBER
alpgiray nyan	Bu victory royale şapkasını belediye mi dağıtıyor boiii
Kløus	Tiktok ölüm asla denemeyiniz
ibrahim kaynak	Mulholland Drive ın içine Krimcan ı koyman psikolojik yoğunluğunu betimledi kardeşim 💆
Kerel	Boğaç ın ömründen ömür gitti kardeşim nasıl format bu
Garip voltadır	Artık 31 cekmicem teşekkürler babakok
Nao Lithic	Nibbas tartışıyor
Halit Cerrahpaşalı	RICA ETSEM SALİH REİS GAMZE VE BABASINI KONUK ALABİLİR MİSİN BEN DE ÖYLE TAHMİN ETMİŞTİM TEŞEKKÜRLER
Hezyan	Michael Caine öldü mü ya
Hasan Demirlek	Youtube geri dönüyor
Kutay Madenci	ben ted yerine geekyapar izliyorum ama
Bilgin Durmusali	sondaki müzik ismi lütfen çabuk teşekkürler
Kubilay Erkan	Between two koks
Çukulata %	Enfes
Godoş Matriks	İyide çok iyi ya
Serkan Turan	Between two fern
gamer bro	8 22 valla mı la
Glass Man	beyin hücremi 20 e indirdin yorekok
Onur Ugur	Burasının cringe olmaması gerekiyordu sadece ted konuşması ufkumuzu açar sözleri çok fazla cringe değil miydi
Kıraç Aslan	kardeşim yengen kurudu seri video at
Beyza x	0 46 youtube tr nin gidişatını düşünürken tam olarak böyle oluyorum Yanlız duygularıma değil mimiklerime de tercüman olduğun için teşekkürler Babakok💛
ayranım dökülmesin götüm sikilmesin	Cock penis değil mi çok ayıp
mustafa boran	beyler iyi izleyin diğer video 10 yıl sonra gelicek ehuehu
yigi	yengen kurudu gel vajinasini yala
Kemal Arda Ayar	meh
Deniz İster	Abi gay sikis porno yapsaniza
i love natsuki	1 cup 2 girl
Baranalp Aksal	B Hala Albert Camus ’ u düşünüyorum Y Osbir çeherken mi
Stuka Blyat	Yok öyle soğuk savaşlar Друг
Yasin Kaygusuz	Niye Elsa jean
Steam Steam	Yorekok sayfanin bildirimlerini açtım ama bana video attiğına dair bildirim gelmiyor neden
esrachunli	Doruk boğazında ne var kanka kablomsu bir şey gibi
adasgamer67 gf	mukbanq videosu bekliyoz moruq
Can Kantarcı	Sen varken remixadam kim reyiz
Ahmet SAYGILI	Babakok soğuk savaşa katıl reyiz
Doğukan Canbulut	le educcate ear face
Emre Ümit Er	Beyin yalpalaması geçirten bir video olmuş nöronlarınıza sağlık 3
Minnak Tilki	Yorekok soğuk savaşa gelsin
Aykut Çam	Boğaç ’ ı Yorekok ’ tan kıskanan bi ben miyim
Osman Erdoğan	Yorekok bu mecraların en iyisi değil mi lan
sin miedo	🍑2 GIRL 1 CUP 🍑
Tarık Şamil ŞAHİN	Sansürlü video 2 girl 1 cup videosuydu da ben niye bunu biliyorum ya
PsyNova	efsane ikili bi arada
Mister Pandastic	Depresyonum 3 kat daha güçlendi
Caner taşköy	31 sonrası izleme keyfi
tyretear	2 36 HDSIRPFHWAEIORHEWNIQRFHYERTEHSITJ
Sakura Hagiwara	Yorekok ❤
Piano Hands	Ahahaha bu konsepti sevdim
Serhat Genç	BABAKOK
Eren Bozkurt	Can sunguru cagır
Maxipyke	şu an şu dağların arkasında aaaaa diye bağıran dayı var ya onun gibi bağırıp yüzlerinize bakarak 31 çekmek istiyorum o yüzden kumbarama para atıp albert camus okurken teomanla cinsel ilişki yaşayacağım şey pardon teoman dinleyeceğim
Haje	Eric Andre Show esintileri güzel
Numb	Ｋａｌｉｔｅ
FNC Faker	Her 31 çekmek istedinizde yorekok açın
Deniz Duru	2 Girls 1 cup 5 37
Berk	Hacı biraz reklamına video düşmüş
Nescient H	Soğuk savaşta seni görmek isteriz
mert aydogan	bekleyelim video gelir bir ara
Yusuf YILDIRIM	ne her 31 çekmek istediğimde kumbarama para mı atiyim zenginim dostum
Buse Ozturk	3 50 kulaklıkla dinleyenlere 5 saniyelik saygı duruşu
frkn krks	tam kuruyoduk geldin
Yunus Çoban	Efsanesinizzzz
Deniz Aksakal	Eric Andre show
Teolia	Abi gerçekten efsane devamı gelsin ya en kaliteli içerik manyaksın sen D
SivilceSurat	şey değil mi ya bu napiyoruzbizki
Berke Ünal	Bilinçli bir şekilde ve standartları belirlenerek çekilmiş rezil bir video İzlediğim en kötü 10 video arasına girebilir çok başarılı
Dragonborn _5445	Birdahakine berk gelsin
Emirhan Altun	3 28 içeride 2 tane yaşlı kadın var D
görkem güler	2 bölüm deep turkish web ile olsun
HanSulh	TED konuşmaları izleyecek gençlere uyarı Eski TED videolarını izleyin bi 2016 öncesi fln yenileri çok bozdu Eskiden veri ve objektif gerçekler yada farklı felsefik bakış açıları üzerine enteresan eğitici ve bilgilendirici konuşmalar oluyordu Şimdi ise daha çok kişisel doğrular hisler ve sözdebilim metafizik saçmalıklar üzerine konuşanlar çıkıyor hep TED konuşmalarına bilmiyorum TED bilerek mi yapıyor yoksa çıkıp konuşacak akıllı adam mı kalmadı Tabi yeni konuşmalardan da güzel olanlar var ama geneli bahsettiğim gibi
Osman BEYAZAY	Aklımda porno izlemek yoktu aklıma soktunuz
Doğukan Keskin	sizi shipliyorum
Buğra çalışkan	Kumbaraya attığım paralarla zengin oldum çok teşekkürler yorekok
soomeoone oordinary	En son çalan müziğin adı nedir
egolu kişi	Şu arkadaki jazz müziğini bilen varmı
Smiley	Yeni HOB h o
LaToupe Extreme	Senin yüzünden tekrar porno izledüym
Serhat Güzel	200 IQ SUN
Buse Kahraman	Son kısımlarda çok tatlıydın be Babakok
Muhammet Işık	Oha en sevdiğim remixçi ve yutubır yan yana 💙
Hiroş hima	Hayatımın değiştiğini hissedebiliyorum D
alperen ipek	BABACOCK IN FIRE
Mehmet Çoksever	educate ear kim
Ahmet Veli Dirican	Yorekok artık bimden alınmış bozuk süt gibisin
Furkan Poçan	Oyyyyy ne video beeeeeeeeee
Tayfun İçpınar	Bu adam boktan espriler yapıp zorla gülme videoları çeken arkadaş değil mi
MEHMET KORHAN	Bu işi biliyosun
serdar al	Dünya üzerindeki en boş video filan ama yine de izledim ve sorgulamıyorum çünkü boş şeyler zevklidir babakok candır
Ahmet Nadir Keçeci	Boğaç çıplak adamın videosunu izlerken yemeğe kitlendi hissettim aç mı yayına çıkardınız lan adamı
Furkan Şen	Tuvalette eskiden p rno izliyordum bu videodan sonra babakok izliyorum
RED Risus	bu molotofçu niye burda binaları ateşe vermekten fideleri yerinden sökmekten mi sıkıldı
Bora TİLEYİ	Lan
Oğuz	Michael Caine i de öldürdün ya helal
Enes Yüngül	between two fern değil mi bu ya
Dalyar Akoğlu	onedio videosu gelsin
gurur ateş	Saglam is 😄
Ajan Profesyonel	31
Tcma Sync	30 yaşında şişman bir insanın Efendim
seth rollins	adam incici beyelr dagılın asd ASf a DFS F
Ezio Auditore Da Firenze	nerede A K A MANYAK ŞİŞKO
ismail sevgili	Defalarca güldüğüm videodan bir tanesi daha
Hasan Yıldız	İŞTE BÖYLE VİDEOLARA TREND DİYORUZ
Pulart	KANKA PSİKOLOJİMİ BOZDUN VE ZATEN BAYA BOZUKTU
Aureliano Buendia	5 30 2 youtuber 1 kok
Max	Babakok yakında Soğuk Savaşa katılır rez alın
Valar Dohearis	4 04 hayattan soğudum
omer	BU ERİC ANDRE KAFASINI SEVDİM AMA ÇOK EDİT YAPMIŞSIN KARDEŞİM BİRAZ AZALT MUHABBETİ DE DİNLEYEBİLELİM
Samet Arik	aaaa remix adam değil mi ya o
Tarık Ekici	5 40 2 dirhem 1 çekirdek
oguzhan ergin	BOYNUMA DOLAKOK
Samet Değirmenci	5 39 2 girl 1 cup sanırım sesden anladım xd
Linatr Lina	YOREKOK BİRAZ CİDDİYE ALSA SAĞLAM PARA GÖTÜRECEĞİNİ DÜŞÜNÜYORUM AMA ADAM TARZINDAN ÖDÜN VERMİYOR
Ömer Faruk	Your lady ha been dried
ÜNİVERSİTELİ KAFASI	3dk gibi geldi 10 dklık video
Mert Sezer	Bana Yorekok gibi acı soslu nargile aromalı 4 ekonomik daba daba burger bulun Avrupa yı feth ediyim Fatih Sultan MEHMET
Çare Sauron	Babakok bu nedir Felç oldum D
Alptekin Ustun	bir an micheal caine gerçekten öldü sandım korktum
Enes	B A B A K O K L A N D I N
Zedra	Yorekok Kimdir Yorekok gelecekten gelen bir cyborg ayısı Ne İşe yarıyor Dünyanın ne kadar boktan ve manasız olduğunu anlatıyor Peki hayat boktan ve manasız ise neden uyarma gereksinimi duyuyor Çünkü bizleri seviyor
The Reptilian	CANIM KÖRİ Lİ TAVUK KIZARTMASI ÇEKTİ
Mia X	Le büyük köz harmanda face
Burak Şahin	Bu videodan sonra 31 çektim Teşekkürler yorekok
Semih Özler	Heath Ledger en iyi Joker
JAGUAR GAMING [TR]	V I C T O R Y R O Y A L E
Doktor Sağbırakmayan	Resmen cringelendim bu nasıl içerik arkadaş
Kurşun Edits	Sex
Ensar Togru	Yengen HARMAN karşimm
Ahmet Şergi	Abi onlar da seni bi ara post42 de ağırlasınlar bence
Just in	Konsept güzelmiş
Egekaan Genan	Bu kadar ilgi orospusu dolu olan ülkemizde tiktok videoları az bile
Rotinda Varol	Yorekok burnun çok güzel
Argonot Ahtapotu	Yorekok batesmotelpro educatedear kamusal mizah bi tarafa olsun geri kalan bi taraf olsun
coni sins	Soğuk koknation
lil xian	ilk değil
Ebubekir Boz	Bu adamlarin kafalarini yakalamanin verdigi mutlulukla hayata tutunuyorum
Efe Ulukir	meme ler cok komedy ya
Emre Zengin	harika inş devam eder
Yakup Kulakoğlu	Adamın yüzü Wade Willson un mutant yüzüne benziyor bence çok cool
Büşra Nur	Bildirim gelir gelmez videoyu izlemek 😂🙌
DarkRider 95	2009
Çağdaş A	post 42ye konuk olarak gelicek rez alın
Furkan SAĞLAMKAYA	3 57 SDVCJCİJCİJCMCKFKDD
Gellert Grindelwald	Bir dahakine eski aburcuburlardan bahsedelim
Erdem Colak	YENGEN HARMAN OLDU KOZ GETIR
SolTık Oyun	Ulan canım popayes çekti
demo121 bomb109	şu anki türkiyedeki ben Lets talk about political stuff
Rhemp	5 37 Müzik sesinden ne olduğunu anladım xd
Gray-Wolf	Aynı uygulamayı kullanmamıza rağmen millet bu kadar sikik içerikleri nasıl buluyor anlamıyorum Yani ne kadar aptal içerik varsa bu tür eleştiri kanallarından vaar olduklarını öğreniyorum Biri gider çokomelin içine yatar diğeri ötekine boks maçında meydan okur bir başkası cinsel içerikli video başlığı atar Sonra arkadaşlar arasında Hacı senin instagram facebook twitter var mı ben de yok kullanmıyorum deyince Arkadaşlarım bana sigaraya hiç başlamamış bir adama söylenen şu klasik sözü söylerler İyi iyi hiç başlama zaten Bi sikime yaradığı yok
Crowley	Eric Andre
idunelmasi 1	Ovv Between 2 Ferns havası var ama ağır değil sırıtmıyor İyiymiş nomoreyoutuber
A E G	Çok iyiydi teşekkürler
MrRobot temsili hesabı	Ğardeşim Yengen kurudu yengen harman oldu qARDEŞİMM sERİ qÖZ Qetir hemen
Serkan	Boğaçın sesi çok kötü geliyor
emin köpekleri	my lady ha been dried
Alfredo Kalınski	5 37 2 girl 1 cup
Moth	5 39 müziği nerde duysam tanırım anasını siktimin 2 girl 1 cup ı
Teoman Toplu	Two girl one cup a dis
Səməndər Səfərli	Ağzımla işitdiğim için hayatım eskisi gibi
ekrem badem	vay kankam közlüyosun gene milleti 3
Can Akusta	educatedear ♥️ yorekok
Hoshi's Bajinia	Babakok yine çılgın içeriklerle geliyor ÇOK SEVİYORUM ŞU ADAMI DJLDMFŞRŞSALĞDD
Barış Bakoğlu	ne izlediğim hakkında hiçbir fikrim yok ama garip şekilde hoşuma gitti
Arkabi 08	Zaman ne hızlı geçiyor Oysaki lisedeyken educatedear in remixleri ile sınıfta birimizin doğum gününü kutlarken çılgınca dans edip zıplıyorduk
R1NT	noluyo lan
Thatweirdgirlnamed 'Cerensu'	5 47 two girl one cup
Tarık Yetgin	1 video 2 şişko
Gokdeniz Gl	E D U C E Y T U R
Yavuz Selim Çağan	This must continue
kathy catty	Tiktoklandin
Damla Altunbaş	cidden ilerletmeden izlediğim tek youtube türkiye kanalıısın
Bayram Sevinç	BABAKOK
Kazım Ömer Geleş	Canlımıydı yaa
Atahan Akyıldız	Victory Royale şapkan güzelmiş kanka nerden aldın😂
efe bal	yav ders çalışıyidim yayını kaçırmışam yuv djsagnjıkagj D
pcislocked	kumbara patladı ananı sikiyim
Raving Raven	ım fabalous hello tiger chicky face
B E R K L E N D İ N	YOREKOK eric andre
Талха Явуз	L E İ L K G Ö S T E R İ M F A C E
lexus Türkiye Bayiliği	Yorekok Cumhurbaşkanı olsanaaaa olsannaaaa olsanaaa
cool man	The one stop This email ha to do so by turning up It ha an amazing day and the Three main thing I want you are a bit It ha been a long term and a bit of a problem I think the best I think the best of all the time two week go for it to the Crown of a new job and a few minute The list it is not a member fellow or a person who is not a member fellow This is a bit of fun I think it is a great deal şaka la şaka türküm ben
DAĞLAR AÇIK	sa
tugrul	YENGE
Sabri Varal	ooo eric andre show esinlenmeleri hoş
Galerici Aydın	Şişman adam baturaya benziyor
Mustafa Durmuş	renk körü oldum galiba lanet olsun
— ʏᴜᴊɪɴ.	when görmek nargile ben triggered
Dogukan Ozlu	KFC den dört menü söyledim MUKBANG educatedmouth
Metehan	Ortak arkadaşımız olan garip biri ile masada baş başa kalınca ben de educatedear gibi oluyorum
Hüseyin Bülbül	3
Bir İnsan	Sansürlenen video hangi video
Didem Yazı	Selam ece seni seviyorumbdjjd ♡
Bedirhan Yağmur	Between Two Ferns with Zach Galifianakis Türkiye şubesi
Naz.X	Napıyonuz mk
Mavi Kedi	Heichdeck SOKUŞTURAMADIKLARIMIZDANMISINIZ
Enes Karakuş	Muck
Grand Crew	Kok OLD
krak trak	H A R M A N L A N D I N
GUNpo364	52 yorum
Yusuf Berke	YENGEN KURUDU KÖZ GETİR
DermooN	İlber Ortaylı ve Celal Şengör gibisiniz Xd
Lyla Rio	Güldüm
enes tahtallı	Sa
Şamil Duymaç	K F C L E N D İ N
cumhuriyet kızı	Babakok nerdesin yaw gözümüz yollarda kaldı
t MAC	Le mençistır aksanıyla konuşan boğaç beyin cringe faysi
Wejaduke	between to fern esintileriğ
Mamishere	Xdd
Muhammed İkra Aydoğan	YENGEN KURUDU KARDEŞİM KÖZ GETİRRRRRRRRRRRRRRRRRRRRRRRRRR
TheChoosenOne FURKAN DURAN	Sa
Lost Frequencies	Canlı chatten sa
Efe Uyma	KOLA CİPS ALIP GELCEM BABA
Taragay	KALKTI
Teymur Mammadov	Babakok güm güm
Rıdvan İskender	Bu ne olumm
Çağan Taha Gültekin	Chatten yazmayin artik
Sea Nabiyon	Tam da 31 çekip gelmistim tesadüfe bak
Gamer	thinken about köri n stuff
Emre _3775	en sevdiğim adamlar be artık rahat ölebilirim
Gülay Terlemez	Babakok sinirli
Mustafa Perinçek	Sokuşturamadıklarımızdanmısınız
İsimsiz Çekirge	Sa
waffentrager	karşım da iki kelime edebilecekmisin yorekökkkkkkkkk
hamdi avni	Aman tanrım dedim Güneş dünya ve ayın aynı hizaya gelmesi gibi bir şey
Mutant Patates	Hocam Bir Yerimizi Alalım
Yusuf Demir	Rez alalım değerlencek buralar
Task Force GH0ST	Sa
Palzivan	Babakok sinirlendi babakok kızdı ve şuan içimizden geçmeyi planlıyor
Ahmet Taha	The Babakok
Edwards JR	Hele şükür bee
yarrak the çomar bükücü	Babakok sütün çok acı
Enver Öztel	LA 2 SEVDİĞİM ADAM YAN YANA TEZ ZAMAN ÖPÜŞÜRLER UMARIM yazarken aklıma böyle bir görüntü geldi ve kusmaya gidiyorum
Zeynep Nur ÇELTİKÇİ	Bekliyorum yorekok u
atmaca a	NOLUYOR BABALARA GELDİK BABABABABABABABA
Hasan Emir Erdem	SoğuKOK savaş
Furky	Bu ne babakok
KEVİN DURANT	Bekleyenler şimdi gidin Saat 5 de gelirsiniz 😎
YENİ OYUN! !!!	31 kisi bekliyor
Ömer Erşuva Saeyaro Lasctar	Wow yayın demek
Mevlüt Yakar	HESABIN ŞİFRESİNİ UNUTAN AMDİN ONLAYN
Etorameth	SA MORUQQQ
