FaZe Censor	LEAVE A LIKE ON THE VIDEO FOR 10 CUT
ACgaming	So ha Jessica asked for a of your video yet 😂😂
abc	Yanet ha a sweeeeeet as pussy i need that as rn
20 subs with no vids	You guy have yachty tho
Jarel17-	Jessica looking good 😂😂
YCSMELA - Compilations	“ Imma deflate yo as ” 😂
jacob T	I hope ur not trying Doug it might be rough this year 😂😂
902 biking	Nadeshot is the firt OG of esports he s like the babe ruth Jordan or gretzkey of eports soooo many people question and spoke down on him not streaming anymore well nade wa just at a different time in his life if u wan na be rich and be really successful u gotte be a bos a good a content creaters do in money there someone behind the scene calling the shot and making a pieace s of the pie
Don Killuminati	Wow 😂🍉 Jessica Now that wa funny
jsinai67	Damn Censor you suck at COD how the hell are you even a pro gamer There ’ s people that play cod for fun and are actually really good unlike you
Orlando Cabrera	Drakes a fucking dumbass lol
Dawit_K	stop clout chasing
Definx Leynlite	ILoveYou and all that jazz right but i thought FaZe wa all about getting gameplay like Pamajs 24 7 No Cap 100 Montage Level Wharris BRUH
l Thane Krios l	Censor you cool but you kinda trash lol
Meek Zilla	Doug is dick riding Nade so hard straight up offered a percentage of the revenue from the video to Nadeshot But wouldn ’ t give Yanet a penny for the million video they made together 😂 🤣
p3rsp3ctive	Hay where is my 10 cut
Wily Peralta	Ayoooo at this point you have no idea what to upload You re washed
12M Views	Less viewer every time
F.B.I	Yes sir wa it this post right here
LoveLags	What wa with that ricegum intro
Abel Parra	What s wrong with going to college and getting a degree
Anthony Picariello	Honestly Doug this is ridiculous You wouldn ’ t have a many subscriber if it wasn ’ t for all of u fan On behalf of the fan and subscriber I ’ m demanding a cut of your YouTube income I ’ m so sick of you taking the money we made you I will see you in court 😂
Anthony Romero	Dam he suck
Chiva	Nadeshot is LITERALLY THE GOAT
George Kenny	Video start at 2 49
Dest	Censor you can be better than pamaj at sniping i can tell
gumbie7	No fortnite man Can ’ t stand that game anymore
TheBigPalooka	👍
tortillawing tv	offer drake and nade 50 of the revenue but yanet got 0
Kicked Modz	Makes a 11 min video and talk about the title for like 30 second
Team Temper	This guy a fucking rider just cu drake joined 100T lmao tryna get a spot on 100T now guy forgot his root in FaZe
Angel Ronquillo	imma deflate your as 😂😂
Rhys Attenborough	“ Imma deflate your as ”
Conceptz S z n	Keep grinding bro
Pyrex TV	100 bullshit drake didnt join nades team it wa just for view
Reckless	I will deflate your as
Abdulaziz CoZMo	That fuck yard Fousey been lying about meeting Drake and shit our boy nade the nerd is partnering with Drake been co owner of the same huge successful team
BlueRoshes LC3	What s the song in the intro
Smozhyy	Give me the scuf pls
Enigma	kd joining next
Hillary Branch	He d rather have a doll instead of a real woman i feel bad for you but your just a weird guy
Wii Fit	This just go to show that money is all you need to get anywhere no matter how much you suck at shit
Rob Antico	Fouseytube is cry in a corner somewhere
OG Franchize	Faze need eminem asap
Jacob Meyer	What re you ricegum now with that background music
David Cash	W
Chuck	Yo dude it ’ s called the Elgato Cam Link It ’ s specifically made for using a camera like that a a webcam
Sasuke Uchiha	Yo bird crashing into ur house HAVE YOU SEEN THE CONJURINGGGG
Abraham Lozano	Yanet did some brujeria on your as for leaving her lmao Witchcraft She cursed you
Cqlten	I miss optic nadeshot
WildOnes - Stun	Your sen is to low
Willow Death_	Why doe he still have gaze in his name
SLL	100t lol worst team
Dj Smith	Look FouseyTube Drake doe actual know youtubers Just not you
Sergio Aguilar	STOP WITH THE FRONTLINE
imBlahh	Nigga didn ’ t even brush his teeth oof
Mohammed Surur	I actually hate when he doe cod commentary
Anthony Diaz	Came from the stream
Infantry Cola	To all who are cry that he should be with her again It doe not matter what he doe because he determines what he doe with him
Panditch _ZA	Now everybody want to be friend with him😂With Nadeshot
Robert Miller	Dough I wa just watching some more video Dude I ’ m so glad you left her She ’ s definitely a snake
Sabotage Habitz	Wish I could drop out of college Well making money doing something I love
x213ERx	You re worse than a female getting all wet for Drake
Brendan Buckley	Whats more boring a censor vid or an apex vid
Honests	So recently my PlayStation account wa banned I swear on my life if anyone can lend me some money I ll be the happiest person ever I really want to start youtube but now i cant My Twitter is WeLokoDepos I can show you proof Thanks to whoever read this have a great day
Itz Joker	Nadeshot met drake when fousy couldnt lol
Killertip731	Yeet
- Gusmanbro -	You ll need a capture card in your PC to use your camera Doug
TReilly 10	The Canon G7X probably won t work in that way I m probably wrong because I don t own one but the Canon S120 had a HDMI port but it wa for viewing medium not live preview so it wouldn t register with an Elgato or other capture card But idk if it the same with the G7X Please correct me if I m wrong
lallalala lallaa	Only thing i learned from this vid is that you fucking suck at cod mah dude go get Yanet back this isnt worth it
Maryland NWA	I think he forgot to mention the fact he also became the biggest meme in the whole call of duty universe for awhilev
uhmz1212	Nades story is nice but people overlook the fact he won a 400k tournement at the start of his carreer From there he build his brand within an org that had another superstar in scumpi together they grew the scene only nade wa a bit bigger and got all the shoutouts from caster etc Its a great story but people should identify with it by any mean considering most of them dont have 100k to start with Anyway to those pursuing a carreer good luck building your own brand and making your own unique story
EJ Carlisle	Hey censor plz i want the scuff
jason day	For a 60 dollar game you drop your relationship😂😂😂
Joespn	Really like seeing Jessica in the video 🤣
Marylin Hebert	Congratulations your royal pal Jack the Bear and Golden Hair child s book
Tye Morris	100 theives are killing it Meanwhile in csgo Almost non existent Okay maybe not here
Emmanuel C Hernandez	You seem pretty average on this game dude No wonder no one want to pick you up No offense Peace and Love
Ramon	Look getting his dad to fight his ex girlfriend what a loser Still get The L You a walking meme
Fiercart _	Damn the view are going down
Yahshua	Jessica Yanet
TMC_GOON ‘	Work on sniper more you gon na be a god if you practice believe in you all the way
Notorious One	Censor is trash compared to nadeshit
Bruce Wayne	You legit suck at sniping dude Good vid though
Lucien99	I am confused why Faze Censor is giving out a cut of his revenue
KingBob	So is it 25 25 50 to nade or nah
DutyPyro	U mad bro
Jimmy Garcia	W
wip3out	I like this Doug more than the cod pro Doug
Dinesh Gaire	That sloppy kiss at the start wtf
RichtofenMinion	Elgarto cam link
Connor Swift	How is Censor a former pro player but totally average at pub
Derron Harris	Nade will act like something he isn ’ t now 🤦🏽‍♂️😂
Twizz Matta	Wait you stream on twitch How come twitch and not YouTube And hopefully I can win the scuf controller brother it would benefit me so much TeamTwizz FazeUp
bowerinioh	DOUG REACT TO YOUR DADS VIDEO PLEASE
its motive	I actually like the idea of talking about topic of interest such a news Ect for gamers while watching censor playing
Brutal Panda 19	FFs i commented on your 1v1 video saying that Pamaj had on ghost
Zero	Play fortnite
1000 subscribers without videos	Nothing special about drake he s a fucking pedo
ilyes fcb	Faze Drake 💀
suarmar19	I want the scuf
Blitzify	Does drake have dick ride everyone possible
JustFayzn	Hey censor can i get that scuf im broke af to buy new controller and mine is a bit damaged it would be a great help my twitter is whoisfayzn
616Freddie0215	Using this for view lmao
Jonathan Nunez	Lmao Jess cmon I m gon na deflate your as
jahan Skywalker	I ’ m surprised fousytube hasn ’ t claimed that he made the deal between possible a a middle man
arii	What sen doe Doug play on bo 4
Eclipse	NO FORTNITE JUST COD
MARTIR JUAN	Doug is really missing that booty
Daisy Villa	HOW ARE YOU JUST SO SEXY PLAYING 😍😍
RYD	yo love the way you taken these hater and just shitting on em Youl always be a huge inspiration to the cod community for health gameplay and personality
Imraan Adams	Censor having a conjuring situation with the bird
Chantzio	She cruised you
G9YT	Drake and nadeshit in the same title someone ’ s view hungry
Xx_Iphone_xX	Jessica 😂😂😂😂💦
-SPORTY-	Yanet is probably doing witch craft you Go get yourself cleaned boy
Pablo Escobar	Don t play FORTNITE
Emily Ghabbrial	Jou and jesica are so cute ❤️❤️❤️😂
Maurice Rickmann	Next week Eminem will join optic
DOP	use ob and record gameplay together with your camera so you don t need to sync in post
Crevan Gonsalves	Sniping is pretty hard in this game compared to other code U get 1 chanse to pull a shot if u miss reg gun go eat u alive Not to mention 1v2s
Third High Productions	Stoners Peep Out My DANK Content D
daniela afonso	I swear he ain ’ t even good at cod he legit just a reg player
Adam Richley	react to papa censor s video on yanet
zSynq	Wtf Gretchen follows me😂🤣
Antonio Morales	Im going threw the toughest time ever in my life and your vid made me smile
xToxiinzZ	bruh the beginning of your video had me rolling lmfaoooooooo
Hector Rios	Let s gain this grain Doug 💪
Jax Teller	Nadeshot taking fat W s in 2018
Canchola51	Censor made Yanet
Jesus	yanet did witchcraft on censor 😐😐😐😐
G Marv	Like if he should spit at Logan Paul ’ s face
Kevin Gonzalez	Plz pick me KG 690
Yasar Ali	Twice a year
Brian Lin	Raise your sensitivity if you wan na get good at sniping
Lamberto Reyna	Love how you said Lance Stewart 😂
Ashton Brooks	Doggie boy I need that scuff man
dj ortiz	i heard Activision wa clapping Jessica ’ s cheek
Brandon Doan	Play a different game mode once in a while 😆
fredoindacut	more frontnite
Retro Goran	clap
Ariel Star	I m confused Is there some sort of FaZe clan out there There are a lot of YouTubers with the same name out there Why s that so
Hello Internet	Anyone know of any PS4 giveaway I can t afford one with my situation rn I m serious if you know of any please comment them or message me them somehow please
ᴀʟᴇᴊᴏ ひ	My boy nade making big boy move
Joe Torres	Lmao the Jessica skit
Boista	Bird hitting you house is not good
Fortnite Servers suck	Bro stfu your irrelevant stop it
Foreign Crises	Ima deflate your as 🤣🤣🤣🤣🤣🤣
Flexa Ghøst	I wan na see that W collection plz🤗
KINGSLAYER	Started from the bottom now we here
Alexis Durant	you ’ ve already inspired me to live stream just had my first two life today 😍🤟🏻💯
AirmanBubs	NO FUCKING FORTNITE more Black Ops
Kid Cody	Doug the type of guy to show up to go to church in a sleeveless shirt 😂
Jasson Reta	Come on Jessica Ima deflate ya as
Havoc	PLEASE NO FORTNITE
Trokitas Del Valle	More yanet crap 😂
Steezyy Brah	Nadie do you love me
Jor	hahahaha
Alex	That nigga Pamaj left optic only to be replaced by DRAKE 💀
Broken Matt Hardy	Fuck Drake
vl_FearMy_vl soul.	Hey dude
Noah Payne	Watch dark sky
GoldenBoyGamer	Install the driver for the camera Search it on google
leonel lopez	Jessica and yanet are the same bouth of them are plastic tit and as
Alex Carlone	I remember before Doug started YouTube when he wa on sb he wa streaming and rage quit because he lost to optic on octane SnD haha good time I CANT BELIEVE I LOST TO OPTIC
Claudio Cortes	Doug BIGGEST L IN HISTORY
Mista _Mask	Do more vlogs with Jessica
psalm	Damn I think the important thing to take from this is that drake from the business side of thing see the the potential in major league gaming money wise
Rigo Mortis	Heard KD is going to 100 Thieves next season
Beasty Gaming	When the view are down
Z3USKY	Congratulations to the lucky boi or girl who is going to win the scuff controller
Noah Luckey	NO DOUG NOOOOOOOOO NO FORTNUT
Jose Hernandez	Yo censor you used a word that I use all the time I ’ m gon na need double the cut off this video 🤔
twitch.tv/Wolfieee	oh no doug use dark mode on twitter
LoganCAD	L video
sTrIkE_BacK gAMiNG	buy the elgato cam link
Brexker .-	I fucking love Doug after the yanet honesty video
Mr. Juicyyy	React to yanet fap comp
FLIPPIN CAMPER!	Faze pito
Haz x	Can already tell Jessica ha a better personality than yanet she seems super chill
cmac brown	Lmao love the dig at yanet with the revenue joke
Blackhawk Baller	Like if they fucked sniping in this game👍🏼
haydn coxy	More yanet crap bit disrespectful
AlexPlayZ	I still wishing i can win so i can stream more on yt cod and alot of fortnite Wish me luck
Matt Brady	You should join 100T
ToCa Strulk	I have some question about the 1 year supply of free gfuel you can get in the giveaway Can you also get free gfuel apparel with it And is the shipping free a well pls someone respond and help before the giveaway end thx
Day Night	You keep reinventing yourself new funny video you are a very talented guy great job keep up the good work 👍
Mohammad-Abbas Ahmadi	Few year later on Black Ops 6 Censor v Pamaj no ghost on check radar on check game face check 3 2 1 go few moment later Censor still loses to Pamaj
winston churchill	why not just turn youtube revenue off for this video
Jose Perez	i want the scuf dog S1ckcess
Dominic Carrillo	I personally like the other camera angle better
FitGamer	Get the elgato camera adapter instant feed
Riva5 Gaming	Bro when you say peace it sound like paste or pace
Why You Bully Me	W
Rusty Shackleford	Word on the street is Doug ha very bad body odor a friend worksout at his gym 🤢
v King v	I see u with gretch😏
UDon'tNeedTo Know	1v1 pamaj
Emanuel Alvarado	Doug can you see my dm on Instagram official emmanuel
Zeerak Shaikh	A ricegum intro
Eternal Exquisite	I love the intro More of that
ThaInfamousONE	My boie Faze Censor is back Taking Ws everyday he get out of bed now GET USED TO IT
CLaUDsTer HD	You and nade are my favourite pro player teaming up would be sick
iFru	Your dad completely flaned yanet lmao
martin hernandez	W
Stormi Deanda	Love you Doug ❤️❤️😍😍😍😍
bohnj	😂 Someone s salty
Weque Official	My inspiration
keil festin	Censor you shit Dump his gf and got kicked No he s beating in a sex doll Lol
Jonathan Noorollah	Do a video of you and Jessica having sex like if you agree
Garshmel	Papa censor going off boii
Paul Okogbenin	What Fousey couldn t do lol
David Sykes	Quit college to become a professional Call of Duty player holy fuck wa that a huge L
Krihpt	I want to win the scuff please I need it I play with a standard old ps4 controller on pc and it feel bad
AR	Drake a bitch
Venom	Live streaming 10 12 am a in a 2hr live stream or a in a 12 hr live stream
xboxornaw	Congrats on 2 6 million sub
michael hernandez	You wish Yanet wa that doll lol
Ban Foxsin	Nadeshot wa more of a dad to you then my biological father
Arnaldo Marte	I ’ m going to deflate your as
1000 subs no videos	Sit yo as down and eat a cheeseburger
MrRonaldo1017	Bro😂😂😂 You ’ re childish for that intro hahaha
Ehram Subhan	Plz stop the overplayed background music ahhhh
Basketball Player	Nade is going to end up running eSports it s in such an early state where money will be able to buy all of the top player in all esports not to mention Nade ha the best team house and the most clout now with Drake and Scooter
lorena suarez	im still waiting for elon musk to be on COD 4 or fortnite lol
Omar Hernandez	Doug you should go pro on gear of war At last try it Doug n
Angel Breezy	💯💯💯💯💯💯💯💯💯💯💪🏽💪🏽💪🏽💪🏽💪🏽💪🏽
215 Dan	Plz no fortnite
CHUCKY _903	Broooo Let Me Get That Scuf 🙏😭 TAKEMONEYLOS
Joseph Fraire	STREAM FORTNITE BUDDY Call of duty Ur sick asf
Santiago Garcia	Bruh you broke a latin girl heart she put a hex on you 🤦🏽‍♂️ smh real shit your cursed my man
MotoStache	Great fucking vid my man old censor is back
Reece Edwards	U should play some wager with some pro would love to see it
DiamondCaliGamer	Get yourself a Jessica she wont leave you or want your money
Marvin Martinez	Drop faze and go to 100 theives
Chris-T	We NEED more FORTNITE vids
VGwas	1v1 vid plz
Enrique Ramirez	😘😅👍🏻🤔💗❤️😎
sebastian murillo	like if Jessica is hot asf
Sebastian Gonzales	Spooky
HAzE	Im still waiting on the scuff 🤝 Twitter xHernandez 702
FirstnameLastname is a dingus	Is Lil Yatchy even in Faze
Kallacolin	reaaaaaallly out of idea arent ya doug
Mr-Silver	Juanito clapping them Cheeks
Cynphol	SAVGRETCH
MrCapochannel	Doug are you and jessica in an open relationship A bird crashing into your window Your as is about to get possessed
WarriorPride _	Fortnite suck ball
Nate Francis	NO No fortnite
MasterofKing	Can I have the scuf I don ’ t wan na seem like I ’ m begging but yeah
Andious	Get yourself an Elgato Cam Link Doug you can use any SLR with an output a a webcam for your PC great piece of kit
Sir mota	U broke
EpicAndy Roo	I know u fuckin that doll censor
Anthony Romzek	I loved the skit
blake joes	ilove jessica hahaha
David Beltran	He didnt brush his teeth
TheCoolj1212	We have now infiltrated the rank of mainstream medium Be ready boy the takeover is soon to come
vR Kiwi	Also Valk joined too
Alpha MKII	So when is Juice Wrld joining FaZe
YouTube Brackets	if I get 400 sub today I ll eat a dozen raw egg for tomorrow s vid only 17 to go ily all
Cristobal	Hey guy Faze Censor told me to tell you guy that he is currently working on a new project with gymshark hence why he won t be uploading tomorrow I m currently with him now preparing a protein shake for him
Rob Soltysiak	Nadeshot look like an opossum
Manchester Is Blue	Keep the uploads coming Doug love the cod video btw
MyLife MyChoices	OMG 😮 let make a video about it upload it on YouTube get view and get paid
Thunda Powa	Leave faze join 100T
Josh S	Call Fousey he s cry
Xtra Cloudy	Nadeshot team is trash
valhr	Stop uploading shit content
Valentino Chavez	Drakes a shnaaake
Cool Nasty	Nah faze is chillin You guy got juju uglygod and lil yachty
ThatGUY Smitteh	My God Gretch made into your video
Jonathan Velez	I want that scuf Man
NichE Basc	Were all in school when you ’ re gon na slice streamjng
Not Mia	Lol
K.M.D. 78	Pusha T been handing Drake L s all summer I thought you were done with them L s Censor lol
Jenko J	Such a gimp
Aserrr	you and nade are the most professional people in the community mad respect for you and nade
Junior Olea	JOIN 100T ITS TIME TO LET FAZE GO
Al Ashkenaz	Nadeshot making MOVES
White Emerald_	Am I the only one who isn t attracted to Yanet Garcia Her body is hot but I m not attracted to her face and her face turn me off Sorry And yes I m hella fugly too Lawls
Baldo Granados	Loving the new direction Doug
DUBSTEP _OH	Wadu hek
sunsbookishgamesx	This ha to be a fucking joke
Kumayl	gterch bouta be poppin
kayla Wheeler`	Im a beginner go see my first video lol
Sadiqul Chowdhury	Unfortunately you cant join the team brother
Source M	Drake is 100 gon na use nadeshot for for view smh it ’ s a joke
Mandy S	doe teawap edit your video btw love u💞
Oscar Flores	That background music ain ’ t it Chief
Obey my Sauce	Who else yawned when he yawned
Danny Rad	Sold his soul for fame and call of duty bruh
I Polaris I	These shitty server stopped me getting a 40 bomb on tdm I wa on 39 fkin kill at 67 to u and the game disconnected everyone
Tony Lopez	Janet did some witchcraft to u son watch out
JayyTB	Gretchen is at 00 30 thank me later
Pierre Piper	Keeping that head up wish I could meet you bro
Zachary Iacona	legend ha it Doug heart your comment if you are early enough
zGNTX	Gretchen is a baddie tho fr
Xavier Hughes	More fortnite
Rogue Panda	Imma deflate yo ass😂
fla gatortown	Juanito and yanet are on the van convoy on it way to the USA MEXICO border damn that s messed up and im mexican😂
Chris	Lmao “ weird ” you killed him to win the tournament in 2015
xStroKeXz	Censor ur cod career is over why did u leave Garcia
viatic writer647	More bo4
ShyguyMLG	Hope you brushed your teeth
Toxic Ghost	I fw the rice gum intro
JOG	You should ve kept the one night background music I hate the stupid EDM techno gay music
TBE2808	imma inflate yo as
Jeshua Jones	Censor is the goat
TTV_ BTW	Like if censor is the biggest L of the century 😂🤔
Oses	Get an elgato camera link 70 buck usb it should pop up into ob
HeffyMatrix	Hey Doug You should 1v1 me with the ICR one day
Regina Scott	You and Jessica did make me laugh
ItzAlom	You should of joined nadeshots team when u had the chance
OG Schump	remember when nickmercs and nade started arguing 😂 “ i got 30 k view you got 3 ” L O L nade will always be more successful than nick
Lumos	Hi doug
tim tale	ohhh more yanet crapp LMAO
Vinstarr	get the elgato cam link it allows for you to use a digital camera a a webcam and connect it to your pc hope you found this helpful bro
RaGeNightz	Refreshing to see this type of content again from a faze member
Modded Account	I want a scuff ☹️
Kenneth 20'	I wa waiting for your reaction 😂👀👊🏽
LiioHeavyMoney	Yanet put a curse on you 🤦🏻‍♂️
KaptainBasketball	That s crazy
- -	im pretty sure you cant use a g7x a a webcam but you can use Canon s eos digital SLR and eos M camera
Brady	Doug taking mad W ’ s 👍🏽
MakaveliThaSavage	Doug look like the type of guy who ’ s jacked af but can ’ t fight for shit
Adam Ramirez	Kendrick Drake
Tropical Breezi	REACTING TO FAZE CENSOR LEAVING YANET GARCIA FOR COD in the hood
RussiaBot #62816451	When a rapper ha more of a cod career than an actual player
Amazing_ Adrian	Doing good on the daily uploads Keep it up
FACTS DON’T CARE ABOUT YOUR FEELINGS	CENSOR walking W
Don't Read My Picture	Guild war and the one that wa a good thing for a bit Don t Read My Name Btw
Moe 590	Drake is just topping up his clout tbh no big artist today clout chase like him
LouiKey	They replaced pamaj for drake lol
OF Carnitaz	0 08 ummm is that a sex doll 😂
Bynx	This is huge for esports
BLACKx BIRDxx	Fuck you and fuck faze
Bzilla	brightens my shitty day when I watch Censor s video
LapisGoBlue	Jessica s name should have been collister or codister Something cod related
Zubaer Chaudhari	FaZe Censor hi
Niks919 Gaming	bro papa censor went insane you need to cool him down somehow jeez
Sachman Gill	Hes not really joining nadeshots team Hes co owning it lmao
Pedro Rendon	JESSICA JAJAJAJAJAJAJAJAJAJAJAJAJA
Will Tisdale	Fuck drake who is Gretchen
Bobby Jones	Wow 2 view and 15 comment smh 😲
AliV3 CSGOVideos	Jessica actually looked pretty sexy
ObeyRyan	This is Doug 🙎🏻‍♂️ 👕 👖 He ha 0 material 1 Like 1 Material P S I ’ m so close to 10k👀
Tommy	Nade and Drake ain ’ t gon na let you on the pro team Stop sucking their dick
Steven Farinella	hen in the Course of human event it becomes necessary for one people to dissolve the political band which have connected them with another and to assume among the power of the earth the separate and equal station to which the Laws of Nature and of Nature s God entitle them a decent respect to the opinion of mankind requires that they should declare the cause which impel them to the separation We hold these truth to be self evident that all men are created equal that they are endowed by their Creator with certain unalienable Rights that among these are Life Liberty and the pursuit of Happiness — That to secure these right Governments are instituted among Men deriving their just power from the consent of the governed — That whenever any Form of Government becomes destructive of these end it is the Right of the People to alter or to abolish it and to institute new Government laying it foundation on such principle and organizing it power in such form a to them shall seem most likely to effect their Safety and Happiness Prudence indeed will dictate that Governments long established should not be changed for light and transient cause and accordingly all experience hath shewn that mankind are more disposed to suffer while evil are sufferable than to right themselves by abolishing the form to which they are accustomed But when a long train of abuse and usurpation pursuing invariably the same Object evinces a design to reduce them under absolute Despotism it is their right it is their duty to throw off such Government and to provide new Guards for their future security — Such ha been the patient sufferance of these Colonies and such is now the necessity which constrains them to alter their former Systems of Government The history of the present King of Great Britain is a history of repeated injury and usurpation all having in direct object the establishment of an absolute Tyranny over these States To prove this let Facts be submitted to a candid world He ha refused his Assent to Laws the most wholesome and necessary for the public good He ha forbidden his Governors to pas Laws of immediate and pressing importance unless suspended in their operation till his Assent should be obtained and when so suspended he ha utterly neglected to attend to them He ha refused to pas other Laws for the accommodation of large district of people unless those people would relinquish the right of Representation in the Legislature a right inestimable to them and formidable to tyrant only He ha called together legislative body at place unusual uncomfortable and distant from the depository of their Public Records for the sole purpose of fatiguing them into compliance with his measure He ha dissolved Representative Houses repeatedly for opposing with manly firmness his invasion on the right of the people He ha refused for a long time after such dissolution to cause others to be elected whereby the Legislative Powers incapable of Annihilation have returned to the People at large for their exercise the State remaining in the mean time exposed to all the danger of invasion from without and convulsion within He ha endeavoured to prevent the population of these States for that purpose obstructing the Laws for Naturalization of Foreigners refusing to pas others to encourage their migration hither and raising the condition of new Appropriations of Lands He ha obstructed the Administration of Justice by refusing his Assent to Laws for establishing Judiciary Powers He ha made Judges dependent on his Will alone for the tenure of their office and the amount and payment of their salary He ha erected a multitude of New Offices and sent hither swarm of Officers to harass our people and eat out their substance He ha kept among u in time of peace Standing Armies without the Consent of our legislature He ha affected to render the Military independent of and superior to the Civil Power He ha combined with others to subject u to a jurisdiction foreign to our constitution and unacknowledged by our law giving his Assent to their Acts of pretended Legislation For quartering large body of armed troop among u For protecting them by a mock Trial from punishment for any Murders which they should commit on the Inhabitants of these States For cutting off our Trade with all part of the world For imposing Taxes on u without our Consent For depriving u in many case of the benefit of Trial by Jury For transporting u beyond Seas to be tried for pretended offence For abolishing the free System of English Laws in a neighbouring Province establishing therein an Arbitrary government and enlarging it Boundaries so a to render it at once an example and fit instrument for introducing the same absolute rule into these Colonies For taking away our Charters abolishing our most valuable Laws and altering fundamentally the Forms of our Governments For suspending our own Legislatures and declaring themselves invested with power to legislate for u in all case whatsoever He ha abdicated Government here by declaring u out of his Protection and waging War against u He ha plundered our sea ravaged our coast burnt our town and destroyed the life of our people He is at this time transporting large Armies of foreign Mercenaries to compleat the work of death desolation and tyranny already begun with circumstance of Cruelty Perfidy scarcely paralleled in the most barbarous age and totally unworthy the Head of a civilized nation He ha constrained our fellow Citizens taken Captive on the high Seas to bear Arms against their Country to become the executioner of their friend and Brethren or to fall themselves by their Hands He ha excited domestic insurrection amongst u and ha endeavoured to bring on the inhabitant of our frontier the merciless Indian Savages whose known rule of warfare is an undistinguished destruction of all age sex and condition In every stage of these Oppressions We have Petitioned for Redress in the most humble term Our repeated Petitions have been answered only by repeated injury A Prince whose character is thus marked by every act which may define a Tyrant is unfit to be the ruler of a free people Nor have We been wanting in attention to our British brother We have warned them from time to time of attempt by their legislature to extend an unwarrantable jurisdiction over u We have reminded them of the circumstance of our emigration and settlement here We have appealed to their native justice and magnanimity and we have conjured them by the tie of our common kindred to disavow these usurpation which would inevitably interrupt our connection and correspondence They too have been deaf to the voice of justice and of consanguinity We must therefore acquiesce in the necessity which denounces our Separation and hold them a we hold the rest of mankind Enemies in War in Peace Friends We therefore the Representatives of the united States of America in General Congress Assembled appealing to the Supreme Judge of the world for the rectitude of our intention do in the Name and by Authority of the good People of these Colonies solemnly publish and declare That these united Colonies are and of Right ought to be Free and Independent States that they are Absolved from all Allegiance to the British Crown and that all political connection between them and the State of Great Britain is and ought to be totally dissolved and that a Free and Independent States they have full Power to levy War conclude Peace contract Alliances establish Commerce and to do all other Acts and Things which Independent States may of right do — And for the support of this Declaration with a firm reliance on the protection of Divine Providence we mutually pledge to each other our Lives our Fortunes and our sacred Honor
Vykh	Let me get a cut of the revenue I ’ m a subscriber
Matrix	Let me know if my biceps get in the way
its Bodak	360p 😷
Ali Hussain	Censor is actually hilarious
MrSweatz	WATCH MY LATEST VIDEO FORTNITE LEDGE GLITCH
DragonicSupreme	“ i ’ m gon na deflate your as ” 😂😂😂
Achraf TV	360p gang 🔥❤
lil GOAT	Jessica is way better than yanet garcia u know why She doesnt talk back 😁 lady take note 😏 jessica is a W
Mario Vazquez	Second
Djjddj Jdjd	Fuck yanet bro I have been I long fan n just wanted to ask u about apathy ’ s war machine play
Rayyan Ahmed	Doug
xSweatySoulzx	I love your video ❤️
Alberto Pina	Wtf 2 view 15 comment
Papa Censor	Loving the vids Son
Julian Franco	Drake probs gon na use him like ninja
Lqkers UHC	imagine breaking up for a hot as girl to play a game that ur shit at
Nick LaBar	He might a well have pissed on fousey
STY THE GUY	Jessica looking good Censor really turning into a walking W
1000 subs without Vids	Kiki do you
Young King	Oh yea
Diamond Gaming	Love your video bro❤️
Blanco Tv	Hey
Cathy Davis1610	First
A L O N E L U V E R	Please heart me jev
BigDaddyD	Ay doug it ’ s JuicyDawson from the stream Love the vids bro keep grinding 🤘🏻
AileenVlogs	Sub me
Isaac Dooley	1 veiw
Hero _BSB	2nd
FishAhoy	Hi
Bruizey	Ya
Juan Garcia	Hi
ShawnsBeats	Who love Faze Censor
5,000 SUBS WITHOUT ANY VIDEOS?	What platform do you guy play on cod Like for Console Comment for PC
Tasir Ahmed	First
Austin Sylvester	SEcond
Foxeys	FIRST
