neki0 playz	So if japan is a u allie dosent that meen that there still under occupation
bandhsilvers1	15 men u call that a army that s a fucking joke ain t it
toonmag50	Kwai did the British army do this
Gio_Falcone	That s a great news
trancehi	I read that after Brexit we English will obviously have a new passport and thus we will be fast tracked through border control here over Europeans however the article stated that the Japanese will also be in the same queue a u along with Americans Canadians and Australians All those country are welcome here a far a I m concerned
hancock63	That base commander should make an ASMR video
unitedkingdom offiveeyes	And in other news male British soldier are allowed to wear earings show of man bun and have tattoo on their hand Oh and female can apply for ANY role in the army
Evans Lin	日英第二次同盟 🇯🇵🇬🇧 British and Japan Forever
Eric Wong	British female troop I heard Japan is famous to experience calamary Jap troop Yes you get undress and we put many octopus on your body
Chiyoko	No big deal
Hussain C	With well trained soldier and anime nothing can stop our country Our men will go Super Saiyan on the battle field
six2make4	Soldier return home to his wife Sorry hun I ve found new true and pure love Shows his body pillow of anime waifu and walk away
George Luo	0 46 Japan ha recently reported the longest period of economic growth in more than two decade You serious about that
Kong Thai	British power remains preeminent globally Impressive Rule Britannia
Christian John Cid	Japan ha gundam and zolds
KASHMAR SUICIDE	they will spread the cancer from the uk to jp poor guy
Patrick Moon	Sledge Thatcher Mute and Smoke collab with Hibana and Echo R6 siege baby
Jeff Song	The Japanese attempt to relaxing the legal restriction and the subsequent military buildup is actually supervised by the US who want Japan to take a proactive role in counterbalancing the rise of China in the decade to come The threat of North Korea is a convenient element for Japan to divert the unnecessary attention and the backlash from China for doing what Japan is doing North Korea a much a the conventional medium want to paint it a a significant threat do not stand for any chance of survival had the war broken out If you are building your muscle to beat up the biggest boy in the playground you don t want him to think that Instead you pick on the little guy and say That little guy buck the hell out of me not you big guy A classic maneuver I d say
Not Me	When i see japan i see logan paul
Y Y	I think that British English is easily to listen for japanese
Habel Buas	I bet british army now have banzai charge tactic in their army stratergy
平康	Britain and Japan working a ally definitely bring great benefit a we ’ re like minded people that cherish free trade and democracy It ’ s natural for u to work together to protect each other ’ s national interest at this modern world
Jepoy Quijano	Japan have the best soldier Kenshin Himura
Shoukanju 04	Lelouch Vi Britannia is happy right now 3
*Eternal Suffering*	We Canadians need to get over the japan for some training good guy over there
Cain Arathoon	Well at least they forgot about the Black Christmas event
Sherlock Investigates Japan	My home country and the country I now call my home working together This is what global sharing communication and trade is all about
andrew christie	The size of Britain ’ s army is ridiculously inadequate How on Earth ha our government managed to convince the British people that this is ok nothing to see here were not degrading our defence at all
New England	Weeaboos giving up a being Weeaboos
Scott Conner	Man the US military make both the Japanese and the British military s look like baby Hopefully post Brexit Britain can rebuild it military a it not got the capability to defend it self let along japan
Will Yu	this is all a tactic to get to russia and china
Robs	Surely you mean Elevens not Japanese All hail Britannia
Warsame	2 39 That is racist
Orange Pekoe Of St. Gloriana College	This is just a excuse to Colonise them without them knowing
Random Person On The Internet	Japan should ve never attacked china or America RIP those who were killed by the bomb But then again if they didn t attack anyone they would ve attacked someone down the line anyways
Violette Summer	disappointed no Katana or Shuriken for them for cqc
tkt tnk	Yessssssss I m Japanese and I Iove UK so much We are same island country Anglo Japanese alliance again
Aiman Hafeez	0 31 geez how to pronounce her name
Pencak Silat	Malaysian Army is the best in Asia👍👍 I love our Army
Janssen Tan	Enemies during 2nd world war
ZHER0	hail lelouuch all hail ZERO
patrick Katalenas	ah japan the best country currently in the world imagine if the military didnt take over the government pushed for expansionism and extremely brutal action instead maintain it constitutional government
GodBlessYou2008	She sound very similar to the woman at CONTROL in Rainbow Six 3 Raven Shield
Marc	Going to get NUKED the 3rd Yeet
Harry	Tell me why doe the British army have it policy directed by the Muslim council of Britain isn t there supposed to be a separation of State and Mosque You take soldier to land to be killed arguably to assist in establishing democracy in the Middle East and again hypothetically to dethrone theocratic despot and then you throw a British man with no other disciplinary problem out of the army because he took a photo with someone whose politics you don t agree with tell me again why the Muslim council of Britain dictate UK army policy in a secular state The same UK Muslim council which the government disassociated itself from in 2009 for it extremist view Sick
LAKA LAKA	東京に行っとうきょう〜
Kenneth Killeen	Imagine the two loser of the war are the most economically successful and brilliant engineering nation
The Wolfy	thousand of thousand killed more like a couple of million
NPC#1911-EGUK	Awesome IAmSoldierX
ヨルムンガンドyw	サムネの左側の人野獣先輩に激似で草。
Geoffrey Bronson	Two Imperial island nation with a tendency to irritate their neighbour and strange sens of humour The UK and Japan seem almost made for each other Much love from England
Zero6Bravo	It s about bloody time
DreamedMemes	Solider IT BURNS Medic Tell me where the wound is Solider No the weather
Yokitomodati	I can t understand why they strengthen their military relationship Their word were too abstract and incomprehensible for me
LuverSin	britain is doing good for this but not it socialist reform
ian jones	GREAT VID O7
The Leestar	God bless Japan and her ally I hope we can be friend for eternity
sato toshi	3 58 Utawarerumono new
Jack Scott	Britain and Japan rest of world
ZeroSupremacyYT	Compare all the country who are bigger and have a lot more people in their country s to the UK is just unfair We make up for that with experience and skill Look at the SAS SBS Pathfinders and Royal marine commando Some of the best trained it the world
samuel colt	Over the hill and far away now to Japan welcome to my country
Tom Hulme	As an Englishman i regard the japanese along with the uk a the greatest country on earth i have much respect for their culture
wtf is humour	More anime
huyton traveller	I can t imagine my grandad being very impressed he wa all for forgiving but just couldn t forgive the Japanese which wa his own choice
Alika Cripe	NIPPON BANZAI
Andrew Ngo	Japan just a puppet been like that after world war 2 and before that even the emperor of Japan wasn t the true ruler and had very little control to stop the war and the barbaric behavior of the Japanese military
The Doc	couldn t you have gotten a translator to ask question to the local seriously it like asking people in the UK to speak Spanish for an interview your answer aren t going to be clear
Edgy Cat	Banzaiiiiiiiiii
Sezar Dd	It seems to me that the time ha come for the United States to pull out of Japan and let Japan decide for itself I think we all know that the greatest danger to any country is the United States itself Why Because America is always thinking of it own interest rather than the rest
tamago tamago	日英同盟か懐かしいのう 日英共にロシアを倒したあの頃が
aclock2	Having foreign army stay permanently in your land is the sign of being a little bitch They could overthrow your Government in a matter of hour if they felt like it So every political decision you make with them you have to make with the mindset that they have an army in your land
北山怜央	富国強兵や
h s	自衛隊がL85を借りてる☆
Team Magma's Maxie	Though they are Philippines lol
Andy D	The Japanese are racist LOL 2 39
Samuel Gurung	British army have gurkha
joe8075	UK want another Asian operational enclave for the Ghurka Brigade
indeed	ah Australia also doe exercise with Japan
Successful heart	Tell me that you guy are making a military base in Japan
World President Putin	Operation Manga schoolgirl
atsp18	Anglo Japanese Alliance again
Pierre S	3 54 cool shot
Steeljaw XXI	This is a really good thing Both the UK and Japan suffer from the same restriction of them being small Island power house While the threat they face will be different I feel some of the strategy technique and technology that work for one will work for the other As neither can amass million personnel army nor can they supply them for long having shared and proven tactic for protection will be key for their survival IMHO Not saying both nation need armed force great enough to become invasive element to their neighbor but increasing their defense against growing threat is not a bad thing
Dueng Design	The 2 country where car driven on the left side LOL
cheowyong lee	british have forgotten how the japanese defeated them
Eric Mowrey	North Korea could have a military four time the size of Japan but until it ha a viable blue water navy North Korea remains an empty threat China is the real threat with ever growing power projection capability including the ever expanding amphibious attack vessel fleet If China manages to build two additional aircraft carrier it may signal the beginning of serious concern
EoTech 553	🇯🇵🤝🇬🇧⚔️🇰🇵
ali Al sahhaf	I expected something better than this 🤔
No Name	The MOD is appearing a little fascist lately
ForAmerican	Make sure they learn how to use the chopstick and Morning Radio exercise like the Toyota factory
绍兴周氏Fuhan	Brats are trying desperately to be relevant
Fetaiai Uta	Still waiting for Japan to build Gundams and take over the world
Adam Tib	Knights and samurai not a bad combo
Daryl Solis	17 40 Sergeant Slick Hair Style
The_Satisfied_ EightBall	17 00 I wa at Yokota Airbase doing Track and Field lol
zzzzzsleeping	When the fight heated up none of these force UK Japan france China Russia can match a country that are battle hardened in the jungle or rain forest And who are they Thailand Vietnam Indonesia Philippines You can have all the bomb you have but if you don t have boot on the jungle ground you are nothing
オフロスキー	サムネの左の人先輩
youngsta Young	Back to training for traditional warfare conventional warfare With China Russia Matter of time They need to change to defence china building island that are nothing but military base China Russia are the agressors
San Arturo	more like British Army train Japanese Army in English lesson
SENANDUNG SURALAYA MALAYSIA REBORN!	Tenno Heika Banzai
Cutie Marxist	TENNO HEIKA BANZAI
User name	Where s the giant robot
Hulagu Mongke	How ironic In WW2 IJN sunk 22 British warship unsinkable Hermes Prince of Wales Repulse and 100 American warship included best fleet of Lexington Wasps Arizona and massacred allied POW And now they re Friendly Nations or Anglo Saxon Norman French simply want to dominated the global trade the same way British French dominated the Suez Canal in middle east back in the 60 s Used Japanese a a tool
SR71ABCD - BETA TYSON	Japan ha Godzilla send him to China to stop all this
Simon says:	Im so happy Japan is starting to expand it s military even with their constitution restriction
Eri Silvester	jajaja jajaja jajaja jajaja you lous
Alvin chang	Bring back the British Japanese Alliance lol
I agree	13 46 おいおい、イギリスの国旗が逆じゃねーか。しっかりしろよ日本。適当だなー。 「おもてなし」って口で言うのは結構だけど、行動でしっかり示さないと。
RmacNet	Forces TV video and Russian Bots go hand in hand
jay dubbs	Warmongers
Dura Keith	Japan UK alliance 🇯🇵🇬🇧
Dr. Conflict	This is a good thing The Japanese are by far the strongest ally in the East
Leonard Wong	Brits are tough Good to see them in japan
Brian James Tobia	so the knight and samurai unite
Birkang Boro	Nice
james ohara	The Japanese soldier behaviour in WW2 wa no accident nor wa it natural they did what they were trained to do but if you train them to fight with a human conscience then they will behave with true world view honor
Weaver	COMPLETELY WRONG ALL THE WAY JAPAN DOES NOT NEED ANY TRAINING AT ALL PERIOD
トメコ	I love UK a one of Japanese
Tyynymyy	North Korea attacking Japan What a joke they barely have the mean to defend themselves without nuclear missile It doesn t matter if the army ha googolplex soldier if they can t be supplied effectively and lack the offensive capability In it s current state North Korea is not a military threat to anyone at least when it come to traditional warfare
ArchesBro	Japanese people dont know English other than the little grammar they learned in school why not use a translator because clearly they are having a hard time responding
Michael Jon	Thanks you United Kingdom Japanese people would like to build a more effective relationship is thought 🇬🇧♡🇯🇵
Jadran Ahlstrom	Japan s first treaty with a foreign power on equal alliance term wa in 1902 with England in the Anglo Japanese alliance It really helped solidify Japan s reputation a a power and it showed the world that Japan joined the world stage and is here to stay This alliance helped improve the Japanese navy until it became 3rd largest in world by 1920 and also win the 1904 1905 war v Russia The alliance soured during the Versailles peace round and eventually the two nation were on opposite side in the second world war Long may the friendship last old vengeance never forgotten but never allowing them to tie u down in the name of progress
トムスT	🇯🇵🤝🇬🇧
Nathan Remix	Waifu awaiting S A S
læzy lozer 2600	It s stupid the atomic bomb get the blame pretty sure the firebombing killed more
Sean Shultze	Train the Brits of how to start a Coup against their Merciless government Its not right for a Soldier leaving his own country get abolished by a puppet Regime And Japan know it
Francis Narciso	Omg it really happen code gease
Fun Update	British Have Gurkha Rifle Never Give UP from NEP🇳🇵
Daniel Alcantarilla	Correct me is I m wrong but did I see Sherman s an M5 s on the Japanese arsenal I would rub my eye to see again Sherman s and M 5 s
Julian Cate	22 minute to talk about 50 British troop who trained a bit in Japan The idea that this need a mini documentary is laughable but even more laughable is the British military Not only doe the UK lack the will to go to war regardless of party in charge but lack the ability to project military power beyond the white cliff
Karl Bauer	Why don t You have an translator
Clee4000	2 island nation working together
eng joo	It s been so long ever since WWII ended but I still don t feel sad for Japan whenever I look into history and saw what the Japanese solider have done in WWII
joe 90	It s all about the Chinese threat
dfpguitar	there is still a culture of admiration of Hitler nazi Germany within Japanese government British govt should be mindful of that I don t think we should ally with a govt that ha taro aso a a minister Same a other fascist leader in Phillipines Burma
DednerxD	2 nuke anime
unknown	Hmm Nice anime
Czecher86	well UK USA
Chris Chen	I m surprised that the British still ha a military force
brian williams	Great to see As an Aussie would love to see our troop train with the Japanese Great people great country even better ally If Japan is attacked by North Korea China etc Our country bloody well better go to their aid
DuckiMucky	11 56 sound like something from sponge bob
200 iq rick and morty fan	For queen and country and anime
Hakuru15	UK is gon na appreciate some anime waifus
alex H	Gate season 3 will be interesting
Antarctica	Imagine playing COD on that simulator
alberich liu	What if Chinese PLA train in Germany？
Above TheCrowd	Two evil empire training together what a coincidence
Travis Lively	Welcome to JAPAN We want second aliance Japan and UK
Captain Right	Yo Japanese soldier I know Japanese are an endangered specie With 40 of your population self reporting that they have never dated and about a 3rd having no interest in sex atall If you want to save your country you d better start breeding a much and a fast a you can A fertility rate of 1 4 is sad In ww2 America dropped 2 nuke on you because of your uniformity in making a harmfull decision Now you are nuking yourself in population because of the same uniformity
Bhum Brahmavira	For you concerned Japanese out there don t be I m rather certain that 1 colonialism is dead in the Imperial family and 2 u Gorkhali drove the point home in 1944 Be more worried about Xi and his greasy finger groping the South China Sea What youse ought to do on your part is bitch slap some sense into the vocal fascist minority Accept your past mistake and allow open discussion That s the only way to prevent this fuck up from repeating itself Shit we fucked up too The turn of the millenia wasn t to pretty in Nepal to say the least Oh well just a youse are always so willing to throw money at u for our infrastructure many individual here are also always willing to persuade a few ultranationalists in your crib Hey you scratched our back a soon a you got off your arse I m certain many retiree in Nepal is more than happy to scratch your ultranationalist ulcer with a metaphorical lance
RR PLAN C	Squarhean lady in red presenter
Kurt H	or in otherwords preparing to defend against a chinese invasion
BrighT L0rd	All hail brittania Nippon Banzai
Phantim3dx	why can t u Yanks have nice thing like intelligent coherent and pragmatic elected official Oh that s right we can t have nice thing because of the derps in office and those who ve made the GOP in place
Chocolat-kun	That reporter name HOW DO YOU PRONOUNCE IT
Adam Scott	1488
Michael Allen	All leave boy your government is against you nothing worth defending
Piper	Japan did alot of evil thing in the war never forget those jap bastard
Shaurya Joshi	They should be training to fight extremist on their street Sigh the UK is a dying country
ShAdOwMaN	Nice
Dr Wellington	Teno hekia banzai
富澤そら	thank you 🇬🇧 ありがとう！新しい日英の始まりだ ﾟ▽ﾟ
Lord Butthole	Welcome to the Jungle
dan forbes	i think not
Clutch	One thing that wa missed when the USAF Col answered Why doe the US have a presence here is the fact that the JSDF wa never designed to stand alone From the beginning it wa designed to be a defensive buffer to last long enough for US coalition force to relieve them
iSE_	13 40 this matter beautiful Queens English We welcome all British Forces and Gordon Ramsay i love how Ramsay talk shit to american food
Matthew Jerousek	I love anime
FANBOY Lets' Plays	British force in Japan Well that s something interesting
no1reallycaresabout2	2 59 They couldnt bother to hire a translator to interview the Japanese passerby The sample is le representative of the population if they only interviewed Japanese people who spoke English Otherwise interesting video
Keith Donald	Surrender what do me world war two over
Snake Plissken	I am sure the British are proud to come to a country where the people come first and not run by politician that support extremist and sharia law
Views 22T	if you can t beat them join them
Bullet-Catcher	IAmSoldierX
Rob Bleeker	Saying that NK ha 1 2 million active soldier doent mean anything We know how out dated their equipment is
Narahiko	British Weeaboos c
John Smith	Ohhh tommy tommy tommy tommy tommy tommy ROBINSON
Chen Lee	Can ’ t possibly the first time the RM were here in Tokyo 2 year ago Friendly football match but still here a an official invitation
CBRMoto	IAmSoldierX
Manu De Man	about those nuke the people killed were mostly woman child and old people a the men were off fighting the effectiveness wa limited a the mostly wooden Japanese city had been fire bombed already many general at the time openly challenged the need to use such a weapon and the end of the war shortly after had more to do with the Russians about to invade Japan than the nuke being dropped or maybe the nuke were used because Russia wa about to invade
Shawn.Kim	STILL no single apology to those country suffered from innocent civilian rape Slaughters during WW II Instead Those ape are building AAS Marine corp which clearly is a system made for invasion Who know They could hit your 6 just like the old day LOL Training with them just to make china calm Funny joke out there You pal should ’ ve done it with ROK Not with those trying to break their leash dreaming their old empire bull s
rainbowsixODST	British Army What army All I saw wa a bunch of demoralized soldier forced to serve a Leftish System who care nothing for them and who can ’ t even utilize the freedom they defend Japan ’ s soldier are more free and open than Britain ’ s I support soldierX
Gaz 00	IAmSoldierX
Kelvin Fong	Britain helped build the imperial Japanese navy It ’ s earliest battleship were built in England Many Japanese naval officer were trained in England Their greatest admiral Togo wa trained at Dartmouth
Jackson Brown	The army blabs on about standing up against fascist then decides to expel someone because they express their opinion irony
The uncomfortable TRUTH	The fact of the matter is that the British Army train our brave young men for combat and once our brave young men have been in combat and end up suffering from PTSD they are thrown out of the Army for a life of homelessness and despair
Lucas Tant	British Japanese what a fusion Nice
Sukacita Yeremia	Where s Chris Broad
GollyKun	I WOULD LOVE TO TRAIN IN JAPAN
Templar Knight	The MOD are DESTROYING our British armed force with political correctness Allowing crack dealing soldier to remain in the army while dismissing those who have the temerity to take a photo with a journalist who is anti Islamic just show the type of people who are in charge a vile
wcatholic1	The Germans have already altered their constitution in order to allow the Bundeswehr to operate beyond German border for example in ISAF The Germans have accepted their role a a major regional power and Japan seems to be doing the same
John Tressine	WOW sending half our front line troop just for a photo opp we will soon be back in the big league
StandSure	Quite interesting to see this not many people know but the British actually freed the Japanese POWs after the war armed them and worked with them to help maintain order in Vietnam and other part of Asia we ve worked with them ever since
chris1117F	Big deal you grit send three ship a few plane 16 soldier and one helicopter That s supposed to be a valuable asset show of force U s ha entire 7th fleet in Japan with a full carrier wing and three assualt carrier and a nuclear powered Carrier and 100 fighter aircraft And 50 000 army and marine in Japan Grow up Britain you re not a global power
liam hawkes	Japanese s favourite part of an english breakfast are bean hahaha wtf
DrPhilFurry	OMG WHERE IS THE DIVERSITY IN TOKYO AND THE JAPANESE ARMY
Malcom Canning	wasn t he called the British tommy shhhhhh robinson
mikeymarmalade	It s a good idea
tentheagle	Alana Partridge
Mr Camoron	The UK should concentrate on it own border and stop pretending it a global empire poking it nose with it 16 soldier and 1 helicopter
Zidaric Helena	lep pozdrav iz slovenije
exactinmidget92	Reporters last name tell me that she is a pole Its just an explosion of letter
Aaron from England	Budget need to be 3
g2macs	I would be ok with the British Army defending Japan if once just once the Emperor stood up and apologised for the Burma Railway Bataan Death march the murder and torture of POW s the list could go on and on
William Warren	north korea ha plastic gun
tommyguntom32	Meanwhile I m china they are secretly making robot to use instead of soldier
Richard Goode	A a good luck a NATO a point to engage or a defence a a engage
Sky Kubo	My great grandfather who wa a British Gurkha infantry riffle man fought with the Japanese imperial army in the Burma ’ s jungle now Myanmar place called impala near India Burma border lost his 3 finger and also lost left side ear in the WWII I heard lot about this chilling British Japanese war story from my grandfather when I wa little super scary story tho but hey those story are history now for me nothing more but for him it wa a bravery honor and never forgetting 🎌❤️🇬🇧
doczg88	Expelling UK soldier over photo with Tommy Robinson What about that
DJJAW11	Good article What s your star sign 🤔😁
Stephen Cockett	Keep an eye on your toe nail and finger nail lad These bloke used to pull out POW s toe and finger nail for a bit of a laugh during their naafi break
Jayden is great	If you are in North Korea it s mandatory to go to the Army wish is not fun some people don t get to the passingout Parade after doing the set year of Duty 💂💂
Daniel Whyatt	Just 15 That s a little disappointing
nowgaku	Glorious Anglo Japanese Alliance again
我是兔子王	in fact japan army is stronger than weak British army The US Army is in Japan to prevent the Japanese army from being too strong Americans do not trust the Japanese hahahao ∩ ∩ o 哈哈
Toffee Abroad	I m surprised the MOD had enough money to fly the British soldier to Japan I wa in a taxi last year in Singapore and the driver had not long finished his national service He told me that he had spent a few week in the UK on a joint training exercise between the British Army and the Singapore Armed Forces The exercise wa originally supposed to take place in Singapore but the British couldn t afford to send their troop or equipment over
Anthony Roic	Train all you want the brit have never known how to fight a force of equal moral technology or military strength Must I remember what the legendary blackadder once said
MC	Sent 15 soldier lol
funkylee2010	Both country come from a strong fighting history born fighter welcome to the future
Levi Liberow	IAMSOLDIERX
Tams80	That question at the press conference wa terribly wordy almost like a speech Also I didn t quite gather wa this training exercise a historic event
dennytenny	Your Brits we re keeping an eye on you If you and your pal the Japanese are planning to invade North Korea you better think again The USA is ready to defend North Korea against all foreign liberal fascist incursion Trump will not allow his best friend Kim to be replaced by liberal fascist South Korean government
mtnmist1	Amend the constitution so the Japanese can militarize What could possibly go wrong
SixSixteen Sevens	Do they get a Hari Kiri knife
John Ashtone	Could people please remember it is 70 year since WWII When I wa at school a friend s father had been in Burma he still had nightmare 25 year after I have never forgotten this But time move on the people today are not their parent or grand parent it is not they we are dealing with And it is how they behave in the modern world and not admitting Muslims who wish to blow them up is hardly a sin In Afghanistan they were superb they were there just doing none military job and back up but still did everything to the best Japanese standard and reliability that you would expect from their electronics and car We are natural ally and were until 1941 and those saying 3 ship and 150 soldier is nothing are just showing how silly they are No other Nation is a highly regarded by the Japanese those saying UK is finished and broke are stupid UK ha 5th largest economy and if we are so broke and finished why are so many people from other Nations so desperate to live here But hey who did let that flag fly a a distress signal at 13 46 lol
bigdmac33	Excellent presentation and interview skill on display Smooth safe diplomatic response flowed forth
Andyb2379	All great everything but we seriously need to look at our own budget Maybe up our active personal
koolyman	2 37 weird target
me him	Stop signing up to fight for the traitor government that have constantly given more and more sovereignty away to EU gastapo Stop going to middle east training jahidi Muslims who then infiltrate into the European country and killing kid It s plain a day they have no bother sacking your life s just for a fucking photo Wtf Let them get the new replacement to do the dirty work stop brit dying for these muppets See how that go
HDaviator	The Japanese should be careful the PC could rub off on them Don t want that
BulletproofKam	They didn t include the uk reserve 35 000 active reserve and over 160 000 ex millitary contracted reserve They included them in the other nation figure Britain ha 210 000 millitary personel they could deploy anywere on earth anytime and the other 160 000 millitary personel they can call back up if needed get your figure right And the Active Uzk reserve if 35 000 are just a well trained a normal soldier l
Phil Staples	Didn t we build them load of warship and effectively train their navy then later a a thank you they starved tortured and worked to death load of our and our ally soldier I can t remember them ever saying sorry for their terrible action either
mitsuru yamashita	To make thing absolutely clear this kind of relation ha made almost for China not North Korea China is the only one country who ha enough power to scare U K who is obviously trying to growth some power themselves in Asia and China is threatening or doing regular imperial stuff I say all over the pacific U K Is also having relation with India kinda though to being British in Asia just like classic British So this seems like big movement but actually is just Japan and U K both are pretty scared of China and trying to scare them a well a possible To cut a long story short nothing ha been changed so far now both island country having a macho friend who were acutely good friend from long time ago
NoahVlogz	Great to see
TheSnakeGaming	UK army ha persecuted it Squaddies for having a selfie with Tommy Robinson Report on that
HOME OF THE SLAVES	Japan is a puppet of America just like Britain
Josh ua	As if a handful of ours would make a difference Rubbish
Kemal	i thought japan didnt have an army
Ernest Lunezi	Us uk australia canada new zealand english the best and the most powerful global power just watch out cause germany france and india it going to betray you in a very shameful way and enemyes are growing now more than ever the west and democratic world it is in danger whith china russia india brasil and ultimately turkey indonesia iran pakistan and france and germany working whith them for money and puttin in danger everything they built in decade cause english speaker country did sacrificed a lot for these two country and especialy for france and betrayed them and for germany literaly fought after the war and free the east germany from russia for the second time that s why you need to increase military budget imediatly Japan the asian bos bravo UK
Zach Okey	When you do a video about how good Germany s economy is don t mention the war 😉👍🏻 lol
Gar	I AM SOLIDER X
Not a Russian bot	Shame the Uk army doesn ’ t care about it soldier and pander to extremist
Zack 691	I thought North Korea ha a peace agreement with South but not with Japan i guess
Andrew Johnston	13 46 why is the flag upside down Didn t anyone there notice it
Daley Wilk	Since ww2
Square Peg Round Hole	IAmSoldierX
