Jake Webber	THIS IS MY LAST SCARY VIDEO NOW BACK TO CRAZY HOUSE VIDEOS THERES ONLY 10 MORE LEFT ON NO NAME SHOP
L Cozzi	Jake her eye look so real Colby except that they are orange Me that look purple pink to me I think I m color blind lol
Natasha Ashley	Anybody else think that when she burned she looked like a child
cute brock	omg a soon a you burned it smoke came straight out of it eye it looked so creepy but i didnt get scared at alllll lmao but also stay safe jake i also recommend you to cleanse yourself and maybe tell colby and sam to do so too 3
ArtistGamerLady	Sorry this is late but doe anyone else know that half of the time the camera is blurry
Mayonnaise	I ‚Äô m a sick fuck I like a quick fuck
Maria Cardoso	I don t give a rat toot lmao Luv u Jake 0 52
Amber Kelley	207 is maine
Scarlett sapphire	When you burn a doll that someone asks you to take care of you shouldn ‚Äô t just burn it especially if she might have a soul trapped inside at least get the whole backstory of it smh
XxGalaxy_GamerxX Wolf	She wa smiling before Colby threw her in the fire
Ellie Stokes	2 29 wtf is that in da backround üòÖ
Hello there!	not kidding that doll thing in the corner at 2 29 scared the shit out of me
a x t i p a t h y	yeah uHm ha good luck
SassyAmerican	Why would you burn something haunted are you stUPID IM CR Y I NG W H A T Plus that would only anger the spirit and tbh I feel bad for the spirit too like w
Kpop trash Garbage	The flame look like a frigging cross What the frick
mysterious art girl	That wa scary
Fangirl With A Camera	YOU SALT AND BURN HAUNTED THINGS YOU DINGUS HAVE YOU NOT SEEN SUPERNATURAL
m t	Love yo content but deadass scared for u ppl
Kawaii Unicorns	this is the only video of any of the roomates who ha actually made me cry of fear lmao
Amy Gazza	It s not funny laugh that wa pretty funny
fatima muhammad	at 4 41 her eye adjust from small to big
Penelope Costa	Did you see the doll eye move
Keeta Honner	You should do a video and see if it move
**Connecting_ With_Spirit*	This is the dumbest thing you could have ever done You could have just sold it on Ebay and found an owner that would appreciate the paranormal You guy are so disrespectful I hope she contains a demon or a vengeful spirit to haunt your dumb ass That way you learn your lesson and respect the unknown
claudia Smith	I broke a haunted doll before and the thing inside it never leaf me alone
Guru	i feel kinda sad for the doll
Piano Keyboard Girl	You made a mistake
Anita Marie Castillos	Lol when colby really need some AKA Its a jokeokay
ItsYaBoiJosh	Yo what if the lady wa being haunted by the doll while the doll wa with her so she sold it but somehow the doll told her that if she harm it in any way then the doll spirit from the doll would come after her and that s why she kept asking Reggie it wa okay
Erika Graves	At 7 52 there is a little hand in the top right corner of the fire pit And I remember seeing that little hand when Jake opened the dybuk box with Sam and Colby
Magge y	why do keep calling the clearly PINK eye orange
OofMelia	I think colby ha been secretly dating the doll üòÇ
Arianna Perez	Bro 7 11 the doll burning look like an upside down crossüò± wtf
Madison Newby	thats creepy i love it jake stop with the demon and doll jeebus i want u to stay alive and not get killed by demon
Catelyn Rosenquist	I got extremely natious while watching this video specifically after she wa burned I haven t felt bad or anything all day Maybe a coincidence but I don t knoooooow
Cupcake Party	üéµ I DONT KNOW WHAT THE FUCK JUST HAPPENED BUT I DONT REALLY CARE SO FUCK THIS SHIT IM OUT üéµ
the joker	Don t burn object that hold entity because you ll release the spirit
Ky Sun	Let it burn let it burn
Evie Harris	Its facial expression really did change throughout the whole process
Anna K	I saw her eye throbing at one point
Caitlyn Jameyson	I got chill Even tho im behind a screen
The Weird Phan	WELP WE LOVED YOU BYE
lancelyn barbee	You should ve burned the doll all the way so that the spirit leaf And burn sage after
‚Ä¢ f a l l i n g b e a n ‚Ä¢	why would you burn your child lmao
Diana Wola	There ‚Äô s a museum that take in hunted item in America and keep them in good condition and the spirit calm so bad spirit can ‚Äô t harm anyone that ‚Äô s where the original Anabell rest
Glory Sage	Burn the rest of her
Maddy Castillo	omg play it sow starting at 9 39 and the hand MOVES
Caridee Bollinger	4 48
The Broken Ones	Burning it only set the spirit free You ve done nothing but worsen your situation
Grace Ronan	I wa washing my face in the bathroom with the door closed and then the door wa slowly creaking open it scared the crap out of me
Miriam Ramos	How do you sleep at night
Elyssa Cranford	Jake you keep dodging alot of bullet with this stuff Please be careful
hannah pleming	imagine if they just sent a photo of the doll on fire and all burnt with no context to that weirdo lady who wa the old owner
Enchanted Squid	When you started to burn it I started to feel emotional
Allison Goodwin	4 41 watch the doll eye they zoom in and out
Raven Maniates	Why am I cry Like literally I started cry And when Sam poured the water on the head and the flame blew up I started bawling Also you need to burn the left over arm because the object a spirit is connected to ha to be burned all the way to send the spirit away Weather it s up or down
Starr Animations!	I wish y ‚Äô all did a lot of scary video more often
Cadence M	h o l y f u c k
B√§by. girl_Gen	When Colby wa humping the doll and the way he wa laughing and smiling is the cutest thing ever üòç
Crazy Robz Vlogs	0 06 is my current mood
Ali Coulter	Yeah I ‚Äô m kinda late on this but I don ‚Äô t care I think that burning a haunted doll or any doll for that matter isn ‚Äô t safe The person who told you to keep it safe is probably just messing with you If it is true then so be it I believe in the supernatural but there ‚Äô s an extent that go with it I ‚Äô ve always believed that it ‚Äô s not just the house that are haunted it ‚Äô s the people inside them Talking from witnessing it myself seeing something that not everyone should see is scary I have had many encounter with the supernatural and let me tell you Shit get real okay I ‚Äô m only 16 and usually after the age of 8 to 10 you would grow out of a phase where you don ‚Äô t have an imaginary friend or seeing a ‚Äò ghost ‚Äô spirit I have watched many show where people think there ‚Äô s a doll or house that is haunted but that ‚Äô s not always the case Take it from someone who had gone through something that you shouldn ‚Äô t mess around with this stuff weather it ‚Äô s true or not Along with the ouiji board There is a certain way to use them As I use the word ‚Äò them ‚Äô They are not toy and they are nOt to make joke of They are very dangerous if you don ‚Äô t use them right I appreciate all your video tho Jake and hope you don ‚Äô t do that kind of thing again I would block that number and make sure it can ‚Äô t call you again and please be safe Alis√∏n
Wild WolfGamer	I think angelica wa looking into my soul I started sneezing not even half a second after y ‚Äô all faced her towards the camera every tome
Lisa Anderson	OMG jake your such an idoit what if you let out a spirit with bad intention please stay safe jake Please like if you agree
Richland Williams	Sam shuts the door loud Jake you gon na make me mess up my pant dudeüòÇüòÇ Colby smacking the doll buttü§¶üèΩüòÇ
Angelica Givens	I hate how it ‚Äô s name is my name üòÇüò≠
Caitlin :/	i really wan na know what the name of that purple hair dye isü§£
Jolie Iler	Bro burning thing that are possessed or spooky set whatever s in it free You got ta bury or sell that crap
T.S. Leigh	Jake I m worried about you now I am I sincerely hope nothing bad happens to you and the roommate On another note the entire video when I looked into the doll s eye I felt like something wa staring AT ME through that doll Those eye were too creepy man
Julia Zoladz	I ‚Äô m watching this at night Great i ‚Äô m gon na have nightmare tonight
Angie gg	It s eye are pink poor thing U guy r so mean n disrespectful
Mathius Strong	Did anyone see the pupil get smaller at 4 45
Madisonbishop	Zorgo diffuse 9 57pm
Julianna	Am I color blind Bc they keep saying that her eye are orange but I thought they were pink Someone helppp Lmao
Perla Garcia	Yall need sum holy water from a church
Evil_King_922	4 40 I Swear a soon a he said something about the doll eye her pupil dilated They like got bigger and then shrunk again
Liberty Borlandelli	Have colby cleanse the house with that plant he bought off line the one he cleansed his room with I forgot the name but it help get all the bad Spirits out
Alyssa Agbayani	4 40 i thought i saw it pupil dilating
ANDz_VH	I always wonder Is jake really this stupid in rl or he s just being stupid for youtube
-Êú™Áü•„ÅÆ unknown	jake i m studying wicca and i need you to know that this wa the worst idea you could ve had the spirit of the girl whom died is trapped inside of the doll you didn t burn the doll to ash which mean that the spirit is still attached to the doll the reason why the fire wa enlarging wa due to the spirit telling you not to mess with it anymore the call you were getting were obviously from the woman who owned the doll and you re going to get a call or see her again soon and she will instantly know what happened to the doll you wonder why your house is fucking haunted
Alison Drake	When the Head of the doll started turning itself on fire I thought it wa a bomb that wa gon na explode I got scaredüòÖ
jayjay2007 fortnite and more	U don FUCKED up
Chemicalpanic!pil√∏ts	hey I m not all the way through the video yet so there might be some information I missed but here s my theory to the text so far I believe that the woman who sold it may have lost a child possibly lost to suicide hence the slit wrist or a young relative and believed that the child s spirit resides in the doll That could possibly explain the text where she tell Jake to care for it like his own because mabey the spirit in the doll wa her child or relative at one point That could also give an explanation a to why she didn t want to destroy it because she might have felt that she wa holding onto the reminents of whatever may reside in the doll and instead sell it to someone she belief will take good care of it I know it s a stretch but it s just what I got out of it Plz like so Jake might see it lol
courtney hutton	I don t know why but I feel really bad for this doll like honestly while I wa watching jake poor the fuel on her I actually felt like I wa gon na cry Did anybody else feel that way watching this
JoyofLaila	As soon a Jake ‚Äô s phone started ringing the second time my phone started ringing
Goosebumps Dolan	she gon na come back and haunt yo as you need a priest and some holy water ‚úùÔ∏è
Marissa Rose	Yeooooo that ‚Äô s fucking crazy
Visual Effects	I don t give a rat s toot Jake 2018 That made this entire video
Hunter Draws	Okay this wa kinda bad idea since she is actually haunted the doll spirit is free but it is now stuck in ur home so she is still with u no madder what
Ashley Blasingame	The spirit come out of the doll when you set it on fire
Hopeful Brock	When they where putting it out the hand moved
≈£h√´ ƒë√¶√Ω	Is it just me that covered my screen while jake focusing that burnt doll Its creepy Btw poor doll I think you should not burnt it Or just give it to someone can handle that thing
Mick Roberson	As I wa watching my light flicker every time it showed her face
Jess W	i dare you to tell the recent owner you burned itüëÄ
Abigail Mustain	Oml dude please don ‚Äô t die
Appieabshire1969	i would of burned the doll a soon a somthing happend
Erica Etherington	She wa murdered
Hayley Keefe	Instead of burning it you should ‚Äô ve yeeted that bitch into someone ‚Äô s backyard
Emily Shearer	When they burn shit they should really put a circle if salt so whatever is in the doll stay in that circle
Bailey Hardy	9 40 i kid you not when he pours water onto her again the arm that wasnt burnt move It like twitch in agony almost
Lilly scissor hands	This is creepy Af
Kara Holt	Ugh a I wa watching this I had chill going down my spine and felt like someone wa watching me Honestly I think my house is haunted because a few day ago when I got home I walked in my room and saw a doll bed laying perfectly in the center of my bed and the bed wa originaly on the floor for my cat
Alyssa Rivera	Did anyone see at the end a bubble come out of the doll mouth And the FUCKING EYES WERE MOVING
Laila Cates	OMG at the end when you were zooming into the doll face and then the outro that scared the living sh t out of me
Darleen Nunez	The arm that wasn t burned moved back and forth
Shelby Faith	you guy are burning in hell for sure ü§£ü§£
KING JULIE	U should have never burn that doll n u didn ‚Äô t finish burning it not good
Itsss Allyyy	i jumped like 10 time I SWEAR I SAW SOMETHING CRAWL OUT OF MY BATHTUB
queen caramel	call the lady and tell her u burned angelica
Aubrie B.	You guy should have salted the doll before setting it on fire now the spirit could be vengeful and could easily attach itself to you guy please stay safe‚ù§Ô∏è‚ù§Ô∏è
Krista Borrelli	Angelica Schuyler for Hamilton
Santa Muerte	you shoulda send it to me i woulda want it
Miranda Barranco	why the hell would you burn it if the person who owned it before made it very clear not to hurt it aND with the fact that it s haunted
Tamera Legaspi	dude i literally got goosebump while watching this that i haunted for sure
Canyon_Wolf	Have you told the lady you burned it
niharika :D	Omggg what if that lady wa attached with this doll and only the doll hand wa left unburned maybe that lady s too She called u She wasnt able to speak anything As her whole body wa burnt
Ali Pynenberg	U just fucked up ppl u might of released something that should NOT have been released ü§¶üèΩ‚Äç‚ôÄÔ∏è
marszhii dayz	WTFFF 4 40 pupil moved OMFG
Bella Suiters	I kinda want the part of the doll that didn t burn
EDWARD CHOE	wondering why you look so cute Jake Btw doe violet sound better than pink
Cat Noir	P s you guy didn t get ride of her when you burned her she wa removed from the doll and freely wondering around your house at the moment Because when you burn something Jake Sam and Colby it only release it from were it wa trapped in know she is free to do a she wish soooooo Be careful and don t let that doll scratch you hot body k lol
bella	colby need a girlfriend
Corey Cunningham	Bad idea number 3 954 Burning a haunted doll
Grumpy Cat	Colby is so lonely It s sad Colby everyone love you‚ù§
Averee Cama03	This wa a bad idea jake Well that wa obvious
Moon Child	Why do u keep burning possessed object that s the last thing u wan na do unless u wan na set the spirit free and have it haunt u üò≠
tammy tidwell	Why did u burn her I would have Tooken her
Jacobi Kroeskamp	Jeez üòÆüòÆüòÆ
Topaz Tera	Okay I m kind of mixed on if it wa a good idea to burn her On one hand the spirit could be mad you burned the doll and probably start haunting your house But on the other hand I used a few tool I have and found out the spirit could be happy you did it In Colby s video it said there wa no way of setting it free but burning an object of attachment can release a spirit that ha a connection with it
DG	ha anyone else noticed that her eye glitch sometimes I thought it wa my computer but ONLY her eye look they re vibrating for like a sec 5 42 when Jake said yeah do it idk i found it weird
Kylie Ferrara	colby is literally all guy in no nut november in this video lmaooo
Kaylerz	Can you imagine spending the day with Jake It would be Non stop laughing lol
Sheree Luker	my phone just got called by a random number
A Clark	OMG that last part wa so fricking scary with the water and everything else
carlogamingplays	Jake why are u burning it I almost cried and u shouldn t have burnt it cause i have been discussing this with my friend and we think that it s spirit will slit ur wrist to kill u
Alexandra Hernandez	I know I ‚Äô m late but if you would of took a picture of the fire you could see a face
JESSICA MACK	Not to scar you guy but at the end of the video when you went dack to finish the video i could see the doll coming back to life did you see her leg at the end of the video üò¨
Emmalea Leonard	Jake why would you do that you needed to wait until she told you what wa going on with the doll and why to keep it safe the doll wa probably dangerous or the soul trapped inside thats probably the reason she wanted it to be safe so it didn t harm anyone or THE REASON WHY IT WAS TRAPPED INSIDE A DOLL you need to tell the lady so she can tell you what to do ‚õî Disclaimer I m not trying to be mean to Jake Sam or Colby I just want them to be safe‚ù§
Kristaps JƒÅnis Dzirnieks	at 4 44 the doll eye
TheAwkwardOwl	Oh my cheese and cracker it doe look like her facial expression changed look at 3 19 then look at 6 12
Aida Camille	You shouldn t have done that
Destiny Burgess	It s not just u it look mad a hell
Emma Davis	The reason why the cut wa the only thing on it body that didn ‚Äô t get burnt wa probably where the demon entered
kitten stuffies	Jake don t die
Madison Cox	Don ‚Äô t really listen to the lady that sold her She seems like she just want to be likeomygoshitsrealfreakoutright She is creepy but I bet she ‚Äô s just making a story
The Tea	There need to be a compilation of jake burning anything that ‚Äô s possessed
taleiyah taylorr	4 00 really colby
Biker girl vlogs	I would have taken her and added her to my collection
Piper G	so during the first minute of the video my phone mess up and turn off It ‚Äô s probably just my phone being a bitch but it ‚Äô s still creepy ü§∑üèª‚Äç‚ôÄÔ∏èüòÇ
LuluGirl Yeea	You need to put salt on the thing you burn
Morgan Eliza	Don t you know by now that burning haunted thing is a bad idea Jake You should have given her to me I would ve protected her
Sylas	Why do you guy insist on releasing spirit rather than actually getting rid of them
Lillie Ellis	Y dose it look like a body
Kenny Lemon	I hate that doll good thing you burnt it üëåüò∞üî•
Emily Sturge	You guy are so childish I love itüòÇ
Paloma Ceja	They should of gave it to graveyardgirl üòÇ
Blue Rocker girl	Jake Webber you have brought hell upon yourself and your roommate be prepare for what s to come jake Because of your not then kiss your life and those around you goodbye Goodbye Jake Webber for this maybe the last time we talk
Meralyn Brimer	He said 50 thousand like and he held up 30 What sense doe that make But your audio screwed up shortly after you lit it on fire And I m pretty sure that the piping noise wa a warning of bad thing are going to happen But I don t know
breathingformikey	wait weren t her eye blue before
Wolf Girl	Creepy as doll
Jayden Cey	Oh my lord How are you guy still alive like wtfüòÇüñ§‚úñÔ∏èüñ§
Vonn Mi Boi	go to 4 38 4 44 and look at her right eye but slow it down to 0 25 It look like her eye are adjusting to the light
Emma Anctl	Go back and watch right before the video end and look in the doll right eye
LeonistaDXVida	Speechless hope you guy are doing fine That wa scary AF
LavenEclipse	This is really disrespectful The spirit wa prob not dangerous it common ppl ask to care for a doll a a real person It make me really sad you did this spirit doesn t always chose the doll or object it connects too Yall have done stupid shit already tho so I doubt you even care I honestly stuck thru most of the shenanigan but this made me to sick to even watch you anymore even if it a joke putting this out there only will create ignorance
Alaina Hanley	Imagine if the doll came back and wa sitting on ur couch at 3 am well i would just die flat out right there‚ò†Ô∏è
jasmijn	Well this is definitely living beyond the norm am I right üòÇ
Bree playz	You should tell the person who sold it that you burned it and see what she say
Daddy Pig	11 04 fifty thousand like hold up 3
Seiara Suiters	‚Äú I have the receipt si ‚Äù
Kaela Nicole Paisley	Now we need an update video on the aftermath of this incident did you ever figure out who called you
Fatima Mohamed	Jake you are clearly calling trouble yourself
Hannah Guerette	I own doll like that but I think it s the doll is calling you like my doll call e all the time
Laila Barker	omg omg omg OMG i feel like angelika srry if thats not how it s spelled ha come through my screen to haunt my house even more than it is i summoned a demon maybe kinda no yeah i did
Hadyn Morrow	READS TITLE WHY WAS IT EVER A GOOD IDEA
Olivia Kiocho	Welp I m happy I m watching this in the morning not night üòÖüòÇ
Crystalized Mari	Jake watch the Video at 4 40 when you zoom in on the Doll because her Pupils are moving like on a Person when there is light ore it¬¥s getting darker
Alexie Ramirez	I know I m really late but what if it wa something telling u to let the doll burn when they were calling u every tune u tried to put the fire out
Azie B	Did the doll mouth open I love how Sam and Colby aren ‚Äô t taking this serious
skyler269	Oh my God It s not the doll that is the problem It s the entity inside the doll If you burn the doll which is not the direct problem you re only going to be releasing the entity and that entity is going to be pissed that you burned it s house down and it s going to be looking for a new vessel You should have put it in a case with special protected glass and sealed it Let it watch but it can t do anything about it That way everyone s happy I don t mean to sound like a know it all but I work with this kind of thing with my mom all the time and I want to keep you guy safe any way I can because your guy video keep me safe every day
Alaina Clymens	JAKE STOP BURNING CRAP
Emma Casey	THE NUMBER THAT CALLED YOU IS FROM MAINEüò± THE CREEPY PART IS IS THAT I LIVE IN MAINE
My Yellow Jumpsuit Blood	When an haunted object is hot that mean there is some weird as energy in that object When I feel haunted doll at like saver or something the weird burning energy lingers in my arm and it s freaky Like ik the doll wa evil but like it looked like you where burning a real person and that kinda freaked me out üòù
Mary Abernathy	The zoom at the end then the outro made me jump xD
Angelica Star	Dude my name is Angelica I m scared now xD
Creeper Girl	Last haunted video yeah VIDEO not life dude text that girl who sold your brother that doll what would happen if something bad happens to her and if it doesnt look pretty than I suggest that you get a priest inside and look around the fire pit or house to be honest you should have returned it to the owner and not to burn it
Matt Man	RIP MF s
Ayanna Bennett	Bruh STOP BURNING CREEPY AND POSSIBLY POSSESSED SH T U ONLY MAKE IT WORSE
Grand Modz	Nice
Kimberly Cervantes	why didn ‚Äô t you try recording her
TheMythCraft	FUCK WHY WOULD YOU GUYS DO THAT DON T YOU KNOW NOT TO BURN THE SUPERNATURAL UNLESS YOU RE ABSOLUTELY SURE THAT S WHAT YOU RE SUPPOSED TO DO DO YOU REALIZE WHAT YOU VE DONE
Izzy1oo	I always like it before it start for you‚ò∫Ô∏è‚ù§Ô∏è
john jamon	If it s really haunted if there s really something or someone inside that doll it will haunt all of you What you say what you did before and after you burn her will definitely have consequence Cleanse the house cleanse youselves but It Will Remain for you have inflicted enough reason for it to stay Hell halth no fury like a woman scorned What ever wa in there inside that doll ha been set free And the once a spirit or entity ha been set free it attache itself to those who freed it Or to where it wa set free
crazy Ladys	rat tude
WolfieOreO	4 50 love the song Jake xD
Stephany Albanil	Jake why the fuck would you burn it üò¨
Milita Askr	Yeah uh jake you gon croak
Hanako Hikaru	YOUR BURNING IT JAKE NOOO YOUR SUPPOSE TO BE BURYING IT THATS THE ONLY WAY IT WON T HAUNT YOU
Danielle Sunga	Ughhh why do you keep zooming her face üôÑüôÑ
Nolan Dolan	I ‚Äô m watching this at 10 pm And I ‚Äô m so paranoid rn
Nikhil Prakash	Hey jake do a cheating prank on sam üòâüòâ
Amber Rose	50 thousand like He put up 3 finger and a 0 isn t that 30 thousand like thereüòÇüòÇüòÇ
Animation with Cyberwolf9999	The doll look like the pupil move like bigger and smaller is freaking horrifying
Wackystallion2328	NO WAY AT 4 40 THE PUPILS OF THE EYES ARE GETTING SMALLER AND THEN BIGGER SMALLER THEN BIGGER
jacinta brook	Says 50 000 like and hold up 3 finger
danya blankenship	Rather bazar boy I think you might have made a big mistake More scary video please
Seraph Kizuna 17	Update y all better not sleep lock your door and probably sleep in one room Cuz the way it ignited steam from the head and eye it s the sign of bad luck coming to you all Try to never burn anything haunted PS if the call number is unavailable the chance are it s the doll spirit
Artsy Witch	Don t ever burn anything that s Haunted because it will set it free and it will either go back to where it came from or attach itself to you
PasteelPetal 101	7 52 look at Angelica ‚Äô s burnt hand that is not Sams hand for sure
Sarah Michaela	Tbh burning the doll wa kinda rude Because that lady clearly and obvi deeply cared about the doll And yeah I rly like these scary vids but now they just clearly doing em for the view
WolfzieDraws	I feel a little bad regardless of your belief in ghost or whatever that wa a really cool doll that clearly had some time put into it and it s probably fairly old
Summer Boston	That doll give me the frikin creep and I ‚Äô m watching on Halloween
Isabella McGarry	I swear I saw the doll eye move or I ‚Äô m just creeped by that doll
allanah the yeemo rat	love catching up on the roommate haunted video ON HALLOWEEN
Awkward Pixie	im actually terrified for you guy
HighPriestKadaj	why doe jake always result in burning thing that r haunted lol
Ann Entad	Poor Angelica The owner will be so mad If you really felt that it is haunted you should have put or sprinkle salt in it and expose it to sunlight for a whole day so the entity thats within it will vanish
Sarah Leibenguth	Jake ‚Äú How is it burning that much ‚Äù Me uh maybe cause you just poured a shit ton of lighter fluid on it ü§¶‚Äç‚ôÄÔ∏è
Garrett Thompson	Y ‚Äô all are crazy
The Magical Puppy	Honestly she look really cool i wish i had a doll like that
kbizzle s	Bruh did u know spirt can contact you through ur phone a Unknown So when sam would put the water on it i think she wa calling you and thats y there wa no one their cuz u couldnt hear anything
Cloey Lorene	9 18 and more is creepy asf
Kawaii Elephant	Wow Jake whatüëè a üëègreat üëèthing üëèto üëèdo üëèwhat if the owner of Angelica find out Here ‚Äô s a challenge for you all In the reply of this comment paste what you last copied
Eli TheAuthor	You guy know if you burn something with a spirit connected to it just release it s soul right That can make the situation like a hundred time worse
BROLBY, TFIL whatever im with them for life	11 21 it made bubble i dont know if it wa the doll or it wa the flame and the that liquid forgot what it wa called srry
Zoey Malik	Wait till she show up in your house and kill you I m telling you all DO NOT EVER BURN A FUCKING DOLL THE DOLL WILL KILL YOU
Miku The beepo	Under the video there wa an ad for the bible
JinSwims Xxx	Zooming into the nose made me fucking wheeze cuz I wa thinking yeeters is the new hooter
McKenna Higdon	oh my fuck im literally an idiot Im sitting in the lobby of the biology building at school watching this and the outro music came on and i yelped a bitch yelped fml everyone is staring at me
Wendiii	Fucking dumbass YOU NEVER BURN HAUNTED SHIT I m starting to feel this is a on purpose thing with all the time you ve experienced bad shit I feel like you re just trying to grab view but that s just what I think
Ally DeNorcey	Oh no what s the owner gon na do if she find this video
Jessica Andersson	omg jake that wa so stupid xD
Blippity Bloopity-Boo	Jake Jakey Jake So here s something you should know There are reason you do not burn a Ouija Board You can not by any mean burn it breaking it into seven piece will do the job
Veronica Bogantes	Should have just burried the doll burning it only realises whatever is inside
GHOSTMAN GAMING	6 35 the doll move
Munasinghe Tiara Jasmine	wrong move y all now god bless ur soul x
julia x	this is easily the dumbest thing any of you could have ever done burning any haunted doll is incredibly dangerous in the first place but it ‚Äô s a whole other story when it ‚Äô s a doll containing a spirit that is supposed to be kept safe that ‚Äô s double disrespect be fucking careful guy this is not good
Diane Black	I feel so sorry for the doll somehow Also by burning her you set the spirit free Shouldn t have done this The previous owner s gon na be so pissed Hell no
Fanroder On Wattpad and AO3	Imagine that woman having gotten that doll from like her dead sister or something which is why he wa told to keep it safe not because it ‚Äô s really da gerous
Marwa Bakht	I am dead
Abbie Judy	his outro scared me SKKSKS
jordan park	i don ‚Äô t think they should have burned her if she wa haunted and like they said maybe the spirit that is attached to it killed herself and that ‚Äô s why it ha a slit wrist that girl might have been very important to the former owner and if the spirit wasn ‚Äô t bad and just attached itself to it they just burned the only thing it attached itself to what if it wa a good spirit of someone who just took their life but just went into that doll
Triple_A	I might just be really tired cause it ‚Äô s midnight but did anyone else get randomly light headed after watching this üòÖ coincidence much
Orina J	4 41 i swear her pupil pulsed ew no thank youuuuu if you don t see it put it in slow motion
Kendall J	Anyone else see the doll black thing in her eye get smaller at 5 41
Kritika Xettri	11 22 There Was A Bubble In Her Mouth And Poped upüò±üòÇ
Naome Hashigana	Person is Angelica ok is Angelica ok is Angelica ok is Angelica ok is Angelica ok Jake burn Angelica Person call jake Jake
Jauniaus ≈Ωukauskas	Goddamnit your f kin outro
Luna Winter	There wa another little hand thing at the top right corner of the fire at 7 51 7 52 it wa only there for a split second this time I swear to gosh I am not lying PLEASE tell me someone else saw it too
MangoPC Gaming	I kid you not when he zoomed in on the doll and then the intro played that made me jump
Neological Gamer	soul are flammable they can t be killed by fire though just start internally suffering seeking revenge and you clearly harmed something
Ashlei Herrera	If an object is haunted to release the spirit You burn it with salt so the spirit go on the the spiritual world heaven hell Because if shes stuck in the doll she s stuck in the veil between physical and spiritual world But u need to burn it with salt so you don t get haunted The salt is for the purification
Impossidle Jackson	That wa a creepy video
lucia flores	Burning it is making it worse STOP BURNING Burning isn t going to get rid of a spirit It s going to release it If that spirit wa in that doll for a reason then you should NOT burn it And DO NOT treat spirit a a joke ESPECIALLY DOLLS So the wya you guy were treating the doll will make the spirit EXTREMELY angry which is very bad
G√ºnther Jadyn	so have you died yet or ha anything paranormal happened since you burned it
K W	You should make an official ‚Äú we ‚Äô re gon na die ‚Äù song
KpopsicleSuga	Jake why are you so stupid not trying to be mean but dude
Rwaii Bay	Okay so first off I just found this account I ‚Äô m not hating but the thing inside the doll is connected to it The person who is very protective of her obviously know something seriously powerful that ‚Äô s why you needed to take care of her Burning her made it worst because the wrist didn ‚Äô t burn there ‚Äô s something seriously powerful that happened to the doll I feel bad because the thing is connected to the doll so you doing ‚Äú think ‚Äù to the doll she know your disrespecting the thing inside of it They know that she got worried but you still did it The woman that told you to keep her safe knew something is happening if something is calling you
Bryanna Emery	Jake you just freed the entity that wa in that doll that is a good thing
Creative Potato	Her eye look pink to me tho
Mastergamer Shy	Colby is sexually attracted to the dollüòÇüòÇüòÇ
thrasherbabe 666	Do a video about her backstory
Bree Ossmann	jake i really really feel like this wa a mistake this video made me completely nauseous the whole time the doll wa burning i have a really bad feeling about y ‚Äô all burning the doll please god be careful
valentina 15	The first time i watched this istg she had neon pink eye now I see a magenta
Lissy Dawn	If you die can I go to your funeral
Sarah Nicole	It take serious gut or something to burn another haunted object üòÇüòÇüñ§
Captain Paws	STOPüëèüèºBURNINGüëèüèºHAUNTEDüëèüèºTHINGSüëèüèº
chyanne storrs	I sware I saw it s eye move
Gaming-Exploring-Vlogs enjoy	If you are burning it it s basically letting the spirit out
Oc√©ane Paul	Me read the title Wtf did we tell about burning possesed haunted stuff smh When will you learn
Ashlyn Dolan Winchester-brock	You really should ‚Äô ve covered it in salt and then burn it
Sarah Schneider	4 41 her right eye dilated Slow the video down
Samantha Rinker	You know what I shoulda been Angelica for Halloween
lapis lazuli	When you die and find out that you have 27 demon and ghost attached to you dont be surprised üòÇ
Alaina Graham	That spirit ha now been freed It s already targeting you guy
Aly Odom	NOT A GOOD IDEA AT ALL BOI NOT SMART
Angie Dolan	What is Jake s deal with burning demonic stuffüò≠üòÇ
Brooklyn Alyese	I said I d make another video about her for fifty thousand like And he hold up a three and a zeroüòÇ
XxKenzie _WolfxX	I thought this would be a bad idea
Hanka Micova	Guys just oh goood watch yourself
Hailey Miller	I love u so much
Kayla Deliz	Don t you love how they decided to burn her at night
Brenna Miller	when you are really focused on Jake ‚Äô s video and you scream when his outro start playing because you think it ‚Äô s a jump scare that ‚Äô s my life right now
Genelle Vieira	The call could ‚Äô ve also been a fan trying to find out your number Welp and of the possibility just mean that you need a new number or even phone
Cassie Jackson	She literally told you to take care of it multiple time why tf would you Burn it
Amya Statzer	I don t give a rat toot LOL hahhahahahaahahahahahahahahahaha idk why that is so funny I guess it the way he said it
Seanna Donnelly	4 49 wa that a sherlock reference colby üòÇ
Anne Clearwater	This BETTER be your last burning haunted thing video because I did see the arm move the one with the slit wrist Sam didn t want to touch the doll which is saying something Colby wa not very nice to the doll Its face definitely changed throughout the video You kept getting call from a random number whenever you tried to put it out And I got chill just from watching the freaking video And you uploaded it a few day ago It feel like something is literally standing behind me and watched the whole thing with me and is now very pissed and want to murder me And all of you three a well Watch your step The future is most definitely going to be in misfortune to at least you and Colby Great now there is a thunderstorm Something is going to happen tonight Thank you Either way all of you even family and friend that were not involved with this at all need to be careful If theyaren t it could mean accident Or in more sever case serious injury and quite possibly death
h0pe MSP	DUDE you are gon na die When you burn a possesed doll you release all of the spirit from the doll No im not an expert but i study ghost and you CANNNOOOTTTT burn the doll You ll start getting weird call and text Im warning you
Fay Ele	5 43 why doe it look like her eye are shaking
joy steph	I love your vids
Aubrey Ann	Why did you do that that doll wa attached to a spirit non the le a good spirit who wasnt doing you any harm ik you guy like the paranormal and all but id think you guy really understand it being a sensitive of the spirt world this is hard
Ava Zuccalo	I wish I wa that doll when Colby wa
KenzieMcKrackerz _	Jake at 11 second LOLZ hi jake
Angelwings 45	Ok so you basically released Angelica cause she wa trapped in the doll I would ve barried it in the wood 6 ft under and just forget about the doll
diablo 6	Did her eye change color or something because I thought they did
Doug	The entity is probably Kevin üòÇ
SamandColby Brocker	You dyed your hair againüòò
Peachy Productions	Jake can I get merch for meh b day it wa Saturday
Crazy Girl	SO SCARY OMG
isabella	He said the eye were orange but I see them pink
Ashes Schnitzle	if the doll is how the person died then they probably did cut there wrist because if u just your wrist that way it harder to stitch it back up so she would most likely bleed out
Nichole Eccles	Colby r u color blind it ‚Äô s pink
Pewdiepie Legacy	Where her wrist is cut I have the same thing bc I went tho a glass door and almost died
Nova Star	I swear to god she s in love with colby just like the rest of u
The Gamer	Mabey it a voodoo doll
taeyong enthusiast	yall when you get a call on an iphone it doesnt say unavailable unless you change that ti a person name
veronica ramirez	I hit that like button Keep this good video coming also you should later try to burn the arm a well to see if it doe burn
OPicebear 1359	I swear I thought I saw the doll ‚Äô s mouth move at 4 40 but idk it might just be my mind playing some trick on meh 3
{Meg Meg}	What if the lady see this video
Brandy Swift	The doll mouth moved it look like it smiled
Amanda ified	The fact that someone kept calling you over and over Jake you boy don ‚Äô t ever listen ‚Äú Take care of her ‚Äù ‚Äú keep her safe ‚Äù Jake ‚Äú nahh let ‚Äô s burn her ‚Äù WTF
Catelyn Humphrey	I have a theory Angelica is a voodoo doll which explaines the cut and stuff maybe a experiment from the original owner Also when Angelica wa on fire maybe the original owner felt it and tried to call Jake because she wa in pain Which would also be the reason she told Jake to take care of it seeing a it wa her voodoo doll
Sterek Haleinski	The poor woman that owned that doll is so worried about it all the time it s really sad to believe that they d burn something dear to another person s soul It s a little disappointing to me
Khaya C	It s a bad idea to burn anything haunted I m not saying it is haunted even tho it look to be I m saying in general Burning haunted thing set the ghost out to the world it basically opening a door to our world I m a wiccan and a medium and have researched the hell out of this because I had some problem with ouija board You guy do what you wan na do just please be careful
Guard Grandma	This is so stupid omgggggg
GhostWolfXOX	And suddenly this turned into a Shane Dawson video üòÇ
Evan Moores	nice video but like maybe that doll used to belong to somebody that the woman loved like a daughter or sister and couldnt bare to have it near them bc of bad memory but just wanted it to be looked after it quite rude that you burnt it idk i mean i cant explain the cut on it arm or it undeniable spookiness but idk i just felt rlly bad when watching this ik reggie bought it so it technically not the woman anymore but she just seemed really worried
Skye Myers	The very second they started doing shit to the doll in the fire pit my computer started glitching out BAD and this is a brand new computer guy And a they were about to set it on fire my laptop glitched and then went white I couldn t see anything but I could hear everything I had to restart my computer and it wa fine after that until you guy started to put out the fire When fire wa shooting from her head my computer glitched again for a sec It wa weird you guy but do NOT burn that doll all the way It s still trapped inside it and it need to stay that way you need to get rid of the doll by selling it or giving it away or something You need to get it out of your house But do NOT I repeated DO NOT UNDER ANY CIRCUMSTANCES BURN THAT DOLL TO ASH
Aly J	Why is her head igniting flash back to a few moment ago where they poured the most gasoline on her head üòÇüòÇüòÇüòÇ
a person that u don't know	Yeah blow on the fire give i to oxygen üôÑüòÇ
soalharvester595 Alpha_panda_gamer_jeff	That wa f ing creepy
Karina meh	No nononononono üò≠wtf did you do
Madeline Armand Taylor	JAKE WEBBER HAVENT YOU LEARN ANYTHING FROM THE RAGING COMMENT SECTION ON YOUR DYBBUK BOX S BURNING VIDEO 90 of the comment on that video wa about how you shouldn t have burned thing that have demon or spirit trapped inside of it I dont understand how you could even come up with the idea of burning this doll when people have been commenting A LOT about how bad of an idea it wa for you to burn these demonic stuff cuz it s literally releasing the demon inside Please jake for these kind of serious issue consult from those who are more experienced You dont mess with paranormal stuff We bother to write such comment because we care about your safety
Rimini Chesworth	Jake I love u and all but I think this wa a bad idea üò¨
Just Me	Colby She ha beautiful eye Me yeah ikr Jake haha PSYCHOPATH ME smh I wa just admiring her eYes and they ‚Äô re not orange they ‚Äô re pink
Shindi Naomi	Greatest intro ever Hey
Mariya Campos	So you burned her before knowing her story That ‚Äô s kind of fucked up
Sour Candy	Yall 3 are going to hell sam jake n colby we are all in this together
venefica aure	In the dream I had about your doll after you posted the first video she wa very aggressive BTW burning something that hold an entity let s that entity out to attach to something new
AannW Rootbeer	How you all have yet lost your soul to the devil is on me I mean holy cow Even I got the creep after this
ÿ¥ŸäÿÆŸá ÿßŸÑŸÉÿ®Ÿäÿ≥Ÿä	Dude there is an app called real caller and it tell you who ‚Äô s number that is if you wan na know
Natty Joachim	that doll look like me on picture day
Carley Clokey	That ‚Äô s the creepiest looking thing I ‚Äô ve ever seen it ‚Äô s one of those thing where I ‚Äô d see it down the hall run and turn the light on why do you guy do all this creepy crap
Tricia Dela Torre	You know when you use gasoline to create a fire it usually is harder to put out the flame using water This is why fire extinguisher are more advisable I think what happened wa that the gasoline seeped into the hollow part of the doll s head and the pop were just because of the gasolline and the heat and pressure that built up inside the head I don t know about the scar though or the timing of the pop hehe
KittyCat 11	Good Job Jake
Gemma Duff	I had chill watching this video
Daniela Zorin	SHIT who got scared by the outro cuz I DID
SkylerY Yanime	That s so creepy
Mischief Gaming	I kinda feel bad for the doll like she didn ‚Äô t do anything now you ‚Äô ve kinda just pissed the doll off she gon na come throw you in the fire pit nowüòÇRest in peace Angelica
Our Lord and Savior Pete	Maybe it didn t burn cause it wasn t in the fire
Hanatuzuki Shiori	I hope Colby buy more white sage that he bought before correct me nicely if I spell something or say something wrong please
iEditors 1817	FUCK MY NAME IS ANGELICA byeüíÄüëã
Xy- -ri	So let me understand please because I ve seen her eye more worried about what wa going on You burned her after the owner told you to keep her safe and then you receive more call from probably the owner I think the owner wa in some way attached to Angelica and you set the demon or whatever wa in that doll free that s why she wa popping and her face literally burned in a hell flame And what if that doll wa a voodoo doll What if the owner called her Angelica but the doll is actually the owner I don t know what to think more and what to say Just one thing Jake never burn demoniac thing they re demon they live in flame EDIT I FELT SOMEONE BREATHING BEHIND MY NECK WHILE I WAS WRITING THE COMMENT AND I M HELL SERIOUS
Big Robz	Anima
Mia Rossouw	You should text the person and say that the doll is died now
Katie Dillon	I actually started to feel bad once you started burning the doll and when you three it on the fire
horror movies is the best !	When i just started watching this video i got a spider on my arm
Maia Jaye	oh man they are screwed
Erykah M-M	Omg I swear her eye grew wider when they put her in the the thing to burn her
Kate Carmichael	It went from happy to pissed off when you dropped it in the fire pit
Pettyvxbes	Boi am I blind or did I see those fucking iris dilate
#1Candy EVER	‚Äú The eye are orange ‚Äù bish No their not Their pink asf
TYPICAL JACOB	You all are so dumb by burning the doll your releasing the spirit into your house
Bruce Dsilva	Instead of showing 5 finger for 50000 he showed 3 so it mean 30000 like
Bridget Trammell	I swear I wish you would just throw it against a wall it freak me out when you have her looking in the camera you should have told the lady hey you need to tell what is up cause she scare me and I ‚Äô m about to get rid of her I can ‚Äô t believe you ‚Äô re burning her I don ‚Äô t like it ahhh ahhhh
Aleyna Beki	I think he should call or meet up with the previous owner and ask about the backstory and maybe show the good care he ha taken of the doll
Alsya Marinda	SAVAGE JAKEüòÇ
Jeaven Pabrua	Yo imma send this to the woman u just texted HAHAHA I actually saw her doll in the past selling it on ebay so i know her contact
Downey Black-Spencer	Btw idk if this make a difference but if you burn a dybbuk box you have unleashed the dybbuk and it will take a long time to burn but you unleashed the dybbuk for good and it can never be returned also in doing some reading on the back of the neck of angelika it seem to have the work shena well in researching about the dybbuk box that ghost adventure ha which you may wan na look at there is a reference to shema and in doing more digging there are other doll made just like angelika and there on etsy also in researching the dybbuk box that ghost adventure ha there are multiple reference to the etsy website and i researched more there wa a holocaust victim named angelika who wa horribly degraded raped by multiple nazi soldier mutilated and murdered in front of her family Which consisted of her her mother and 2 younger brother and they swore revenge against Germany and the Nazis and the last know descendent of her wa a woman named Angie who had her 2 yr old daughter murdered and she several year later wa horribly murdered in both case the murder were never caught and what happened from there no one know Jake I am not saying any of this to scare you but to inform you I believe you have unleashed the dybbuk to yourself i have noticed certain thing you have been doing since you opened it that are strange and I do not believe you unhexed yourself using that spray I feel your life is in danger that the dybbuk grows stronger and you are getting trait from it I also believe you should contact a Rabbi I know I sound like a crazy person but I have seen and know more than I want to Im begging you to please seek help from someone in Hebrew religion preferably a Rabbi ASAP Before it s too late Like I said this is a concerned fan wanting to keep all involved safe But ultimately you do a you choose I wish you good luck And blessing And I also ask that you guy and all other youtubers quit messing with the unknown because somethings are not ment to be dug up or messed with and you all are basically intriguing the mind of vunerable audience for like and subscribes and ultimately causing them to cause harm to themself and others tampering with thing they shouldn t and possibly releasing evil spirit and demon to our world PLEASE do better research And DON T mess with thing that are hidden or sealed it wa put there for a reason PLEASE And little side note the dybbuk knew if you burnt the box it couldn t be locked away again therefore unleashing it forever Good luck Best wish And I hope you listen Please for everyone s safety
Queen WildBeauty	Do not sit outside at 1 in the morning watching this üòÇ I wa tripping so hard I ran in the house You guy are bat shit crazy
naomi fonseca	what if that wa the doll calling you 0
Abbey Menchin	Make a pt about when the lady tell you the back story
Alvaneya Navarro	Reminds me og the movie The Boy like boi that is creepy
Abri Atencio	What would have been the most scariest thing is if that when y all wake up in the morning the doll wa just sitting outside by the fire pit in perfect condition
Galactic Shadow	dude you hella dead
Andu	Si chuyyyyyyyyyyyyy
Sadi Preve	Simple Salt and Burn case
Musicly Stars	I love you Jake üíì Your have the best content üíù I wish the best on your video üíû Your so funny üò´ JakeWebber ScaryWebber WebberSquad FunnyJake üíú
Ayanna Slaughter	Wtf did you guy do to Kevin ü§£üòØ
Hardy Har Har	Uh she ha orange eye Looks pink to me
Torrie Mluzan	I love how ever clip Jake s in a new position üòÇüòÇ
Rebecca Adkins	10 10 that doll wa possessed by something and it ‚Äô s probably still there and it ‚Äô s probably really pissed off now
ArkerTheGreat	Shut up we love you
Kaleigh Betancourt	tell me why the eye moved at 4 43
Christa Ellsworth	Do you want ghost
Veronica _ Family	That so stupid üò≠üò≠üò≠üíÄ
me95917	I m still subbed but like every time I looked at it I felt like it moved Bad idea Jake
Ethan Van Emmerik	Her eye are purple colby
Fluffy Marshmallows	Jake YOU RE SO STUPID I love y all and everything but that wa beyond stupid Please PLEASE stay safe
Kayla Joyce	Burning it wa a bad idea When you burn object that have spirit trapped inside of them the spirit doesn t just disappear That will release the spirit which is far more dangerous
kk plays	That wa wrong
Jayla B	Colby spank the doll üòÇüòÇüòÇüòÇüòÇüòÇüëè
Mercedes Ireland Mua	Idk but I saw an upside down cross when they were burning the doll lol
TheDivergentSlytherin	Honestly call me crazy but I would ‚Äô ve just kept the doll üòÇ I mean I would actually take care of it and talk to it because I ‚Äô m fucking weir but seriously I would ‚Äô ve taken her I just turned thirteen and am not even scared of it You can kill me if you want
Gay Subway	IDGART I DONT GIVE A RATS TOOT
„Éü„ÉÉ„Éï„Ç£„Éº„ÉÅ„Çß„Éº„É≥WolfeChan	Why do I watch these scary video before I fall asleep
Taleah S	I don ‚Äô t know why I found it funny every time they cussed it went bleep bleep bleep üòÇ
No Name	3 17 orange lmao i see bright pink
Zamo Tv	The last time Sam start pouring water on it he hit the un burnt hand and it move up and down However it then start going side to side
Bryan Droptini	if you look closely u can see the eye move like light flickering don t burn it
Jeff the Killer Lover	at 11 22 watch right above her lip there is still the blood or lipstick smere and she look sad also di you ever think that by burning the doll you free the spirit into your home
__emily	The owner of the doll is going to show up üòÇüíÄ
Sedona13 Penny	2 29 KEVIN ü§§üò®üòµüò±üò±üò±üò±üò±üò±üò±üò±üò±üò±üò±üò±üò±üò±üò±üò±üò±‚ò†
elison german	i got the creep and the goosebump and everything and i cant feel my hand
NahNah Nah	Lady Treat the doll a your own Sam Lets burn it Colby and Jake Yep Me Peak parenting
Daleshaa Smith	When you said you ll regret it it look like she smiled
Ella Roberts	I feel like my furture is going to not be so great that I m watching this
Conley Prater	Bro He Is Great With His Hair Dye
SLoPPY BiSCoTTo	No homo but I love u and I think u should upload more Bc u give me something to do and ur funny af
America Gonzalez	5 41 her eye move
JennSCHWA	Oh my fucking shit Why Why WHY
Krusty K	around 4 40 or whatevs i swear i saw the eye dialate a lil bUt i could be trippin i haven ‚Äô t slept in a while
Nattie	This piss me off so fucking much This is so disrespectful on so many level Looks like you ve learned fucking nothing you shit head
amy	do yall not know how fire work lmao
MacKenzie Hall	I think you guy have officially lost it lol
trex ballerina	4 41 why do the doll s pupil get bigger for a second and shrink back down
Always Jalynn	He should be waited to hear more backstory to itüíØ burning the doll could ve jyst made everything worse you guy are back to square one where u guy were when y all were playing the midnight man all those other ritualsüíØ you guy could ve sold it to Zack Baggins the Ghost adventure guy to put that thing in the museumüíØüíØ if y wanted to get rid of it Do research before burning evil haunted thing
duhh its me	The end made me jump üòÇ
Nikki Boyatzies	You should try to find the obituary or backstory on the lady who had her who died I seriously think the owner put her in the doll or some shit I have a feeling she killed herself like her wound on her arm is how she died I ‚Äô m very sensitive to paranormal stuff and like spirit and i can ‚Äô t stop thinking about it Also That lady had to have felt that doll spirit be freed or something She wa so attached and ew I have such a gross feeling
Bratannah	Your hair ‚ù§Ô∏è‚ù§Ô∏è‚ù§Ô∏è
Maija Pakkanen	the moment when she caught on fire looked weird arm wide open and the furious look in her eye
constance williams	Did you know that if you burn something that is cursed that they can have ac to you so I would stay up all night if I were you or go spend the night in someone s room
Destiny Banchich	You guy should have hidden a camera on the doll and seen if it moved
Pinkghost_22	I think you should have put holy water on it before you burned it
May K	You should stop burning stuff like that Jackey you know before thing get worse
Cheyenne Brewer	U are not smart for burning that
XxItsGellyxX ello	OMG MEH NAME IS ANGELICA WHY MEEEEEEEE Why doe everyone hate meh I love ur vids btw‚ù§
Abby Neill	The head exploded at the end probably because of the amount of stuff they poured on it head
Bossbae Alleyne	That is crazy üòÆimagine you wa about to burning and it started to fly saying leave me alone or dieee üòÆüòÆüíÄ
Harley Martinez	nooooooooooooooooooooooooooooooooooooooooooooooooooooooooooooooooooooooooooooooooooooooooooooooooooooooooooooooooooooooooooo
Jennifer Lynn	You probably just forgot to DM me but you can date me thoughü§∑üèª‚Äç‚ôÄÔ∏è
smug f4nt4	Jake made a really bad mistake burning that doll a really bad one He shouldn t have burned it Just a feeling
Lexiüåë	Sam ‚Äú How did that happen ‚Äù Me ‚Äú Fire ‚Äù
Wolf Bitch	You could ve given me the doll I really liked it
Blue Gangsta	Should ‚Äô ve gave it back to the lady this is kinda fucked
sunny studios	I feel like im the only one thats re watching like three time in a row
Calie R	Wtf that wa the most stupidly entertaining thing ever
Virgil Sanders	You guy fucked up big time That wa a real real bad idea
holly13000	I felt so sad for that doll ‚òπÔ∏è I wanted to protect her or something
Tania Escobedo	I feel really bad for the doll y ‚Äô all shouldn ‚Äô t have burned it
Lilith Stefanovich	Should of put salt on it then it would be dead for real fool
Kim Jack	When Sam sed what is up with you burning Evil crap all I could think about wa Shane Dawson burning stuff
Woodzy Girl	THEY TOLD YOU TO KEEP IT SAFE OMG IM SO WORRIED FOR YOU GUYS WHAT WERE YOU THINKING
Christiona Fourman	Honestly I don ‚Äô t think you should have burned her
It's yuh girl mikkeai8908	Jake never learns You re not supposed to burn cursed object Jake Now you have just freed the evil spirit that wa trapped within the doll
tammygibbs	Omg be safe and stop This is terrible you guy are probably fo real haunted like haunted haunted you guy I m sorry to say it but I bet you Angelica is mad look out and be careful plz this is dangerous what you guy are doing plz be careful you guy are gon na get hurt seriously plz plz plz I m begging you plz üò´üôèüôèüíì be careful stay safe quit playing with DEMONS PLZ You guy I love all of you and if something were to happen to you I don t know what I would do Plz plz plz plz plz PPPPLLLLLLLLLLZZZZZZZZZ stay safe plz üôèüôèüôèüôèüòáüòáüòá
NoodleDaddySenior :3	All of a sudden someone call him and all you hear is ‚Äú Is Angelica alright ‚Äù
Maddison_yeemo24 Yeemo	This wa insane Stay safe Love u üíú
Kawaii Pandie!	The head wa igniting because there wa air in the doll head so it wa making it worse and sorry I have a spelling disorder
makeupbyjesss	jake i love you stay safe üñ§
Chloe S. Mendoza	10 50 it wa her for sure
Spicey-Chan	You just burned a innocent soul in a doll when I saw you burn it I knew there wa something wrong not right
Alexia Harp	i just now got the notification for this what the fuck youtube
Haylie Pierce	You could of just sent the doll to me lol
Trinity Garrett	By burning the doll you burned it home so now it s spirit is free
Max	Am I going crazy or wa the doll ‚Äô s expression actually changing on camera Like not just Bam bam bam instantaneous change Gradually on camera like a real human
ThatCrazy AnimalLover	I saw that on Instagram that freaked me out lol
schuuichiminamino	Can t wait on the feedback of what is about to happen now on Good luck Jake You can run away to my country if you will I ll take good care of you I won t set you in fire Promise
Cindy Michelle	I think burning the doll wa a mistake but since you did it I think you should ‚Äô ve burned it all including her arm
Olivia A	dude so at the end of the video where they showed the doll one last time my computer froze on the close up of the face and i kept clicking escape and the space button to fix it and it just logged me out of my computer and then it wouldn t let me back in for a minute thats never happened before ever
sianemmajones	Umm sorry but everyone know that if you have a spirited doll and you think something negative is attached to it you do not burn it is like releasing a genie from the bottle to do what it like be careful guy
JIMIN POP	WHY THE FUDGE WOULD YOU BURN THE DOLL LIKE TFHJSDBKJSjFCDS
Nico Di Angelo	As a Wiccan burning spirit like that is absolutely a bad idea ESPECIALLY when they say they have bad intent That spirit wa released from the doll partially Fully when you poured the water on it to put it out I do highly recommend seeing a priest because a you said that spirit is going to be extremely pissed when it come back
Koffee_ 399	what if the spirit inside the doll is connected to the person that owned the doll or what is the owner is the spirit inside the doll idfk üòÇ
Delia Welker	wtf is wrong with you jake
Willow Garcia	The doll mouth lowered at 5 37
Ezra Sanchez	You just let it free by burning it inside of the doll if it wa someone there spirt just got it and could hurt anyone else in that house
Kia Laursen	Am I the only one who see the eye move at 4 42
dum dum	I have a Theory a game theory sorry I ll stop but for real I heard if you have mirror looking at each other that allows demon and or ghost and how you have a bathroom I think with a lot of mirror looking at each other that might allow demon and or ghost in your house That is why think you are hearing thing and you think it is haunted
cheesetoastie11	This gave me chill
Mariah Marty	Did anybody else see the doll started shaking when Sam started getting the water closer to it s head or am I just going Insane
Kaitlyn Goldsberry	Omg the doll ‚Äô s facial expression change throughout the videoüòß
Cat Gaming The Deadest Youtube Channel	I kind of feel bad for her
Numb Nuts	ARE WE JUST GOING TO IGNORE THE FACT THAT COLBY MIGHT BE COLOR BLIND BECAUSE HE THINKS THE DOLLS EYES ARE ORANGE WHEN THEY RE ACTUALLY PINK LMFAO
Natalie Zdzieblo	the eye scared me the most doll eye do not normally do that sending love and prayer to you allüôè‚ù§Ô∏è
tam	sometimes i think yall fuck with these ghost because you want to be haunted be careful guy seriously you joke but you re gon na get yourselves possessed
Jennyy D	Bro so I stop and took a pic on snap at 4 46 and stoped at 5 29 and puased it and the face expression changed üíÄ
stranger 2 dolan	It look like her finger is moving on the burnt hand in 9 55 10 03
Gracie Binette	Jake why
rawrchik500	Literally watching this while my mom is on the phone with her pastor in the next room
…™t ra…™ns	FAAKK The ending song scared me so badly
Bruno Aranda	we love u jake even though you vape we still love you i just hope there is no consequence to the stuff u do WE LOOOOOOOOOOOOOOOOOOVE UUUUU
A Wleklinski	OMG THERE WAS A COMMENT THAT SAID ‚Äú That wa a mistake ‚Äù AND THE USERNAME WAS It ‚Äô s Angelica WTF THAT SCARES ME SO MUCH LIKE I FREAKING TEARED UP
Tanja M Dahl	Leave it overnight on the couch and film it and see what happensüôâ
Lexi828	Jake s outro music always make me jump after these video jumpscaresssss
Haley Marie	Guess you can say that this video wa LIT But all joke aside you should keep u posted about the after math and that lady Maybe make a video of you telling her you burned the doll and see what she say
Nadia Dragoncage	You dyed your hair my favourite colour D
Christine Castillo	Colby lol
Jo Jo Campbell	I hope that wasn t that lady calling wanting her doll back üòÇ or maybe she ha some attachment to that doll and she felt something bad happening to the doll üò±
Caity Moss	When Sam the person who ALWAYS doe 3 00 AM challenge and mess around with haunted thing wont even hold the doll is when you know it bad lmao Jake shouldn t have burnt the doll it just released the spirit and you should ve waited until the lady who sold it told you the WHOLE story
Allex Strider	That lady told y ‚Äô all to keep it safe you burn it Wow
Richard Baranowski	I think it wa kind of a dick move burning the doll after you told the woman you were going to take care of it Creepy a the doll is wa the woman who sold it wa obviously very attached to it
Clickbait	No guy wrong move your so close to letting the spirit free your putting yourself in danger and if you burn it to ash then who know what damage will be done
Madi Hollingsworth	Imagine the soul just screaming in pain
kenzie christine	Please be careful guy this wa a really bad idea
Patricia Martinez	Wow what a great ending just showing u the burned doll face is greeaat cry in a corner
Goat boat	HER HAND WITH THE CUT IS NOT BURNING
Maqaroon	I have the uneasiest feeling you can ever get in the world It really wa a BIG MISTAKE for burning that doll Imagine that old lady from Kansas calling you one day asking for the doll care and comfort Or maybe she sensed that the doll is dead although DON T BURN THW WHOLE DOLL THE SPIRIT KEEPS THE DOLL AS A VESSEL IMAGINE WHAT WOULD HAPPEN IF THE SPIRIT BREAKS FREE YOU DONT KNOW HOW SCARY THE SPIRIT MAY BE OR HOW EVIL IT IS AND WHAT IT S ABLE TO DO Just be careful
Alycia Harp	Why would you burn the vessel That ‚Äô ll only release the spirit
ZOEY STRONG	Bitch u should have looked up what to do
Mariana Malta	Dude you are crazy
·¥ç·¥Ä…™·¥Ä.	Y all are always doing some fucked up shit Take wan na be Annabelle out wrap her in a clean white cloth and bury her far away from you pour salt on her grave then never go there again UGH YOU BOYS WILL GIVE ME A HEART ATTACK
Nikora Bagzie	The ending though
heller msp	Jake why is it burning so fast Um idk probably BECAUSE YOU PUT WAY TO MUCH LIQUID ON IT
Allie Kitty	How many time do we have to tell you jake burning the doll only make it worse smh
Jaylyn Dinn	Never pour water over an open flame put dirt over it
M & S	normally i don ‚Äô t believe in all this stuff or care but this gave me seriously bad vibe
Nikita Bowe	Lads am I color blind or are the eye pink
wolfiplier wolfie	I think you should ve answered the phone when the doll wa still on fire The reason I think this is because if you did answer and said hello someone might ve said something back Because if it wa the doll it could ve said something That might the reason when you did answer that no one said anything because you put the fire out and there wa almost nothing left This is just one of my conspiracy theory Love ya ll Keep up the good work on vids and if you need any advice on paranormal stuff just ask me cause i know A LOT 3
Peter Lariviere	you should of kept it and not burned it bad idea she wa special and you should of just hung onto it
Makayla Ross	Lady is she ok Jake yah also Jake where gon na burn the doll XD
zoeyLoLcutie 1617	I really Liked the video but the lady never said it wa a bad spirt or evil you shouldn t burn it any way evil or not but what if she s wa a good spirt you probably should of checked before you did that it would be kinda sad if she wa a good spirt
Annette Miller	take care of the doll like it were your own Hope she don t see this video üòÇüòÇ
Hailee Fair	Omg this scared the shit out of me üòÇüòÇ I ‚Äô m praying for you Jake Sam and Colby üëèüèª
Aleksandra Georgieva	Jake for u the eye are pink for you and the others they are orange that is maybe because it doesn¬¥t want to have anything to do with u but it want something from you
Cindy‚Äôs DTXplr Edits	Like for Kevin ‚Äô s thicc body
Holly Drury	This video possessed me üòÇ
Richelle Santos	yall fr about to get more haunted like 1000000
Naleena Villarreal	u probably just released a demon
Jackie Martinez	Ily
eturnal_kat_gamer :3	JAKE HOLY FUCK BALLS AND COCK
Bexsternaitor	Is it just me or did anyone notice that it kinda looked like a cross when it wa a burning
Marik Ishtar	I would ve taken her for free Edit I love haunted thing
ParkChoiJeon -	Jake did you NOT read the comment saying that burning these type of stuff is literally the WORSE idea you could have no Thought so
I‚Äôm Angelica	That wa a mistake
Andy Scene	Min 5 51 you can hear someone humming Female üò±
the kittens	What would you do if that released her spirit
jazmineriva	oh no
Olivia Beatham	Don ‚Äô t read this Oh look you ‚Äô re reading this I thought I said not to You ‚Äô re still here Ok this is getting to serious stop reading this before you get to the Boo üëª it ‚Äô s almost Halloween üéÉ Happy early Halloween üéÉ üòä I scared you didn ‚Äô t I üòÇüòÇüòÇüòÇ Jk
Teela	After they spanked it but it looked like it wa smiling
Martina Anitram	What if that lady previous owner want to buy it back Oof
Joshua Alvarez	You say your scared but you fuck with the ouija board Lol i mean if anything a spirit is already latched to you You just cant physically see it
Angie Ryen	Hey Jake so I have told Sam and Colby both about this I recommended coming to Lily Dale New York I have lived near there for my entire life and the medium there are legit You all should come and get a reading done Something can be done to protect you all from the being in your house and anything you decide to contact later Mediums here are usually in business during the summer when people are traveling but I m sure string could be pulled to make it possible for you to get reading done whenever Please come and get some help with all this spiritual stuff I m seriously worried about you all especially after this video
CKFilmzTV	At 9 39 the hand start moving a if it wa squirming because of pain
Kalei Seno	I ‚Äô m literally watching this in broad daylight and I ‚Äô m spooked guess i won ‚Äô t be taking my nap
Erin McCormick	So everyone saying the pupil move at 4 42 slow the video down to the slowest one and it move 100
burnt biscuit	Good luck Jake
Rosie Squad	Her eye moved in between 3 20 3 30
Claire Hobson	keep u updated on the backstory of that doll i ‚Äô m intrigued
Kiersten Kuhns	You should follow me Kuhns51 on instaüòÇüòÇ sorry ‚ù§Ô∏èüòÇ
Payton Howard	Check out the art I did for the doll on instagram noblerainxxl
Freya W	what the fuck jake why would you do this
Heema	Idk why im watching this alone in my dark room rn when it night here
Gaby Daoud	Jake i think ur stupid cz u released the fucking spirit you dumb fuck and now start complaining about having ghost and paranormal activity at the house real smart realll smart And i know playing with stuff that are devilish make ur life miserable so go see a priest and stop playing with stupid stuff
Crazy Unicorn	7 50 what is this thing in the right up cornerof the fire
CpTheRanger Ttv	DUDE YOUR OUTRO SCARED THE LIVING POO OUT OF ME
Lps Honey Senpai	Is Satan controlling instead of the girl who died
Dawnyelle Reece	is it just me or when they were burning the doll I got hot a if someone wa burning me
Flower Freak	So light em up up up Light em up up up Light em up up up I m on fire
Kiara Molina	I wa honestly scared and felt bad cause the lady asked multiple time to keep the doll safe And now it s gone dead no hate tho 3
Ava Laine Precour	You tried so hard to burn it But wa ro hainted to do so
Deamon Kitty	This video gave me the fucking chill
Sydney Meyer	I ‚Äô m glad you did what you did I can feel the bad energy coming threw my phone I don ‚Äô t wan na sound creepy and sometimes I don ‚Äô t believe the shit you do but you definitely need to bless your home
WHOSLAUREN_ XD	LOOK AT THE CONJURING THE DEMON GIRL HAS SLITS ON HER RISTS JUST LIKE THE DOOL YOU BURNED The conjuring is based off a true story
hydi c.	READ YOUR COMMENTS JAKE EVERYONE TELLS YOU THAT THERE ARE BETTER WAYS TO HANDLE THIS STUFF BUT NO YOU DO THE BAD THINGS
rayn3260 rayn3260	Angelica is one thiccc bih
Daimarie Tenney	I liked it
Gray Jimin	You should not have burned it
Samuel Vilei	you are fucked
Makenna Silva	doesn ‚Äô t burning the doll release the spirit inside it
itsjustteagan	When u burn it I swear it set the soul free or to another object
Dariann Adams	Omg can someone tell me why I started to feel sad and about to cry when he put the doll on fire I like felt guilty or something The doll face when u burned it wa so creepy I got chill when u guy started to put water on it and someone or something started to call Jake Guys that wa a bad idea to burn that doll u shouldn ‚Äô t have done that I think u just let out the soul üò≠üò¨üò¨ü§≠üò≤ be safe
Life Of Kiki	OHHHH NOOOOO
ah yeet	What happens if that lady find this video
Cry Baby X	Colby is showing u all of his kink
Ana Ana	Early YAYY
Eric Lindesay	7 50 look at the top right of the fire pit SHADOW HANDS
Grace Lillian Simon	Not like it would matter now but burning with salt actually work so that probably would ‚Äô ve helped Just a thought for the future since we all know you guy are gon na keep messing with these sort of thing
Maddy Grace	207 is a Maine phone number
NerdyEcho	on camera the eye look pink not orange
aya-412	use spy caller to get the number
Trina XxxX	I had to pause the video to take care of my dish and all of a sudden right when I turned my phone off I got a random phone call It scared the crap out of me
Fancy vlogs With ari	I missed their vids ‚ù§Ô∏è‚ù§Ô∏è‚ù§Ô∏è
Shweet_gothy_pie	I think this is really disrespectful I would ‚Äô ve taken care of her Have fun getting haunted
Fausta U≈ækuraite	you f cking idiot why wait wait wait you realy did that NOW at first can you wait to heard her istory you realy dead her soul free now and that b tch say that you not save so WHY THE F CK YOU DID THAT
Jasmine Corona	‚Äú I have receipt si ‚Äú üòÇ
Arleth P√©rez	WTF DO YALL KNOW THAT BURNING POSSESS STUFF IS SO DUMB MAYBE THE SPIRIT IN THEREWAS EVIL AND YALL JUST OH DANG IT Atleast yall are moving BUT STILL IT COULD FOLLOW YALL BC U FREE THE SPIRIT
Mollie Marks	jake burning any possessed object will only set the spiritfree you should have sold it on or something jake please cleanse yourself and your house please jake you all are in EXTREME danger after the queen mary thing you don t want any more and a well a burning the dybuk box STAY SAFE Xx
Issiah Montanez	If I wa supposed to see a scary as doll I m kicking that shit thru a field goal
Ariel Ortmann	Omg the fact that the person kept calling omg They should try to call the number back
Felix Clarke	GUYS DID YOU NOT LEARN FROM LAST TIME DONT BURN THEM IT JUST SETS THE SPIRIT FREE
hannah mackenzie	I feel like it ‚Äô s facial expression changed when you put it into the fire pit honestly I ‚Äô m terrified for y ‚Äô all
Tegan B	That is some demonic shit
Tatyana T	Oh my I m scared to even watch this Pray for Jake
Triviana Zimmerman	4 42 it look like the right eye moved
Kayla Fitz	Y ‚Äô all gon na die ü§°
Fatima Munoz	Lol when he said 50 000 like and he it up 3 finger üòÇ‚ù§Ô∏è
Ava Sarkies	My bf ‚ù§Ô∏èüíñ
the turtletron	I have a feeling something bad will happen You shouldn t have done that You sure are in for it Jake You will surely regret it
Nikki Richards	I don ‚Äô t know why but I wa eating and got sick to my stomach watching that doll burn
brock tarts	You shouldn ‚Äô t have done this The spirit trapped in this doll could have very well been attached in some way or related to the woman who gave Reggie the doll in the first place This could have been the soul of a child or a baby The way the doll look on the outside doe not reflect wa may have resided within You burning it did not set it soul free if anything it just upset the spirit further You should have taken the doll to a priest to get it blessed and find a way to release the spirit so it can go to the light and be released from this physical plane Spirits were once human too burning their physical vessel like this is just a disrespectful a forgetting they once existed
Emma Grace	So I ‚Äô m just now seeing this and then when they started burning her I get a friend request on snap from some person i don ‚Äô t know name Angelica I absolutely Lost my shit and hid under the blanket
its Addison games	Jake that s a 3 not a 5 XD
Zoe	Technically Colby raped the doll and killed her like jesus dude
Fatal Stitches	Oof
foxichu	if something is attached to that doll and it wa cursed which it is hence the scar it ha to find something new to posse I hope it is going to not posse something new
Samantha -	and it make sense to kevin and his nipple
Annabelle 42	6 31 light em up up up light em up up up
Marika	when that doll wa hardcore smoking I automatically blew on my phoneüôÑüôÑüòÇ
Mia Talbot	What if the lady see this She ll be so fucking pissed jakeeeee If she wanted you to treat it like a child there had to have been a good fucking reason I love you guy but Your fucking idiot My brother i think you fucked uppppp
Yana Rossoshanskaya	2 28 What is wrong with Kevin Who dressed him like that üò≥üòÇüòÇüòÇ
Olivia Barron	I ‚Äô d take it a a compliment if Colby started humping me üòâüòõüòè
Sophie Robinson	You actually scared me at the front but you are soo funny and I love the way you talk and the zoom and different angle and those eye tho love the hair
d.arkcolby.mp4	Sam Colby Orange eye Me boy that s pink
Blonde Creature	You are fuckin hilarious Love it ‚ù£‚ù£‚ù£üíôüíôüíô
Savannah Burnett	Did anyone crap them self when the music came in at the end
Rufflebutt	oh boy that wa a mistake the spirit ha probably attached itself to something else now and is now pissed off you should not have done that
Unicorn Farts	NO FUCKING JOKE WHEN I WAS WATCHING THIS A NEWS STORY ABOUT THE QUEEN MARY CAME ON AND THEY TALKED ABOUT ROOM B340 WTF
Baka No Nightmare	I made a comment on Colbys video about why you shouldn t burn the doll Welp better get that priest over because you ve just created a very angry spirit
warrior cats fan	THE FUCK MAN BAD IDEA VERY VERY BAD IDEA
BlueBubble Cosplay	You guy are fucked may god be with you Me in my head ARE YOU FUCKING STUPID Hey let ‚Äô s burn the doll HELL NO
editingbel	i love u jake but you ‚Äô re a fucking idiot lmao
Louise S	The owner gon na be pissedüòÇ
·ë≠·ñáO·íçE·ëïT  ë∆°·ñá…†∆°	Omg your hair üòçüòçüòç
Like Whoa It's Trent	Hey Jake follow up video idea Maybe you could take the video of the doll burning to your local firehouse and ask a couple firefighter why the head seemed to burn so abnormally They may have a logical explanation Or they may be like Holy crap never seen anything like that before Regardless I did NOT get a good feeling watching this video
I LOVE BLEACH	Know I wan na dye my hair like Jake s
Liana Mcduff	4 42 and 5 42 her face totally different This is freaking me out Holy crappp
RAIDER RAGE	u idiot if ur gon na burn something that u think is posessed u need to pour salt over it before burning or the spirit wont go away u need to research this shit before doing it man
Laura Braun	You shouldn t have burned the doll It s probably possessed by a demon If you burn conduit because they can t posse object only people so they use an object to get to you so they can posse you they will be unleashed Pls be safe ‚ù§
nyah nieves	Burnig A Haunted Doll BAD IDEA Me YEAH NO SHIT HONEY
Han Law	Her eye moved at like 3 20 urrr ok
Cecilie Trolddal Juul Laursen S7A Sofiendalskolen	FINALLY YOU KILLED THAT F UCKING DISGUSTING DOLL üòñüò®üò®üò¨ dools are you some crazy ugly killer sh t
Cassidy Starr	Jake get everyone else to do his stuff
Arwa‚Äôs World	Make i still don t understand WHY THE HELL DO YOU NOT HAVE 5 MILLION SUBSCRIBERS Also creepy awesome vid
Cadence Barfield	‚Äú how is it burning that much ‚Äù idk maybe cause you put a lot of burning fuel on it
Angelica Cunningham	This is weird but that s my name and spelled the exact same way
TimidCutie	I m a little confused is the camera not picking up the orange tone or am I seeing thing Cause those eye look PINK not orange in my eye I know this is irrelevant but I might a well point it out
karla e	those phone call were creepy a shit daym that ‚Äô s crazy hahah mad respect jake you got ball ü§£ ü§üüèªü§úüèª
Kimberly alfaro	You guy literally do the thing I would do but I ‚Äô m such a pussy to do them so I love you guy
Kiwi The Great	I feel bad for the old owner and doll
20dakota03	Dont worry about the fact that the head of that doll get more on fire when you put water on it because well I don t know what you guy springled on that doll some sort of liquid may get a more havier fire when you put water on it Love you guy I am sorry for my english tho I come from the Netherlands sooooüòÇ
Byron van niekerk	Shy is not than yout üò±üò±
bru.itsPaige	omg what have u done if u burn a spiritual object LIKE ANJELICA u are destroying something or one home pissing them off so yeh we re all gon na die
Kawaii Psycho	Jake singing happily We re gon na die we re gon na die xD Why ain t anyone talking about that
Sinead Mohally	The only thing left in tact is her hand
Victoria	dude this wa probably the dumbest thing you guy have ever done
LFC Spectre	This is such a bad idea Jake Webber big mistake good luck with sleep ahead including roommate
belladonna morrison	that wa a dick move she wa so pretty
Meghan K	5 41 into 5 42 her left eye move I watched it like 10 time and it get creepier every timeü§¶üèΩ‚Äç‚ôÄÔ∏è
M S	3 18 orange They are fucking pink
x gabrielle x	okay i m freaking out what if the lady will try to contact you again
LD C	I don t know if you ll see this but there are people who take possessed thing know how to care for them properly Zack Bagand is one of them I believe he s got a haunted museum where thing like that are kept Y all should probably look into something like that instead of burning thing like that You keep screwing around with thing like this bad stuff keep happening to y all
Xaya Blood	DUDE YOU DON T PUT OUT GREASE FIRE WITH WATER OF FUCKING COURSE IT S GON NA BLOW
lindsey taylor	I feel strangely sad that you ‚Äô ve burnt her I liked her üò¢
Jessica Barron	4 41 lol
Isabel paniagua	Put the remains in a box and set it out to the ocean or put it in a cave
Michelle Dzbinski	Such a stupid idea ü§¶üèº‚Äç‚ôÄÔ∏è y ‚Äô all are gon na get hurt
Taana Warren	Yo I swear I saw her shake when you guy putting out the fire
Your girl t	But can you keep the scary vids going I live for these üòÇüëåüèª
Jaelyn Sebastian	the doll did not wanted to be free
Zaynah Begum	u guy r gon na get a spanking from the lady who sold reggie the doll
holy shit	a soon a i saw the title i wa like wHy dId YoU dO tHaT Of cOursE iT wAs A bAd IdEa
Brin Chan	Ok so I scrolled down the comment and someone mentioned that the doll s pupil moved at 4 42 something like that So I went to 4 42 to check and I didn t see it move BUT i changed it up to speed 0 25 slow motion and THE PUPIL ENLARGED AND SHRANK BACK A FEW TIMES YOU NEED TO WATCH VERY CLOSELY TO CATCH IT
Stacy Lynn	WTH
Gabbie Gab	11 26 stare into her eye
maureen T	Oh my god üò® what have you done you can t burned the doll jake if you burned that mean s her spirit is free when you said that when all you wanted to get closer she pop so that mean she wanted you guy to stay away so her spirit can free jake and all the roomates you have to becareful because you just unleash something evil becareful jake GOD please protect them give this thumb up for jake and all the roomates üíüüëçüëçüíüüíûüíûüíû
tam bam	yall literally know not to burn this haunted shit y all done it before and everybody telling u but i guess view are more important
Madie Singer	Jake maybe the lady told you to take care of Angelica because something is inside the doll and if you burn the doll you could have released the spirit making Angelica even more powerful than she is in the doll Long story short if Angelica is evil you are in deep üí©
Elmy Diaz	Ooooh Boy
Kat Space	Good job you ‚Äô ve pissed off a spirit and now it ‚Äô s malicious and will search for revenge
Coley H	Don t judge me but that doll wa so pretty
ryuƒ∑565	yous smile n joke round to much for me to think this is real üòÖ
jessica delarge	Holy fuck this scared the crap out of me I hate knowing u guy could be in danger Pls be careful ilysm ‚ù§‚ù§‚ù§
Conceited Jay	Fucking insane
Lexi Marie	It look like when you tried to put it head out that whatever evil spirit wa in the doll when it finally did go out Looked like it left the doll Which mean y ‚Äô all could be in for some stuff
Min Suga	JAAAAAKE WHY IF YOU BURN ANYTHING THAT IS HAUNTED IT DOESN T GET RID OF IT IT BRINGS THE SPIRIT INTO OUR REALM and considering it wa attached to the doll it s probably really pissed at you PLEASE don t mess with thing that you are uneducated about especially the paranormal or you will eventually run into an unfortunate event that will be way more life changing than even the Queen Mary incident ever wa The spirit wa best left in that doll Had you shown her respect she wouldn t have shown you anything le Any spirit can be a nightmare if you anger it if you read this Jake please take my comment not a hatred but a an informative message to take into consideration for the safety of you and those around you
Lyla Tomar	I love Colby smüòÇüòÇüíÄüòòüíñüíï
nevvy XD	Ok what if the owner like before he posted this jake wa like why did you burn her
Brooklyn Neibauer	If you burn a haunted doll the spirit will come out of the doll üòê
ineedalife 00	I know I may be trippin But at the end it look like the face of Angelica is tear stained but IDK MAN I MAY BE TRIPPIN THO THIS VIDEO REALLY CREEPED ME OUT
XoXoQueenDaliahXoxo	YOUR SO DUMB JAKE WHY WOULD YOU RELEASE THE BAD SPIRIT INTO THE WORLD
Eily Sheehan	What s Eily the overly scared worried her house is haunted even if it isn t doing at 1am Scary vides that are making her sweat
Emma Booth	GUYS I SPOTTED A WILD JONAS BROTHER IN THE BACK AT 2 30 THIS MADE ME JUMP SO BAD
Manuel Peru	Jake I don t think you don t do that because you will release that evil spirit and thing will get much worse and you and your friend will be in greater danger
Sphoorthy Kandra	SPIRITS USE ELECTRONIC STUFF AS MEDIUM TO CONTACT PEOPLE IN FEW CASES EVEN THERE ARE MOVIES BASED ON THIS IN CASE U DINT KNOW THOSE CALLS MIGHT BE FROM ANGELLICA AND PROBABLY THERE NO WAY U CAN GET RID UNLESS U GO FINDOUT FROM PRIEST OR SOMETHING BE SAFE JAKE DONT GET UR SELF INTO TROUBLE FOR VIDEOS
Metalfy	Jake that s the worst thing you could ve done Burning a possessed object is not gon na help you get rid of it And I don t think the woman that owned it will be happy
·ÑÄ·ÑÇSongmin	Okay but like Angelica s eye look pink to me but Colby said they were orange I m deadass so confused maybe it s just the camera that make them look pink
Banar Nilam Sari Wijayanti	You re the dumbest person I ve ever seen bro I m not even brave enough to touch kind of thing like that but you BURNED IT WTFFF
Jasmine Andersson	Her eyeball whas moving back and front üî•üî™üñ§üëπüò≠ü§≠ü§≠ü§≠ü§≠ü§≠üòµ
‰πôÂçÇÂåöÂçÑ‰∏®'Áà™	Did u see that sort of white black Bodie like flame shape go up into the air
Rima El-Alo	The phone call could also be some weirdo people recording your voice to use it to sell shit to people because that s a thing I don t know why they would keep calling but yeah Creepy man
Kane Deverall	Tell the owner that you burned her
Lindsey Tomlinson	Umm Colby dont say your a sociopath because Shane dawson will get you Shane Dawson ha entered the chat
Twika	Colby really want a girlfriend üòÇ
ugandan knukles	My house ha been more and more haunted ever since my 13 birthday witch wa a on the 4th While watching this vid my tablet flew across the room I m scared
Ruby Davies	What would we do if Angelica got set free even though there wa no way out the doll and it kill you and the room mate
siddhimoodley	wa that ending really necessary i almost cried
xXsgtSNIPER66Xx Add Xbox	Since the scared arm wa left maybe the spirit wa released from the doll
nichole rose	That wa so scary and u are amazing and awesome and keep up the good work
Marshall Hall	Wtf at 4 42 the eye do fucking move I ‚Äô m done my g that ‚Äô s fucked up
Bryan Vargas	Next thing u Know the doll reappears trying to kill ya for burning
Angela Stell	NOOOOOOOOO YOUR NOT supposed to burn it that s really bad you sell it to someone else oh my God you re going to regret that so much
Amber Louise	Jake ‚Äô s dimple üò©‚ù§Ô∏è Colby ‚Äô s smileüôà‚ù§Ô∏è Sams laughesüíï
Vanessa	All the fan watcher DONT BURN THE DOLL YOULL RELEASE SOMETHING Jake roomates BURN IT
Emily Twizzlerbee	Half of these comment are saying not to burn the doll You do you boo boo
skyeanais ayris	Don t wan na make y all freak but flame coming out of the eye mean s demonic im afraid you let a demon out of it trapped body when trapping a demon you have to keep the thing trapped Now there maybe danger coming your way Be careful
Tina	if the doll really wa haunted and the spirit had bad intention then this wa a bad BAAAAAAAAAAD idea
Marije Zwaal	Omg when jake wa called in the video someone called me that wa scary exactly on the same time
Crimson Smile	dude you have a deathwish all of you realse the demon at your house what did you expecting
Dancing Star India	You re stupid wtf Your as will get haunted and then yo gon cry
Vianca Baille	U shouldnt hav done dat like u just made it furious
Kiley McCaffrey	Uh well have fun sleeping
jannie de villiers	Love u jake
1019 unicorns	if there wa a haunted doll rule book we would all be holy right now
TheDyligentLad 90	All aboard the fastest train to HelltotheNo ville
Bhabie Jj	Wow big scary clap clap clap
Maya Kenny	THIS IS SO CREEPY üòÆüò®
Mark IFurung	i saw the eye wa getting bigger ni even kidding when colby said that his eye is getting bigger it get real big
Oh shit No	no offense but please stop messing with thing you don ‚Äô t fucking understand this isn ‚Äô t a game
Damijana Aukselis	Jake Burning haunted thing to make his house even more haunted Since 2017
isabella hepburn	i cant be the only one that saw the doll arm move at 9 38
Beni Venetta	Oh my goodness üò¢ why do I have this feeling of sadness Which is almost like you re torturing a child I know it haunted and stuff and I understand you wan na take it away but Oh man Anyways good luck Don t know how you ll survive
hfkgore	How did that happen Idk sam i think it s because it s melting
Amelia Moore	That doll look like my best friend waking up in the morning also she fudging mad
Emily Ramallo	Every time I watch video like this I feel like I m bringing the spirit in my houseüòÇ
Danasaurus Rex	Don ‚Äô t die please
Abz Holmes	Sam they went from orange to white to black How did that happen Me lol it ‚Äô s called ‚Äú FiRe ‚Äù üòÇüòÇ
Tonique Washington	honestly u deserve more subscribers‚ù§‚ù§‚ù§
Love Nilsson	You need go to medium and get help üëç
1000 Without videos	Wait why ur hair not blonde
J45M1N3 sabani	omg im staring down the doll and all the sudden at 6 03 the doll MOVES to be honest im not realy suprised that it moved
Autumn Janelle	Jake this wa probably a bad idea isn t the same thing gon na happen just like when you burned the dybukk box
Tenshi Kawa√Ø	He just want our attention and a reaction so u dumb
Izzy IsYellow	BBSNSND RIP MY EARS WITH HEADPHONES IN THEM AT THE BEGINNING ü§ßüíÄ
Jessica Clark	holy heckballs
Andrea Williams	Crazy hey üòï keep safe guy üôèüíñ
Lilla	I think the best idea would be to pay a priest to move into this house with you guy it s the only hopeüòÇüôáüèª‚Äç‚ôÄÔ∏è
Akanksha Kohlib	Idk why but when they burnt the doll I got weird feeling I just don t get it why did I get that weird feeling üò•üò±üíÄüíÄüëªüëª
Akira M.	Colby LET S BURN HER Uhmmmm don t HAHAHAHAHA
Raquyya Adams	She Is Pissed
666 is the best number	WHY THE FUCK DO YOU DO THIS SHIT OML JAKEü§ß
Cody Wincen	The poor owner of the door
Molly	to be honest im kind of scared of what that lady will do to you guy and reggie if she find out
Sky Hislop	I thought that wa colby s doll
Ali Quenery	Goodluck on thay jakeyyy
kirstin gracee	but like i need colby s sweater like my own it s bangingg
Inspiredbycolbybrock 5	I think Colby is colour blind
Trym The Viking	u brought it on yourself by burning her
Amzie xxx	What I found weird is that when Sam wa VERY gently pouring the water on the doll face it ignites really big through it s EYES and then immediately after the flame go out Sam poured just a trickle of water and that happened Also I think her face blew up the most bc they were joking around at the start so they ended up putting load of lighter fluid on her face thats probably why be REALLY safe guy ‚ù§
norjihan abdul rahman	Never burn curse object Give to someone else I bet many oddity collecter want the doll In my religion Satan and devil are made from fire so it will not affect that doll at all coz the doll only a vessel gud luck to you guy
Andy Indra	5 50 I feel like I heard a girl s voice like hmm
Priyanshu Singh	Sociopath üòÇüòÇi knew it gonnna come üòÇüòÇ
Becky James	You guy made a big mistake You set the doll soul fee and it s going to haunt you And their is probably no way to get rid of her now Sooo Good luck with her
shella ebonalo	It is really scary
Helen Greensmith	Omg Best Fucking Intro Ever üòÇüòÇ
Jono Lovegood	Last night or the other night I had a dream I wa about to burn some evil stuff and there wa a doll there along with other thing I woke up before I did though Thought it wa sketchy
Êó©Â∑ùÂÑ™ËÅñ	disappointed but who care Rip the doll
Enik≈ë 91	Why would you burn her if she is hunted i mean i would just sell her of to someone else who is into that kkinda stuff you just released the doll spirit what ever that wa plus in Colby s video it said it wanted to hurt one of you so if the spirit Demon what ever that it wa in the doll is free now you guy should be careful i dont think it going to thank you for burning it body nice video btw
Fedej œü	this is the most dumb thing you have done lol
MIN NIE	i love you Jake because you are such a gobshite
MR BARR	You shouldn ‚Äô t have burnt it I love scary shit I would ‚Äô ve bought it off u
jordan shae	noooo I will miss her T T
Irene Yolanda	that s a stupid decision bro
April Reid	love you
walkingd3ad12	u have let the ghost free and there probly pissed so be very careful
Monika Kab√≠ƒçkov√°	I wa like burn it ok probably not a good idea but of you want to do it ok do it but Salt it first and then burn it you know Salt it and burn it
Lauren 143	literally 90 of comment on colbys video were dont burn it youll release the spirit and make it angry üëèüëèüëè
ExtendoClips	After burning the dybbuk box you still haven ‚Äô t learned your lesson
Vladimir Cain	I would have taken that doll off your hand Burning her wa actually dumb but oh well Sam Colby and Jake have fun dude it wa nice knowing you
Hungry Unicorn	JAKE EVERYONE KNOWS THAT ITS A BAD IDEA TO BURN HAUNTED THINGS JESUS CHRIST üòÇ
Cecily R.	I really wanted the phone call to be the lady who sold ur bro the doll just right a you answer she say what are you doing to the doll
Danielle Bradford	prayforjake prayforcolby prayforsam I hope no demon tickle your buttholes at night stay safe ilysm‚ù§Ô∏è
Pat Murphy	Don t burn haunted thing
holly m	Jake I heard that if you burn the doll it will anger the spirit and will set it free
Nati Beca	Wtf
Maddie Duncan	Everyone in the comment don ‚Äô t burn the doll Jake I think I ‚Äô m going to burn the doll
nariko	jake I swear stop burning these kind of thing ahjdkdjhdkj
Cherry Fairy	After watching this video I started to get really sick like I m gon na vomit and my eye teared up a bit for no reason I really think that burning the doll wa a terrible idea
Rachel Grissop	what ever you guy just did messed up bad
Raven Dragon	Finally you got rid of it I keeping on seeing her move her eye
Caboose The Michael J Caboose	Why am I watching this at 3 am
SuperStormingGamer //MrSSGamer	Jake your an idiot if that wa actually the doll calling you it mean it ha energy to and a mobile phone ha a lot of energy THINK ABOUT IT and on Colby s channel the doll said I can t escape Spirits or Demons say this so that you do something bad to it and eventually do something like burn it aka RELEASING IT now the doll if if it evil sign of when you went to touch it the the doll the fire get stronger it will haunt you until a stronger person can get rid of it some priest so good luck Also I have no clue why her wrist ha still not burnt maybe cause it s how she died maybe no gasoline I don t know Also also the fire coming out of it eye is because it is releasing the spirit Edit also when the owner told you to keep it safe One otherwise it will hurt you Two it wa probably a family relative that died or maybe even Murdered
Emilia Levin	Love you jake‚ù§Ô∏è‚ù§Ô∏è
sam	WHY WOULD YOU BURN IT YOU COULD LVE GIVE IT TO ME ITS NO RIGHT
Cheyenne Hicks	While I wa watching this my phone screen went all black it still is but I can still comment
Alex Minecraft	on Colbys video it said it couldn t be set free so would the spirit still be inside the remains of the doll
Jacqueline Gunning	It ‚Äô s face fucking changed I looked back at the video then it looked different
Ingunn	Oh Yes Burn baby burn D
Jacob Spearpoint	Take care of her like it ‚Äô s your child 5mins later want to burn it
Naomi Willemsen	You are so stupid why would you do that
Neha Chauhan	Next video I ordered a haunted box online Next to next video let burn the box And the saga continues
Sara Hamdan	Dude wtf my entire body went numb when Sam wa pouring water at the doll I still am this is my friend typing
Thea Loyola	Creepy
Peachy Breeze	yeah burn it nothing s gon na happen
Salisa Lambert	DUDE You are dead You don t do that to haunted soul trapped doll Red flame represents the demon trapped It wa the worst Idea you have ever had Why DID YOU THAT
Emma Kelley	this is just disrespectful
Oscar De La Cruz	I thought that if you burn a cursed item ghost attached to it it get rid of them not release it
Official Ines	Omg ColbyüòÇüòÇüòÇ
Hope Simpson	You know when you burn a object that ha an entity you realise it Have fun with her spirit roaming your house
Teegz	Owner keep it safe Jake BURN
Cynthia x	Jake ‚Äô s gon na be possessed one day
SUGAR SKULL	That looked like some dark web sh pretty gnarly p s wa the lady who owned the doll a witch
Lindsay Enid Lopez	I ‚Äô m digging your hair üíó
what the frig?	She look like she s smiling on Colby s video and in this video she have a straight as face wtf
Lucy and Doof do stuff	Omg Jake you had to keep it safe Also it haunted in Colby s video the one he wa on about he contacted it and it said it wanted to harm the roommate Now you have set her free Good luck Go get some Holy water or something
Mackenzie Cringe Princess	YAY
chopped cherries	I don t give rat toot üòÇüòÇüòÇüòÇüòÇüòÇüòÇüòÇüòÇüòÇüòÇüòÇüòÇüòÇüòÇüòÇüòÇüòÇüòÇüòÇüòÇüòÇüòÇüòÇüòÇüòÇüòÇüòÇüòÇüòÇüòÇüòÇüòÇüòÇüòÇüòÇüòÇüòÇüòÇüòÇüòÇüòÇüòÇüòÇüòÇüòÇüòÇüòÇüòÇüòÇüòÇüòÇüòÇüòÇüòÇüòÇüòÇüòÇüòÇüòÇüòÇüòÇüòÇüòÇüòÇüòÇüòÇüòÇüòÇüòÇüòÇüòÇüòÇüòÇüòÇüòÇüòÇüòÇüòÇüòÇüòÇüòÇüòÇüòÇüòÇüòÇüòÇüòÇüòÇüòÇüòÇüòÇüòÇüòÇüòÇüòÇüòÇüòÇüòÇüòÇüòÇüòÇüòÇüòÇüòÇüòÇüòÇüòÇüòÇüòÇüòÇüòÇüòÇüòÇüòÇüòÇüòÇüòÇüòÇüòÇüòÇüòÇüòÇüòÇüòÇüòÇüòÇüòÇüòÇüòÇüòÇüòÇüòÇüòÇüòÇüòÇüòÇüòÇüòÇüòÇüòÇüòÇüòÇüòÇüòÇüòÇüòÇüòÇüòÇüòÇüòÇüòÇüòÇüòÇüòÇüòÇüòÇüòÇüòÇüòÇüòÇüòÇüòÇüòÇüòÇüòÇüòÇüòÇüòÇüòÇüòÇüòÇüòÇüòÇüòÇüòÇüòÇüòÇüòÇüòÇüòÇüòÇüòÇüòÇüòÇüòÇüòÇüòÇüòÇüòÇüòÇüòÇüòÇüòÇüòÇüòÇüòÇüòÇüòÇüòÇüòÇüòÇüòÇüòÇüòÇüòÇüòÇüòÇüòÇüòÇüòÇüòÇüòÇüòÇüòÇüòÇüòÇüòÇüòÇüòÇüòÇüòÇüòÇüòÇüòÇüòÇüòÇüòÇüòÇüòÇüòÇüòÇüòÇüòÇüòÇüòÇüòÇüòÇüòÇüòÇüòÇüòÇüòÇüòÇüòÇüòÇ
Mallory Bruce	Everyone in the trap hou e that doll possessed scary and haunted Jake why ‚Äô d take it Jake let ‚Äô s burn it so whatever ‚Äô s in it can leave and the doll find someone else to posse Lol I love them üòÇ don ‚Äô t think I don ‚Äô t
Devon Salina	Look closely at her mouth a 11 20 a bubble come out her mouth a of it siliva then it pop Jake sam colby please be careful she could be let free when you burned the doll and might be after you be careful
tiger craft	it a demon the head kept getting on fire every time sam put water on it
Justin Natasmai	This is nightmare fuel
baby chimchim	That wa scary
Nienke Mennes	Omg you are all gon na die üòÇüòÇ you should never burn the doll you should have gifted it to a haunted museum to keep it save in there
# Sam and Colby	The mouth opened slowly
William Walker	Actually if you burn a Vessel it will not get destroyed it more likely will set Free and it will remember what you have done to her if you found something haunted in your House again then you know why it happen
Thad Rose	You destroyed the vessel containing the spirit Now the spirt is free You should have buried it far away from the house keeping it trapped forever away from anyone else Be ready It won t be happy if that wa truly a haunted doll
Sapphire Jeon	what did you jut do the doll s eye is fuckin moving and her expression get darker every minute you put an oil in her face It s not a good idea literally not
Tona Matt	Well if this wasn t the creepiest video I ve watched tonight I don t know what wa
Stacey Cano	I ‚Äô m scared üò± lmao cry
zach cc	except that the eye are ORANGE colby you are colorblind
Flap Cat	U know u burned the doll what ablut the spirit inside If it s free now and in ur house
Shakeira Proctor	Why would you burn it jake I ‚Äô m pretty sure that the spirit would be released now
Shania Evans	damn son that ‚Äô s some scary shiiiit
Summer Blackwolfe	NOOOOO
I - AM - A - P√∏TAT√∏	I luv your hair so much üòç
Whisper Rebel	Eyes are pink
DWSY	0 05 lmaoo
shady3 xwolf	JAKE THIS IS THE SECOND TIME YOU VE SET DEMONS FREE INTO YOUR HOUSE
Madi H.	Colby wildin
Erika Jantz	So colbys color blind the color of her eye are pink
Katie Kat	I rlly like jake s hair
jasmine !!	JAKE burning the doll or any object with a spirit connected to it will not get rid of the spirit attached to the item it will only let the soul of whoever free be safe oof
Thea Queen	This is like the boy
Ghost2218 Dragonfirestar	1 Burning the doll just make it worse 2 Is it just me or after Colby threw the doll in the pit thing Jake wa putting the camera close to it face and the eye were moving
Sam Hamel	I love how Jake said let s get this to 50 000 like but when he wa using his hand to show the number he did 30
Miss Maddie	4 42 it look like her eye move
Gothic Fujoshi	Why am I watching this at 11pm √ó √ó Now I m paranoid af Looks like I m not getting any sleep tonightüëå
Yang Geraldine	i wonder if the doll in the house communicates like yo how did you get in there the usual killed and possessed in the this doll man this dress is getting too tight
Summer May539	I feel like that doll wa wearing contact that doll is flipping creepy if that person new it wa dangerous then she would not sell it
Cierra Rose	That wa totally that lady calling you She sensed it I hope you didn t release anything evil
Shadow Wolfy	Y ‚Äô all are fucking idiot
spooky spun	So uh keep u updated on your upcoming haunting I guess Got a bad feeling about this
Baybay Veenema	I SAID I WOULD OF TAKEN IT IN ü§¶üèª‚Äç‚ôÄÔ∏è or there is such thing a a second hand store Jake
iKONICs Lemtur	Orange white black
The Unique Sisters	I am scared
Sandra Shisha	Why
troy collier	trippy how jake uploads this vid with Sam and colby at home and Sam and colby just uploaded a video of them in Australia 0 two Sam and colbys
pastel moon	Why do I feel bad for Angelica ‚òπ‚òπI m so weirdüò≠
sabrina navarro	Her face changed
Mia Kashigawa	What would happen if the owner of the doll fund out that s you burned her and try to come after you
Daniel Baehr	F cking hell dude
Prabhudev Sharma	Why did you burn her fuck
Britney Joiner	Guys did you see when the doll wa laying there on fire with her arm out it looked like a cross
Bunny Angel	You were dumb by burning it You have released the spirit Her spirit will haunt you now You should have taken her to a wiccan shop to know what to do with her
a_ prettygirl___	You guy should not have done that
Hope Loves Maze Runner	If me and Jake were sibling 5 year ago ‚Äú MOM JAKE SET THE LAWN ON FIRE AGAIN ‚Äù Mom ‚Äú What HOW ‚Äù Me ‚Äú He tried to burn a haunted doll Mom Jake ‚Äú WHAT WAS I SUPPOSED TO DO WITH IT ‚Äù
ItWillBeOkayLove	i feel bad for angelica but if her owner really wanted to keep her safe she shouldnt have sold her in the first place Burning doll that are haunted is dangerous because it release the spirit captive inside I don t commend it a it s dangerous and the toxic gas and chemical released from burning this thing is also dangerous for your guy health a well a bad for the air I have a little bit of family history when it come to haunted doll so i ll give u a little info we keep aside from the doll hair fiber probably causing the head to burn more The soul is thought to stay mainly in the head instead of the heart or chest are where most culture and folklore have taught it to be in the human body So that could be a superstitous reason her head wa burning more Although im sure there s a clear scientific reason a well The doll is considered a vessel just like a human body your soul can not leave your body and inhabit another unless you do some sort of crazy ritual or are a master of astral travel but even in those circumstance YOU ALWAYS HAVE TO COME BACK TO THE SAME BODY The only exception to this is death the ultimatum you are no longer bound to your vessel or bound to it and unless you are trapped or cast somewhere or into something you are generally free to roam for the most part a a soul that is The rule is a bit different for no gooders though those who do unforgiveable thing in waking life there soul get heavy and dense tainted in it own way it harder for them to have the same amount of control a those who didn t do unforgiveable misdeed Those who say all sin are forgiven you living a myth sorry to break it to you But after life matter and controlling spirit even removing them from area or binding them is my tribe specialty and i take great pride in being a half descendant in that You burned her vessel so she might be free now i cant say whether or not she will haunt you guy or terrorize you it depends on the amount of energy she hold without a body in all honesty and if she is able to drain energy from you guy to use herself The doll still wasn t completely burned though so there is a chance that it hasnt actually been released yet In these case it better to break apart the doll limb from limb attach a prayer or spirit bind to it dismembered head place in a box and bury deep below a you would a deceased human being
Jeff Howard	So is everyone buying this cash grab
Niklas Palicte	Jake what ‚Äô s your Outro song I need to know
Rita Fernandez	Whyyyy Did I watch this before bed damn it jake üòÇ bye bye sleep
Michelle Planko	I ‚Äô m legit scared for you guy More for what the former owner will do when she find out you burned the doll than anything else the lady give me such bad vibe and she now ha Jake ‚Äô s number I just have a really bad feeling
Ayy Space	Don ‚Äô t leave Angelica Me in the past Keep me in your present future üò≠üíî P s my name is Angelicaüñ§
soupy water	Please be careful jake By the way ThAt stuff is scary especially since someone wa calling you
Alexandretta Billings	This better be ur last scary video dude u and ur friend could be in danger I dont think u realize this is dangerous and can lead to someone getting hurt or killed I see and hear demon and spirit ik what they can do all of u need to stop messing to with the dead
Ella Stiletto	If you re going to mess around with haunted object such a doll and box you should at the very least be respectful and handle them with care If you re going to get rid of it make sure you know the best way to do so Burning haunted thing isn t always the go to
Siiri Heinonen	If you burn the doll you release the spirit into the world and it will stick to the person or thing who burned it where it wa burned
Chelsea	Goodbye grandma üî•
Ella	Can someone tell me why the face and the 1 arm aren ‚Äô t melted but everything else is
Sierra Knight	tell me why i ve been listening to burnin up by the jonas brother all day and jake so happens to pick that song
Lily - Unknown Yt	Haha you call the lady at the start at she doesnt pick up but before that you said it would be 11 00 we she is Haha Jake your funny D
Susanna Hansen	see title NO S IT SHERLOCK
Heyyy Reyes	Just got done watching Kevin Hart and I came home to watch this and now I can ‚Äô t sleep üôÉ
BearingtonTradingCompany	I can t believe they would burn her That s incredibly disrespectful All I felt from her wa immense sadness anger sure but holy crap the sadness You didn t even have a conversation with the woman You should have at least heard her out before trying to destroy the doll You didn t even fully destroy her so whatever is trapped is still there Edit At 4 40 put it at 0 25 speed and you can see her pupil adjust
Crimsen rayne	I m honestly really disappointed about this video it s super disrespectful to Angelica and the girl that sold it to you guy I hope you guy don t get hurt I may be taking this video to seriously but seeing her burn made me want to cry
Hailey Mueller	BURNING a HAUNTED doll is not cool dude not cool thats mean cause basicle your BURNING the SOLE
Wolf Leader	Where d Colby get his hoodie
Cole Ann	I loved that doll üòíüôÅ but also that ‚Äô s a dumb idea
Gwyn Reiman	i love you Jake but that wa a BIG mistake i have a haunted doll myself and i would never want to harm her if she scared me or not this spirit might be a bad one but she wa in a vessel i felt sad watching her burn her spirit is now released but she wa probably happier in the vessel spirit fade when not in vessel please never do this again Jake
Icy Waterfall	Jake Y ‚Äô all did wrong by Angelica You should ‚Äô ve donated her to one of the haunted museum like Zak Baggins in Las Vegas or something or at least waited till the lady got back with you on her back story
Hannah LueWho	Is it just me or did her arm slightly move at 5 55
yo GIRL estefany! we lit Llamas	Wait she had orange eye But I see pink it weird
DemonBoy -	I m actually mad that y all burned the doll she honestly didn t seem that bad until yall started f cking with her
FreakzRitual	I m thinking burning the doll might of released the spirit So now he is stuck with it I wa also thinking if he didn t want the doll He could of given the doll back She said keep the doll safe He clearly didn t
Megan B	This is so disrespectful to the lady who sold the doll to Reggie Especially since she said to take care of her
JesseLoves Carbs	Ya funny cunt Hope she isn t haunting the fuck outta you Elton Sam Corey and Colby aaaaaaaaaah fuck that shit
Aine Hughes	I shouldn ‚Äô t of watched this at 11 o ‚Äô clock at night I ‚Äô m not going to be able to sleep tonight
Abby W	A little after 4 40 when Jake put the camera on Angelica her pupil dilate for a split second
Rian Limpach	The eye look pink
Isabella A‚Äô	Colby Her Eyes Are Orange Me Looks at the doll and think That ‚Äô s Pink ü§¶üèª‚Äç‚ôÄÔ∏èüòπ
Jennifer Novella	I saw Colby ‚Äô s video first and it wa creepy how weird thing were happing a they had the doll right next to them and then Jake burn the doll not knowing what ‚Äô s going to happen üôÉ please jake be safe that wasn ‚Äô t a good idea
Alice Valdez	Yo Jake man I have a feeling that what you Sam and Colby did wa very bad Please stay safe guy and always be alert with that doll being burned could bring bad news Love y all s vids but this wa freaky Just stay safe üòé
Hannah Shuler	You burned the vessel Not the entity
Jordan Troyer	this give me the heebeejeebees
Joy Arnette	that lady is gon na be pissed and you re gon na be super haunted now
rukiagirl19	honestly i just wanted to take care of that doll a soon a i seen her i hope it soul rest easy after that burning
Kibuni	You ‚Äô re all psychopath lmao
makayla misses niall	jake i really dont think you should ‚Äô ve done that
*The Pansexual Pocky Stick That is Named Pan*	jake no
Mary	bro even THE Sam Golbach guy who doe every haunted exploration and 3am challenge won ‚Äô t hold Angelica that ‚Äô s when you know something ‚Äô s really scary
Stephanie Brock	Jake I love u guy but ur such dumbass lol jkjk but srsly Ik u guy aren ‚Äô t rlly religious so u should hav second thought on that and hire an experienced priest Or go to church at least U need to bless the house Colby doing ouji and bringing the spirit back home Sam inviting spirit in with ritual and u Jake releasing spirit their trapped for a reason
Lindsey Hensley	Some Youtubers are going ham for Halloween Jack Weeber out here going for a full thanksgiving dinner
Derpy Dino Gaming	At 11 27 When jake zoom into the eye look at the right eye what is that
Christina Petrin	I bet that f doll s doin it üòÇüòÇ
Jjlove1056	This is why i watch these right when they come out not 11 at night on a school nightüòÇüòÇ
FarBeyondGalaxies 22	Burning thing release the spirit and shit in it So you let it loose in your house Why
Kitty Max	When you burn a vessel you release the spirit to do whatever it want
Taylor091096	JAKE what did we say about burning haunted shit
Maddi V	just after 11 42 HER ARMS MOVED
Tara Delaney	Jake omg ü§¶üèº‚Äç‚ôÄÔ∏è
Effys World	Jake I think you ve just make a big mistake lovely Not only have you just released that spirit but when the lady who sold it to your brother find out what you just did She s not gon na be pleased All round you ve made a bad decision and I hope it doesn t come back to bite you on the as Stay safe ok ‚ù§Ô∏è
DeviNNoisE	You re such a pyromaniac wow
kissy_george kissy_george	Do you one man hide and seek do one man hide and seek
Kali Ander	I can t believe so many people are dumb enough to be worried about him burning the doll ü§¶ It s just a doll there are no evil spirit
Panic! at the 21 pilots chemical fall out	Jake I love you But your fECKed now F E C K E D
Tia T.	Shoudve answer the first call lol
Brennan Revere	Im not usually the type to get scared over these and i live on the other sidevof the united state and im scare u boy better stay safe ‚ù§Ô∏è
Grayson	I just googled what it mean when an unavailable number call you It mean that the number calling you is being placed outside of where your phone service can receive the actual number so it couldn t have been the woman who sold it to Reggie and it couldn t have been a friend trying to prank you because both would be within reach for your phone service to recognize the number The phone rang each time you tried to put out the fire I personally don t think that s a coincidence because once the fire wa put out the strange number stopped calling I don t think this is over Jake so I wish you good luck
sarah geddes	She wa a beautiful doll
Terry Navarre	No why
Mitzi What?	You poor boy are so dumb You re gon na learn though I hope this video wa a set up because if it wasn t you all are so fucked
Anthony Melvin	First comment on any of your stuff Havent you herd of not burning a ouji board cause it will leave a portal open for the demon You think this is different
NayNay Steele	Colby is a sociopath and I love it üíï
Lexi Pinto	I seriously hate the fact that Colby ‚Äô s in these like Jake ha proven to not give a fuck about MANY thing Especially these but Colby wa always the one to be very cautious and now he ‚Äô s fucking around with this doll and burning the thing Making sexual joke like really
Gracie Acheson	So I m not sleeping I hate doll
Spade Of Cards	You just fucked yourselves over man
Nayeli	Ima have nightmare
bunny cake	You guy are going to get haunted while you are already are but still you guy are probably I am not trying to scare you but when you mess with demonic thing that have bad intention they attend to posse people that you don t know they are possessed or take form of a different person that you think that s at the person but they re really not that person there s somebody else and there s trapped in astral projection astral projection realm and you know hope you guy be safe because you playing with fire right now like very bad fire to never burned a doll I can feel that something bad is going to happen
Paphitchaya Saksaowapak	her pupil tho went big and back to small 4 42
Olivia Da Silva Moore	I know this isn t very important right now but JAKE YOUR HAIR üòÄ Does it randomly change colour Edit Jesus if the person that sold it found out that you did that tho üò¶
Grace Machado	Don t mind me just digging your grave
cami	u guy are dumb afff
OreoMonster951	Bro you should ve just sent it back to the lady I m scared for you guy You got ta be careful with that kinda thing
Synnovea Dhanipersad	Y all need to cleanse your soul after that holy crap dude
Isabella Nelson	if feel like wherever the doll is it s always looking at me and it s fucken creepy a
marshall mondou	You just released the spirit completely into our realm you fucking dumbass
Tara Hughey	I wa actually terrified that entire video
Anna Sherlock	This is probably the scariest video I have seen and I ‚Äô m and being 100 honest about this lol
Ghostwolf	Why tf did you guy burn the fuckin doll you guy possibly just released a spirit that will possibly try to kill you now and plus that lady said keep it safe there is something that she wanted safe or didn t want to get released out of there i love you guy but this is stupid lol
anissa cordova	What if the lady who sold it see this vid
Stephanie Lari	Stay safe Jakeüôèüèª
Issabella_Playz 945	Bruh YOU JUST RUINNED THE SPRITS PLACE DON T YOU REMEBER THAT DEMON BOX THANG
Becca Sandhu	Why didn ‚Äô t they give her to good will They take anything
lil sprite	burning the doll wasn t a good idea you might have just released whatever wa in that doll
Edward Niles Klawitter	Im not an expert on these type of thing but when you burn something that could have a spirit in it wouldnt you realese it by burnning it Idk but please be safe about what you do Love ya‚ù§ EDIT a i wa writing please be safe when i went to type suffer for the word safe And it kinda freaked me out
kyrsten Pack	When jake started blowing on the fire it made my ear actually hurt cause I wa wearing headphone with the volume all the way up üòÇ
chase vlogs	At 11 42 the doll lip move
Hannah Seddon	—ÉœÉœÖ—è fœÖ¬¢–∫—î‚àÇ –≤—èœÉ
Rae 45	ew at 4 40 it look like the pupil are movingüíÄ
c mal	6 29 doe anyone realize that it look like her eye are glowing and at 7 13 like Sam said her eye are orangish white also at 7 19 you can see them go black and at 7 34 is when we can see for ourselves that they actually went black ONE OF HER ARMS ISN T EVEN BURNING
Remogr Person	My phone literally suck with notification üôÅ but at least I ‚Äô m watching it nowüôÉüôÇAlso hi jake
Alejandra M	Did Colby say bye to it before ya burned it He didn t do It
Momo Chan	To be honest I m not sure if I want to like this vid it s just too creepy and it s 3 21 AM and I m terrifiedüòÑ sooo I m just not gon na like it sorry Jake üòî
Mrstabbie 099	Kevin ‚Äô s nipple still beat sam ‚Äô s
TheNerdUniverse 123	f i n a l l y a g a m e s y s t e m f o r m e I d o n t e v e n k n o w
Deijah Bailey	Didn t you learn anything from the dybbuk box Ig not
emma lee	They say the eye are orange but I see pink I don t know it could be the camera or my vision is messed up
Laisha Alfaro	You concern me üòÇüòÇ I love you Jake but I hope you stay safe
Firelgnd YT	Love the hair should I dye the top of my hair tip purple I have brown hair
Madison Scherer	biiiitch I am so scared right now lmao
Madison Portier	rat TOOT
Starquisha K Gant	Lol sam with the popping part Hes reaching Goofy
Jhos Rosa	The previous owner said take good care of the doll but you burn it now you fucked up good luck
Mark Hansen	Put lighter fluid on the scar and see what happens I mean did u put lighter Fluid on her arm maybe it wa not hot enough to catch on fire Do what you want that did freak me out a little
Emma Carpenter	So like are you going to tell the lady you burned the doll
koala june	I cried when you hurt her IDK why Ik she s a doll but something about her just seems calmer ik I m not making sense But that s wrong dude so wrong you hurt an innocent soul I really wish she isn t hunted omg she must ve been scared in pain
Ally M	Your fucked Dude
animelover 277	Look jake i know you were doing this for the video but you should not have done that I haven t researched or know exactly what happens after you burn the doll but I think something really bad will happen i love you but this wa a stupid idea
horsegirl love	Holy shit that wa scary the thing is like the devil s kid if he even ha one that wa scary and sorry for my mouth
Noob101	When the doll head wouldn ‚Äô t go out I started shaking like crazy
CrypticCats	Spooky
Crissy Mae	What is with you and burning stuff I wish I told you sooner that I wanted the doll I would have fixed her up and kept her safe She wa a pretty doll and she could have been worth a lot if she wa fixed up and taken care of better So sad üòû
cheryle chia	im so do you really have no more content
ash kings	Jxkskskk yall r goner oof
PossiblyGia	I feel weirdly sympathetic for the doll soul I almost cried when it burned
ashley brooke	4 51 lol we know colby
Josey Foster	At the very end if you look close you can see bubble coming out of it mouth
Evelin Gonzalez	Honestly U should ‚Äô ve waited to hear her background before you did anything and I love scary video but you ‚Äô re going too far with these video yeah it make content but it ‚Äô s real and u needa stop messing with it before u regret it
Nemesia Rodriguez	i wa so spooked 0
Tapainga Walker	I do not approve of this you don t even have proof that it an evil spirt that wa a dick move you and the others did plus you didnt even care about texting or calling the doll owner to tell them Like you could have just sent it away if you didn t want it
BIDL Macy Nguyen	When someone called Jake and didn t say anything I wa thinking THE HASHSLINGINGSLASHER Idk how to spell it üíÄüëπ
Michelle Jimenez	‚Äú i have the receipt si ‚Äù jake new favorite quote üòÇüñ§
Rosie// Subliminals	BURNING A HAUNTED DOLL BAD IDEA Because setting a possessed doll on fire could go a right way
Belle Collard	I have the receipt si
Torieplayz Nothing	Jakes mind keep Angelica safe Burn Angelica
Bunny Kookies	Is it weird that I find the doll cute No Okay
r u b e l l e	FORGIVE MY BAD ENGLISH ITS NOT MY FIRST LANGUAGE KSAKL y know jake the soul inside anjelica angelica whatever it is well guess what of course you don t know well let me tell you the soul inside that doll is still staying with you all it won t leave you this isn t the end jake she s still staying you didn t release her soul out of the doll you didn t ask for an expert s help and her soul can posse anyone dog your roommate and your other doll stuff toy and etc she s mad and she won t stop she will get revenge be careful and now she will be stronger and angrier at all of you and now my theory is maybe the soul inside angelica wa used to be depressed maybe the one who you bought it from wa her mother etc and also i think that when she wa human she got so depressed and decided to cut slit her wrist and probably the cut wa so deep that one of her vein wa cut the vein that wa connected to the her heart and it killed her and maybe it stayed there because she s trying to tell how she died or how one of you will die well the seller wa calling jake while you were burning the doll right i think she got suspicious that jake s brother suddenly messaged her out of the blue and felt that he wa lying or maybe she followed colby from home and saw colby with angelica and saw the 3 of you burning her and maybe she called while you burned the doll cuz she know that once she call you you will stop since you will get scared all i know is angelica won t stop haunting you all and you might get scary nightmare
Fandom Goddess	I have no idea why but the intro with him just saying hey with the sweatshirt is so funny to me lmao It s like me at party
Aubrey Paige	I believe that if you burn a haunted object you release the spirit and allow it to move on But this doll wa not completely burned you need to finish that bitch
Jennifer Bergeron	BAD IDEA GUYS Plz stay safeüôè
Weepy Tea	I wish they had sold her somewhere so what if the spirit wasn t nice How would you feel if after you died you possessed something and it wa broken or burned
PatrickStarsMomma	4 48 Colby s giggle 3
Jessa McGuire	Why did watch this at 11 00 and I think that Colby is a rapist know that what he did to the doll and I know is so triggering to someone me too because it happens to me üòû
the_beauty_of_logic_yt	Jake u fucked up so bad If it we re me I would sell it or take care of it and make peace Not burn it cause you can t burn a lost soul so all u did is anger and realise it
moon meow	I hope Colby chooses to be more respectful to thing that are more than likely very connected to a spirit If he seriously want to start practicing Wicca he NEEDS to have more respect Smh I m sure one day he ll come across a spirit who will happily teach him a lesson on respect Hopefully he doesn t start worshipping a God or Goddess that is big on karma I ll keep him in my thought
Lps Makenna	I saw her hand catch on fire but it still disnt burn and out of the whole body of the doll eye are either to fall oit safely or stay put in the socket
princess tay	Love the outro music scary to hypeüòÖ
Sarina Hansen	Y all are idiot you never do this scary stuff the right way and it s so annoying
Brieana Bott	It wa definitely her You need to get an actual priest to come and see what s going on That or get someone to put a protection spell on you guy and the place y all live at
Halbug and Allison	Dudee this wa not a good idea Burns thing like this realases whatever spirit in the doll which could be a bad spirit I be very careful please Jake
Emily Smith	Okay at 4 42 I swear the doll pupil moved
Siobhan Davenport	Wait how they going to explain to the owner they burned her
Kira 1308	I feel bad for the doll what if Angelica really went through something horrible like that and them u put her through another horrible thing and i rly hope you didn ‚Äô t set her spirit free because in colby ‚Äô s video Angelica wanted to harm you guy Please stay safe
Steph14	When it ignited at 9 44 it went bright and immediately wa gone it stopped burning almost a if whatever spirit wa in there wa getting out and when it stopped burning it wa a if there wa nothing in there anymore
Maycee_Ann	Andddd now I can t sleep üò≠
Brianna Ribeiro	im having an anxiety attack kkhh
Frankie Bloodshed	I love you guy you guy need to stop doing this dumb shit y ‚Äô all could really fuck thing up for yourselves Don ‚Äô t take this a a hate comment I ‚Äô m actually concerned for you guy
Averie Switzer	This is fucking scaryüò∞
Meghan St. John	I love your hair
‚Ä¢Spooky Zo‚Ä¢	Each time jake put the camera on the doll the doll ‚Äô s mouth open a little bit each time
abby broughton	Omg I love colby
MarSadie Edwards	bad idea
Beo abdurrhman	Did Colby just 4 01 lmao üòÇ
jamie_9	0 52 this is why I love JakeüíóüòÇ
_katelyn_	4 44 the facial expression were ok but when it go to 5 35 I think it changed unless it ‚Äô s just me
Rylee Stewart	Can we please get a curse word count üòÇ That would be so funny tbh
Auburn Schmidt	Keep u updated if you get possessed or whatever
skyla josey	WHAT THE ACTUAL F CK see this is why you don t mess with haunted thing
Lexington Imbraguglio	EVERYONE MAKE SURE THE ROOMMATES SEE THIS screenshot it and send it to them on Instagram or Twitter The spirit is still trapped because the doll wasn t burned to ash The doll wa clunking to keep them away from it so it would burn then it called to get them to worry about who wa calling and when they were putting it out the flame kept getting worse so it would scare them and try to force them to leave it alone The spirit is still trapped because it s not fully burned to a crisp only a part of it is free not all of it JAKE DO NOT BURN THE REST OF THAT DOLL The spirit is using the doll a a conduit or a a vessel if you free it it can and will posse the weakness person in that house or attach itself to one of you just like it did that lady in Kansas that s why she is so worried about it because she ha a direct connection to it That lady is going to call sometime the day after all this happened and she is going to know what you did Jake BE CAREFUL
Star Power	I liked both video at the beginning The content is better than Red Dead Redemption 2
Maddy Storm	yeah you re right this wa a bad idea jake you let her free and she want to kill you and the roomates Yes She wa a human at one point obvioulsy and this wa probably her favorite thing she owned if she took care of it and then later possesed it and you just burnt it Jake thats messed up and you most likely made her more mad then she already wa i would have given her to someone that would acually care for her and someone she liked bless your soul üíöüíö
tater tot	No lie Jake the doll seemed like it wa trying to tell you guy something I mean it kept popping a you got close which you could ve angered the spirit and the head kept igniting so the spirit is mad also burning that doll just set the spirit demon free
Elise Keehan	Is it just me or did I feel bad for the doll Like something wa attached to it Jake this wa a bad idea üòü
Alex C	BRING BACK THE PRANK WARSüò≠üí© You should ‚Äô ve played one man hide and seek before haha
Sabrina Ladd	I ‚Äô m seriously wondering if it ‚Äô s entirely possible to exercise a possessed doll like a possessed human I ‚Äô m gon na look it up
Amy Sirawsky	I had a bad feeling when I read your title I think this wa a mistake I ‚Äô m not sure if the spirit in that doll wa good or bad but I don ‚Äô t think it could hurt you if you treated it right like the woman said Now that you burnt it I just feel like something bad is going to happen If you didn ‚Äô t want it in the house there are plenty of people who would be glad to take her People who know more about this than you You should do the mirror game again with Sam and Colby to see if she ‚Äô s attached to any of you
boos123	You should tell the lady you burn the doll and see what she say to you about it
Chelsea Moon	That wa weird when it ‚Äô s head started igniting when u tried to put it out Also after what the owner told u u chose to burn the doll what if she called u to check on her Good lucküò≠
Beyya DiCaprio	U guy r such idiot why did u do that the only flipping thing that didn ‚Äô t flipping burn wa he slit wrist
Mariel Henderson	Your going to die my lord üòÇüòÇüòÇ RIP Jake
STRICT _ SHENANIGANS	JAKE YOU RE SUCH A DUMBASS OHMygODDDDD YOU SHOULDVE WAITED TO B URN THE DOLL TILL THE LADY TOLD YOU HER BACKSTOry BRO OH NOOOoo
andrea beltran	i am scaerd to like this vid ssrry i am NOT going to
LizardQueenie	Stay safe
Arkham 703	Try burning the rest of the doll otherwise the thing the spirit wa latched to wasn t technically burnt That s what I would do if people disagree say
Rn Tn	Come on guy quit forgetting to hit the üëç button This crazy bunch is great
Claire	What wa that popping when they were by the fire
Julia LeBlanc	In Colbys Video the doll said it wanted to hurt them If you burn the doll isn t setting the doll sprite free There dead for sure Jk Jk üíôüòÖ
Evelyn Gonzalez	Umm sir why Lol
Cla zrma	I think you need 1 more fire where you actually make sure every body part get in Be safe Jake
Chyynia Reeder	5 53 it s mouth started to bleedüò±
Grace M	Honestly I love Angelica the eye are so pretty and there ‚Äô s something so esthetically pleasing about the doll creepiness idek
Emma Grape	I m watching this at midnight in pitch black on a school night alone Wish me luck
Maryam That Artist Fab	Didt the woman you got it from said to oh idk KEEP IT SAFE That thing ‚Äô s gon na haunt you
Samantha Exists	To put out a fire you don t blow on it when it s that big you re basically just helping it to be larger Have you ever seen somebody blow on coal to make them light It s because oxygen help feed the fire You either put water or dirt on it to make it stop
jeanne maclennan	YOU SHOULDNT HAVE DONE THAT
lovablewolf 1	You shouldn t have done this Who set it on fire She wa trying to call Colby s phone right This video wa the dumbest Idea you have ever done the girl that wa haunting the doll she wa trying to contact you guy when the phone went off If it wa Colby s phone Colby I am sorry I have to do it If it wa sam s phone of Jakes phone your fine I have been keeping track of you haunted video And all the paranomal stuff and the stuff that you have been targeted on You hurt her I dont want to scare you Colby but your the taget she want revenge he want revenge
Specer Payseno	Oh my fucking God are you serious
Sydney Androsuk	Omg you re so stupid sometimes You are putting the whole house in danger
Infinity Derp	Why do I always end up watching these type of video at night
Kyra	How could you burn the doll when the owner gave it to you so you could protect it like wtf thats messed up
Victoria Zamora	Y all crazyü§¶
Jenny‚Äôs World	With all the stuff that ‚Äô s been happing in the house I swear you guy don ‚Äô t need no more spirit attached Jake burning the doll doesn ‚Äô t solve the problem it make it only worse
Warrior Wolf	jake gon na die rip jake
Raspberry Tea 663	I love your hair It honestly looked like the whole time you were planning to burn or started to burn it it started to move even the mouth looked like it moved a little why do you like burning evil satanic thing
ExploringForward	I ‚Äô m gon na have a nightmare about the doll now üôÅ
Sarena Maynard	Is Colby that desperate for a girlfriend that he HUMPS the doll what the freak she said keep the doll safe and he is over here humping her and then throwing her face first smack into the fire pit ü§£
Genuine Happiness	singing happily üéµüéºI M A SOCIOPATH üéºüéµ
Harley Quinn	You re so funny üòÇ hey
Carrie Dodson	I don t give a rat s toot I don t know why but the way he said made me laughüòÇ
libz_richxx xx	hiiiii I have to say u like to do some weird thing lolü§£ü§£üòÇüòÇüòÇü§£üòÇüòÇü§£ü§£ love u‚ù§
kyndra gallais	That is the most scariest thing I ve seen in a VERY LONG time Anyways Love the video P
imarriedawaffle	I really like the Jonas brother music playing before burning the doll
todoroki gamer	Be safeüò£
Maggie Breeden	You Messed Up I wish you the best of luck jake
Skull !	I SWEAR TO GOD THE DOLL S FACE CHANGED üòìüòìüòìüòìüòìüòì
Psychosister101	This spirit is going to reak havoc now that you released it jake
Blade Lord	1 Solby trash emo boi 1 get rid of creepy doll in the most heartwarming way possible 2 Colby should ve thrown some sage in the campfire Now he s gon na need to burn a pick up truck worth of the stuff 3 The former owner is going to be steamed 4 Jake is gon na get possessed or worse the spooky thing would hardly do anything to Colby and Sam ha the Midnight Man The Haunting of Jake Webbers body coming to theater this oct 31st it gon na be so lit
Daphne The Angel	Before you burnt her her mouth wa open At the end it wa half closed
Grace .G	‚Äú She kept texting him is Angelica ok Like a WEIRDO ‚Äù üòÇüëèüèª
TheSmolBoi 07	Dang it jake you shouldve set a motion camera infront of it for a day so that we can see what happened MISSED OPPORTUNITY
Cookie Dragon [CD]	Guys I love you Jake Aaron Colby Sam Corey etc Etc But WHY WHY DO YOU STILL DO THIS SHIT Like you ‚Äô re awesome BUT GOD DAMNIT
Bekah Rat	This genuinely just made me so sad and uncomfortable because haunted or not this wa someone ‚Äô s belonging who obviously wanted it to be safe and in one piece not to mention she wa a nice looking doll and idk that wa someone ‚Äô s at one point and it meant a lot to them
ChillyFan	You guy are idiot full on moron
Romeo Miranda	I actually feel bad for the doll Couldn t you just return it instead of burning it
Juliana Salazar	bad idea guy im only gon na say that
Phanicing At The Chemical G-Note	1 00 Your eye are the size of the moon
Chance Takers	God Bless Jake Colby Sam and everyone watching üôèüèºüôèüèºüôèüèº stay safe guy
Queen Shane	Y all mmmm mmm mmm why whyyyyyyyyyy üòî
Christina _Gaming204	6 40 IM HOT YOURE COLD U GO AROUND LIKE U KNOW WHO III AM BUT U DONT U GOT ME ON MY TOES JONAS BROTHERSüòÇüëå
Hayley Russell	This doll is slowly making me hate Angelica from RUGRATS Anyone else no just me ok luv ya comment section
Merdith Campbell	It ‚Äô s weird I wanted to help the doll and stop y ‚Äô all from burning her and then when it show close up shot of her it made me want to cry No joke I don ‚Äô t know why but I felt so bad for her
DiaboilkGaming	11 27 u can see like an eye looking at the doll so creepy
Judy Campbell	ü§∏üèΩ‚Äç‚ôÄÔ∏èü§∏üèΩ‚Äç‚ôÄÔ∏èü§∏üèΩ‚Äç‚ôÄÔ∏è
Josie White	Boiiii Jake haven t you realize that burning thing is not always the answer since the dybuk box üò≠üòÇüëã
Harley Jean	Y all are crazy for that shit
kittycatgirl 22	Dear god plz protect me from this video sand don ‚Äô t let it harm me in any way
Alyssa Rose	what color are the doll eye to u bc both Colby and sam said they looked orange but they look pink to me
Jessica Wallace	You guy are going to die someday and it will be bad
savannah bornstine	Why the helllll would you burn that üòë
ur homie eve	Colbys new girlfriend gone
Quaking Tea	I fucking love u Jake and imma get a tattoo of ur no name logo on my shoulder‚ù§Ô∏èüòò u make AMAZING CONTENT
WeezyFire	that doll looked dope af u didn t have to burn her she wa a cool looking Halloween prop
Jake Weeber	Did anyone else notice when they laid her down her mouth wa wide and after she wa burnt and they were putting her out her mouth wa back to normal
Chloe Alexis	THIS WAS CRAZYYYYYY TALK ABOUT SPOOKYYY
Pickle Waifu	This is why you din ‚Äô t burn haunted doll or buy haunted doll Just don ‚Äô t have doll they ‚Äô re creepy
Taylor Brigance	If Jake or anyone else in that house dy what the hell am I gon na do with my life
Ella Decorso	Damn dude I woulda bought her
Sara Moncayo	i think maybe the doll wa some kind of robot or at least had some electronic device in her head maybe a camera thatd be weird haha but maybe that is why it wa popping and also the way the owner would have known and called you that or the doll is really haunted and i dont know how the owner knew o
Melati Salma	JAAAAKEEEEEEE WHYYYYYYYYYYYYYY
Laienose Casting	My phone started glitching after watching this just saying im a bit fucking lot creeped out If this isn t a coincidence i don t know what is
Jiminnie	Isn ‚Äô t this like burning the ouija board Burning the scary doll release any spirit in that Lol gl man
Joana C.	Jake should make conspiracy video
Rekilang Kikuo	so u text her ooooohhh
xplrboss Master	That doll is gon na haunt ur as and im scared for you guy so please stay safeüò¨
Ripley Alison	I didn ‚Äô t even touch my Siri but it just turned on and recorded what I last said I ‚Äô m low key fuckin scared üëª
Crazy Goddess292	Colby got alittle HoRnY
Shy Cannon	I am so glad you and your roommate are okay I love you and Colby and also your roommate ‚ù§‚ù§
Kloee Rane	‚Äú Okay I ‚Äô m ready ‚Äù ‚Äú But I ‚Äô m not ‚Äù ‚Äú But I am ‚Äù ‚Äú But I ‚Äô m scared ‚Äù Me going to school everyday üòÇüòÇ
Avea  Marks	This is why a demon gon na eat the fuck out of you real good lmao
Rayanna	Probably it wa the owner bcs they probably knew you have burned it bcs either she could feel the hurt or sadness or rage Or she could feel the heat of the fire And burning a haunted doll is mean and disrespectful to the spirit j
Rico Lee	There is so much swearingüòÇüòÇüòÇ
Emily Cardoza	You guy messed up something bad is going to happen I feel it
ThatOneGirlBaileyy	Me About to watch Haunting of Hill House after this video Me after watching this video Welp time to turn on Friends üòπüòπ
Turtle Lord	I don t know how else we re gon na get rid of it BITCH SEND HER BACK Also since everything ha been already been sent to hell you might a well burn that hand to because this could be like that one part in Choraline where the other mother s hand wa left over and that hand still had life in it
Peachy Queens	Jake jake JAKE why THE HECK WOULD U BURN HER U COULD OF LIKE pUT IT TO A ANTIQUE SHOP OR SOMETHING
Bunny girl only	I don t know if it my eye messing with me but it look like her arm move and she seems anger and worried or sad I don t know
Annie Goris	I love your video but this is disrespectful It ‚Äô s trapped inside the doll and burning it isn ‚Äô t going to get rid of it
burdeche000	you are robolh really haunted now lik EALLY HAUNTED
StarsForSolby	I m mad that I didn t get a notification and I wa waiting for it too
Silentmoonsoul88 Boo	U shouldn ‚Äô t have done that
Crystallized _	how have they not died yet with all the thing they do
Noodle Ninja	Kill all doll
fkenbrenda	PLEASE BE SAFE GUYS U MAKE ME HAPPY my god bless u guy and ur friend and ur house amen
Dumbest of The DUmB	Her eye color change right before they burn it
hi	PPL TOMORROW IS MEH BIRTHDAY üéÇ ik u ppl dont care but thanks if u guy read this
Morgan Hurt	Why did I watch this right before I wa about to go to sleep look like I will have nightmare tonight
Lars-ado Isbosethsen	Isn t the doll eye pink\orange Or is it just me
kaylee honeycutt	Jake put out a three wen he said 50thousand
BFF vs BFF	omg I wa stressed out this whole video GOD DAMN IT JAKE
DarkenedRose hoi	Boooooooooooooooooooooooooooooooooooooooooooooooooooooooooooooooooooooooooooooooooooooooooooooooooooooooooooooooooooooof
Keith Kogane	Yesssssss love you jake
ashley brock	You wan na make me shit my pant Sam It scared me too lmaooo
YourPvp Gt	The spirit of that doll will live at your house
Mikaela Hauser	I ‚Äô m so disappointed in you you could ‚Äô ve given her to someone else That ‚Äô s so disrespectful Jake
Jamie watts	i ‚Äô m ded when he say ‚Äú give that like button a good ole spankin ‚Äù
Dead Winter	Why tf would you burn it
maritza	jake ur hair look great
Fwx Kelly	HEY YALL
Ksenya Kochan	dude idk im like hiding in the comment section lo
nia jones	Yall should bot have done that yall just set the ghost or demen free
Serena Alucardo	You just released Whoever wa the previous owner of that doll spirit into the house That wa a bad idea
Marne Ackermann	4 04 Colby s dimple
Mattie Snider	You are fucked dude
Ashley Roorda	You should play Brennens haunted Ouija board
hOi :b	I ‚Äô m now freaking out after watching you burn that doll even tho the owner told you to keep it safe üíÄü§∑‚Äç‚ôÄÔ∏è
William Follmar	7 52 7 54 you can see a hand kind of thing shadow come into a scene in the corner of the fire pit
Beca Stevenson	Guy s I Think You Should Just Burn The House Down At This Point Guaranteed You Have Demons If Not Really Evil Trickster Spirits In Your House AKA The Midnight Man Is A Trickster Spirit That Likes To Play And Mess Around With Your Emotions And Stability Life Jake You Should Not Have Done That Tbh 3 But Still I Love You And I Wish You Be More Careful Sorry I m Starting To Sound Like A Big Sister Mother Too You Lol Nothing But Love Babe Xxxx
Toshi Ezarik	I love these video
Alona Leonard	Jake why did you do this Do you want to get killed or something
Addicted to music	üëèBitch stop burning shit üëè Fire is not always the answer
Stephanie Tovar	7 24 It look like a cross burning
ItzMe Kate	I saw kevin and I died xD it wa so funny
Harmony Heyes	You guy are So enthusiastic about thisüòÇ
KayJess Watson	Anybody wan na roast marshmallow
Mariah Raposo	I literally just clicked on the video and I already have a bad feeling
Jenna North	Dude that doll ha creeped me out for the past few video but idk if this wa the best idea I mean 1 if it haunted you probably just released it spirit into your house and it may just get worse and 2 if it s not that lady is still gon na get hella pissed Idk man this just seems lowkey wrong maybe you should ve just given it away like she did
cheerskiitten kitty	Loved the video load it made me smile load and we all love you very much no matter what you do
Adrianna Sims	Whoever called you had to 67 before they dialed
xx_Queen_ xx	Jake I love you but you have a unhealthy obsession with burning haunted as stuff
Marika Taylor	You shouldn t have done that jake
Meg Foreman	I watched this right before I went to bed I hate myself
Marissa Jay	Y ‚Äô all need some Jesus
Queen Weird	This is so ypu shouldn t ever burn haunted thing It release the spirt and it make it unhappy Dont burn haunted thing
Bree Rose	Alrighty roo So because you don ‚Äô t know what kind of entity wa attached to the doll it wasn ‚Äô t the best idea to burn it because if there ‚Äô s a dark entity attached you just burned the vessel it wa contained in or connected with which can release the entity so you worst case scenario could ‚Äô ve screwed yourself and the roommate
Bailey Holloway	Im watching this at night at 9 40 it s doesn t seem that scary but it is Because I ve already started this video and now I have to go to the bathroom The scariest thing is I have to go outside so in the dark alone with no light freezing T
mari sanchez	am i the only one that see neon purple eye i don ‚Äô t see orange
Multifandom Edits	Why TF did you burn it you know you let the spirit free and it s gon na move to another thing ü§¶üòî be safe dumbassüòñüòÇüò≠üò±
angelica solorio	that ‚Äô s my name lolll
Lily Ritchey	üò±üò±üò±üò±üò´üò®üòìüò©spooky scary angelica sends shiver down your spine
Autumn Bowens	Orange eye I thought they were pink ü§îüòÇ
Tamia Simms	yall are so dead
Ilana Poznanski	The doll had a cut on it neck and that didn t burn
cat lover 1234	Eneyone esl realize it face changed
I'm Jesse Evans	I love you Jake webber
Colby_ Hawt	Colby stop humping the FRICKN doll You gon na end up like the girl from the movie ‚Äò The Boy ‚Äô
queen jos	colby is so sexy but please be careful with these type of thing that phone call scared me the most
crybaby libra	I already need an update üòÇüò≠
cris romero	keep making these scary video I m hooked bro this is the reason I followed the rest of the people from the house but then they went blank on me man thanks for feeding u these video
Moon Baby	After the whole dybuuk box thing what else can Jake or Sam do that won t fuck them up
Sarah Cupcake Lala Land	Me yelling at my phone WHY WOULD BURN A DOLL Also me oh what the hell I would of throw it on the trash
RosesofVersailles	Where did you come up with the idea of burning the doll being a good idea
Harley Shepherd	JAKE I LOVE YOU BUT WHYYYYY WOULD YOU BURN IT üòÇ it s scary what if whatever is attached to it end up haunting the house And Colby justtt cleansed the house Hahahaha that suck bro
Nunya Bizness	You really need to get that doll ash away from your house now or thing will go very wrong I know some one who ha delt with some slight thing like that Trust me on this one I will haunt your until you do something
June Couch	Wow
Alexandra Williams	Hello
Heather Oldfield	4 42 her pupil get bigger
Emily Morgan	Aren t you not supposed to burn thing like this
Shealyn Ingalls	Was the area code 207 or wa the time 2 07 if it wa the area code then someone from Maine wa calling you
B R I T N E Y	jake wtf are you doing
Ka boom	Colby is leading Angelica on bro humping her one second then throwing her in a fire the next
Carlee malbeck	We re gon na die we re gon na die we re gon na die we re gon na die we re gon na die üòÇüòÇüòÇüòÇüòÇüòÇ
Grace Philomena	üéº why do I watch dumbass that do dumb shit late at niteeeeeeeeeeeeeeeeeeeeeeeeeeeee üéº in robot voice
Bella Zook	Breaking News Jake Burns His Adopted Daughter
Unknown Grudge	You just angered them also disrespected them I should be very careful if I were you
Keekee Xox	If you burn an item which a spirit is attached to The spirit will most likely attach itself to a near by item person or place Burning item which carry spirit is so dangerous manüò´ ya ‚Äô ll will never learn will yaüòÇüòÇüòÇüòÇ
Cat Rodriguez	Dude am I the only one that buy haunted stuff an try the same thing a Jake lol
Umi Echo	Hope you guy will be okay after doing that if I wa you i d be watching my every step
Dilara Caki	please do a second part of this video like did anything happened after that did the lady called or said anything after you burned the doll i m kinda into this haunted situation at the house haha
Megan Scott	There s this stuff called Dark Energy out in space It interacts with stuff in space but we can t see it And there is no way that it can be contained just in space So maybe it s affecting all the haunted stuff
Loki	That wa a really really bad move to burn it on your property or burning it at all good luck with that mighta wanted to ask the red book what the outcome woulda been first
Adriana Molina	Bro love your new hairüôèüôèüôè
Irah zuzu	Can I still keep you in my closet JakeüòÄ
Infle ctiun	You ‚Äô re so fucken cute üòçüíï
Fighting Angel	I ‚Äô m watching this at 9 00 so perfect timing for the video and yeah‚Ä¶I have creepy doll that sit on the shelf beside me I sleep near them and I ‚Äô m terrified of those doll Anyways burning it can actually bring the spirit ‚Äô s demon out and can be free to reincarnate to be attached to another time or a being I actually had a major nightmare form those doll and this wa after I touched one after a few month but it fell down from a storm It wa complicated to say and confusing but it kept saying I made Anna or some name that started with a J or F mad‚Ä¶there is a lot more but if u want me to say about it I will
CNCOwner/ Martinator/Child of God	4 42 or somewhere there I swear that F KING pupil moved I m not even joking üò±üò±
Sara Garcia	Jake dm me I know why it wa doing that
Belle Watkins	Holy shit I wa watching this and right before sam started talking about it going from orange to black my phone vibrated for no reason and when I looked on it nothing wa there kinda scary
Katie McInnis	No effince but y ‚Äô all are stupid
Alexandra Balcazar	Normally when you post video of you burning supposedly haunted shit I ‚Äô m pretty indifferent to it but this video gave me seriously bad vibe you shouldn ‚Äô t have done that dude
Music N3rd	Ohhh My Gosh WHY WOULD YOU BURN IT YOU JUST PUT YOURSELF IN MORE DANGER JAKE Ppl best hit that like button after all of this
Danielle Rivera	So I m pretty sure you angered the fucking spirit by burning it so uh be safe you bean
BTS Story Of Your Life	Looking forward for the paranormal activity vlog
Neisa Escamilla	I watched before I showered and then I wa seeing thing when I closed my eyesüòÇ
Emily Hunt	10 53 there ‚Äô s a penny in the fire place
√§nniemay May	can we at least get an update üíô
Natashia Ogares	JAKE WHY DID YOU BURN THAT DOLL WE SAY YOU SHOULDN T BUT BUT ü§¶ü§¶
Jenna Dickens	0 54 1 00 Me getting ready to text my crush
JustLiv 4	y all are screwed not gon na lie üôèüôèüìø
XPLR Edits	üñ§üñ§üñ§üñ§üñ§üñ§üñ§üñ§üñ§üñ§üñ§üñ§üñ§üñ§üñ§üñ§üñ§üñ§
Emily atilano	dude thats F14king creppy i wa gon na go to sleep bc i have school tmr T T but tbh im scared a shi now
Gucci Z LOL	Me when I literally saw this title I for real said you fucking dumbass but I still love you üòÇ
Sarah Mills	LMAO I am watching this at 10 PM and I scared the crap out of my self
Poich Lee	Love the hair bro
Nema Jones	That doll is actually really cool looking and I had one kinda like it when I wa yonger
shelby stanley	DUDEEEEEEEE BROOOOOOO you should ‚Äô ve talked to the person who sold your brother the doll because Angelica mean something to her
live your life	You CRAZY
Shay	Y all are f ckedddddd
Smh Rori	JAKE WTF WHY
auds	Can t help but feel this wa a little disrespectful the owner trusted you with her want wanted Angelica to be safe Idk
Alexsa K.	This may be how you die RIPJAKE
Fae t-m	What are you gon na tell that lady how are you going to explained that you set it on fire
Roxana Melissa Majano	Hun y ‚Äô all already haunted Why are you doing this to yourself Sending y ‚Äô all much love and please stay safeüñ§‚úåüèº
tyra dawn	see the title jake honey you ‚Äô re such a dumbass
Pia Alzira Roa	Did you know if you burn a doll that ha a spirit inside it It will now haunt you because the spirit is already free
Montzerrat Arellano	Doesn t the doll remind you of the movie The Boy I think ima do some research if I have time
Gracieee K	I love jake s hair And I m late again
Abby Smith	Aaahh this freak me out Please be careful ‚ô•
Carmela Coursen	The music Intensifying a they were putting out the fire gave me so much anxiety but love you Jake Please stay safe ‚ù§Ô∏è
Hailey Alsbaugh	jit said ‚Äú for 50k like ‚Äù YET HE PUT UP 3 FINGERS üò≠üò≠
Jay is trying her best	This video actually made me uncomfortable and I usually don t feel uncomfortable from this stuff It s because it s a doll I swear
BTS FAN 4 LIFE	WELP THE DOLL
Jenna Marie	you shouldn ‚Äô t have burned it jake
Nine YT	It s 2 30am when I m watching this and I m scared a hell I love scary video but that wa too much for me
Keila Davila	Jake the doll give me the creep ode
Savannah Ya Girl	421st üòãü§ûüèª
testube66	Omg terrifying
ameisha ganggg	I love Jake so much
Jpeli10	Omg at 7 52 at the top right of the fire place there is to stick hand that move really fast
HyunGi Kim	The doll s burnt face scare me For a sec there I thought her mouth is moving üòÖ
Alayshia Rivera	dude you literally like your literally just screwed your self That like saying I m going to burn the ouija board you just let whatever spirit wa in there free it wa trapped for a reason God have mercy on your soul
Melissa Fletcher	the doll almost look like it ‚Äô s either going to come back to life or kill u guy
Jay B	did anyone see the thing in the doll eye like after they burn it plz tell me someone did see the creepy thing in the doll eye
Yemili Cruz	At 4 42 the doll pupil get bigger and then get smaller
Amanda Blake	Colby is color blind Silly Angelica s eye are purple
Bobbie Houser	Okay this wa a lot creepier than I thought it wa going to be
XxrobloxmoodxX	I wan na know why Colby is the most inappropriate person in the trap house Plus at 4 42 it look like the pupil are moving Also when you burnt the fall and the eye changed color that mostly mean the soul is leaving the body I know freaky right
Cody Ragan	You should have recorded it moving
Catherine Bolding	wait you know how like 666 is the devil number and if you call it you can come in contact with a spirit maybe it s not ANGELICA but ANGIE the girl that died and MAYBE her arm didn t ignite because you didn t put anything on it MAYBE her eye changed because of flame i believe in this stuff and don t think you can just light stuff on fire but i have no hate towards you or sam or colby i m jut naming the thing that caught my attention and trying to give it an explanation and i m worried about your safety because you re letting demon of all sort into your house i m still surprised a to why you would take her from the dead people place i don t know what it s called LOVE YOU 3 3 3 3 BE SAFEEEEEEE sorry it s so long and you came down here just to read this little sentence
Elizabeth Woodward	Hey love you
band. freak	I fucking love you üòÇüñ§üñ§
TANGYBER	Angelica is crispyyy
Cloe Brown	Early
hereforviolet	Seems like Colby like doll
Purple Sapphie	That is legit my favorite Jonas brother song üòÇ
Kaidence Mason	stupid mf if you bur a doll with a spirit your letting the spirit out u you just want it to haunt you
Colby Brock	OK OK I m done jake I have chill
Queen Zaddy	Jake I bet it wa that fucking doll is doing itüòÇüòÇ2 03ha ha üòÇ2 58
Rissa Long	the different position in the beginning lmaoooo
eli	i wasnt planning on sleeping tonight thanks jake i have school tomorrow D
Unfocused Explore	4 dislike don ‚Äô t disrespect jake like thatüòÇ
Kayla	holy shit this is the most realest shit I ve ever seen
Keeliah Tso	Be like Child s play when the mom threatens to burn Chucky and he said You Fucking bitch SLUT Hahaha idk where my comment went to
Kaylin Hornback	My skin is crawling oml
A Lost Forgotten Sad Spirit	If that friggin doll come back looking like it did when you first got it I quit everything I have a really bad feeling about this I know you re saying it your last scary video but please update u on this
Its_Alexis Hart	Jake Jake jake
grey	this is the fakest thing i have ever watched shoutout to sam and colby for going along with it please dont return to kansa i dont want people to know we re from the same state Jake s trying to attract a younger fanbase oof
Nerupa Yardram	Hhhhhmmmmm wow
Alex Martinez	I m so sorry I forgot to like ur last vid I ll like this one to make up for it üòÇ
Bekah  Dawn	please be more careful messing with these thing i don t want bad thing happening to y all from this
Droopy043	At the end when he got closer it honestly looked like it smiled
Umicupcake Cosplay	Bro you shouldn ‚Äô t have done that
Evil .queen	Omg his hairüòçüòç
Kyleigh Lol	I always like your video but my YouTube doesn ‚Äô t allow it and it make me sad but hopefully it stay liked Love your video ‚ù§Ô∏è
Exzavia Renata	For your sake I hope you haven t just given that spirit the mean to cling on to a human host a it wa safer to be in the doll then attached to the living be safe look after yourself Jake you should have waited for the previous owner to tell you the back story before doing this üíöüíúüíö‚úå
TheJuinSprings Show!	YOUR SCREWED we watch for entertainment and you guy are risking your life and almost dying from spirit and other stuff just for u wow oof
Mina	I hope she like me Wtfüò≠üòÇüòÇ
cloey h	This is so funny ahhhhhhhhüòÇüòÇüòÇüòÇüòÇüòÇ
Jess Ridley	Lmao the person that owned it before is gon na be soooo pissed Lol hope you don t die
exotickawaiigirl	why would you do that that wa risky you could ve released the ghost in her she is dangerous
jasmine /:	i peed my pant
Skye Brookshire	ur literally one of my fav youtubers every and i love you
Krisqueen Xoxo	this reminds me the movie ‚Äú the boy ‚Äù damn
Why Don't We Germany	What is Colby doing to that poor doll üòÇ
Hannah Parrack	I ‚Äô m sorry I love you guy but 1 this wa a bad idea and 2 you were extremely disrespectful and rude to the spirit and that ‚Äô s gon na come back and bite you in the as
ObeyRyan	This is Jake üôéüèª‚Äç‚ôÇÔ∏è üëï üëñ He ha 0 material 1 Like 1 Material P S I ‚Äô m so close to 10küëÄ
Maria Diaz	Why would you burning the damn haunted doll Omg Jake
Jaymee McAliece	Youre a tit lol i wa watching aaron stream tonight lol
Zara Endreen	Jake you shouldn t have burnt her
Annika Berman	Loooovvee the haaaiiirr üòçüòç
Kam2331	I feel like that is super disrespectful in more way then one Also ya it probably gon na haunt you
Joss Boss	Jake your amazing Keep doing what you do As long a you want to at least If your reading this let me know somehow please I highly doubt you are but whatever Just be safe and have fun
Marley Churchman	That ‚Äô s so horrifying omggg
Hallie Colon	Donald Trump wa calling you lol
Daisy Rodriguez	Am I the only one who noticed the doll arm move
NotQuite Human	Watch out jake I mean it She will get u
ellie o	take care of the doll a if it your own she say light doll on fire
hailey and cali	i love you
Ashley Gameing	bruh i wish i wa that doll
Kyndra Whitlock	In t he begging of this vid I wa just laying in bed now I m in a ball of fear with stuffed animal around me Thanks jake Sam and colby
Lilac FireRose	1 He gon na be haunted forever 2 He gon na have nightmare 3 He going to see thing like shadow He is definitely screwed üòê
Oh my girl miracle	NEVER OPEN A DYBBUK BOX jake open the dybbuk box DONT BURN THE BOX jake burn the box Lady KEEP THE DOLL SAFE jake burn the doll Jake honey are you okay
Becca Martin	Now get rid of the remains and burry them somewhere far away from the house üòÇ
hayley geyer	BROOOOOOO
Trash	Jake you dumb bitch Ily tho
Leah Ball	Burrrrnnn meeeee toooo dddeeeeaaattthhh ii aammm nooo lloonngggeeerrr wwweeelllccooommeee hhheeerrrree iiii wiiissshhhh ttooo reetttuuuurrrnn ttooo wwwheeerrrreeee iiiiiii ssshhhhooouuuullldd bbbeee
They LoveTatum	Uwu üíÄüíÄüíÄüëÄüëÄüëÄ‚ÄºÔ∏è‚ÄºÔ∏è‚ÄºÔ∏è
Kaz Winters	We already know it ‚Äô s haunted so what the hell jake üòÇ
paranoia.syndicate	everyone is like NO DON T BURN THE DOLL YOU LL DIEEEE my religion say belief that burning haunted item including ouija board are supposed to be burnt until there s nothing left it s the safest way to dispose of the item the demon s that posse the item left and do not usually cling to you however if they do then you must have your entire house blessed and you must carry protection with you at all time until you feel 100 safe
Imanii Muller-Malone	i am sitting here alone in my haunted house with 2 porcelain doll FML
Loserskwad	BOI
Emily Anderson	Thats so bad y all
Uni Eli	I like your hair
JJ Sandhu	Colby üòÇ
Jordyn Uecker	50 view 839 like 262 ok yea YouTube are you ok
Jongdae Seok-Jin	sISTER If you get possessed by a demon bitch you better call ghost buster so they can grab their ghost vacuum and suck the demon out of you
QUEEN- rose	I don t like buying doll from people now Oof
Min Wolfy	What have u done jake
Lizzie _	I m more uncomfortable with this than I wa with the Dybbuk box
Annabelle	207 is a Maine phone number üñ§
LIL BABY MANI	y all should ve smashed it and kept burning it
Chaotic Potato 0w0	Y all is crazy it not destroying it ur releasing it think back to the dibux box
Brie Surrae	Bro I can t even Like WTF Bro
xxangel101	In the beginning of the video jake said 50 000 like and then held up a 3 and a 0 Jake are you ok
Onyx Blurr	Send help üÜò
Unknown50567 1	Early squad where u at
DeltaLucario :3	Jake When u burn somthing it release the spirit attached to it back into the world or onto yourself PLEASE STOP BURNING THINGS
Jack shadow123	It was100 the fucking doll calling you how fast it called back seems like what wa trying to call you wa angry I got a feeling you guy fucked up that doll is the only thing that ha gotten me worried just from looking at it out of all the thing you guy have done
ya local spoopy gay	hmm 3000 view yet there only 2000 like Something isn t right
Kaylynn Rose	When you burn something with an entity attached to it you are releasing the entity
Giselle M	are we surprised that jake is a dumbass once again
Kallie Rose	thats not that smart it will probs haunt u
some one	oh no
Tay is A piggay	The intro is legit me in school
colby brock is my husband	that doll is a lucky son of a bitch
Mysterious Weird girl	Omg I clicked on this video so fast
Mary Porter	redruM
Elanoar Elizabeth	I WAS SO HAPPY WHEN I GOT THE NOTIF THAT YOU UPLOADED
tayuyya uchiha	That doll would be beautiful if she wasnt possessed and had blood all over it
Emily Blood	Man I wa about to go to bed but I saw this and now im here
Turtle Girl 571	Sam s face at 4 51 wa just like yep that s my best friend ok then üòÇüòÇ
Samantha Ruiz	ü§ôüèºüëæüëæüëæüëæüß°üß°üß°üñ§üñ§üíö
TigerTiger Girl38	Plz be careful jake üíóüíóüíóüíó
Vinnie Conforti	Omg there wa a comment that said this wa a mistake and the comment wa from a person named ANGELICA
_Bonnie_	love it
lol yeols	the expression on the doll face while it wa burning ha to be the most haunting thing i ve ever seen
Ashlee And John Wayne	Love you jakeüòçüòçüòò
Diamond's GachaLife	That doll is a mystery
Misty Donahue	You best be moving out of that house and get a priest
Orsal Stone	So Brennan wanted you guy to destroy the doll and Colby said he ha to ask the roommate and I m assuming you all collectively decided to destroy the doll üòÇ
Mashedpotato01	4 42 it look like it pupil move I m spooked holy crap
Tahlyia Jade	Colby made me laugh so much which made me feel better üòÇ also I ‚Äô m starting YouTube and i will greatly appreciate if you check it out ‚ù§Ô∏è
Mak Lawe	wtf Jake why why would you do that why would you burn it on your property YOU HAD ONE JOB JAKE ONE JOB you know something better than burning it BURRING IT SOME WHERE OFF YOUR PROPERTY CUZ YOU KNOW WHEN PEOPLE DIE THEY GET BURIED
Adrianna Gibson	WHHHY
lil uwu	odd flex but ok
Joshua Cofield	Watch out that certain big smoke cloud from the doll face wa the spirit going away
Zoey Marie	new friend add me on Insta zoey marie516 my snap zoey ann16
Jungkook ismybias	THIS WAS SO FUCKING SCARY OH MY GOSH
kayla pate	early comment yaa love the video
Flora Jung	I think u shouldn t have burn that doll because u only brought her spirit into ur house when you first burn it
Makayla Vance	Hey
Anna Rose	I read the title and thought ‚Äú shit Jake you messed up ‚Äù
MXL	Everytime I watch video like this I always think im gon na get affected somehow and like have weird shit happen
Jamie Borgia	Everytime you zone in on those creepy as eye I can t even stand to look at them it so fucking creepy dude
band nerd	Jake you should have throwing the doll over the fence have neighbor deal with it
Zia Jazman	Such a bad idea
Jorie Alizabeth	Jake omfg DO U WAN NA DIE OR SMTHN
TygraLilly :3	You guy should of done your research before destroying the doll because by destroying the doll you released whatever spirit demon or whatever that wa inside it
Jane Arkensaw	omg i love jakes new hair color
zoey hicks	508
Lilkitty Texas	Mk I m wishing y all the best and wow that wa intense so goodluck also I would recommend praying
Team Wolfie	Im glad u guy burned the doll but still plzzzzz be careful wit haunted thing plzzzzzzz
Yari Bradley	this video wa xtra scary
Ur dad	OMYGOD
Lily Torrez	As the video wa ending I wa a little scared Not gon na lie But his altro music make every video better üòÇüòÇ
Wanna be meme Lol	Hm maybe it ‚Äô s a bad idea because the god damn doll is haunted maybe idk when you burnt her and stuff her spirt came out of the doll and will haunt you because you fricken burnt her idk
Jenn Dumont	Thats crazy omg
Mikayla Little	You guy better be careful it very dangerous
Sydney Rose	Colby I ‚Äô m a sociopath SHANE DAWSON BUSTS THE DOOR DOWN
Eliseo Geraldo	legend ha it that if you reply early enough he will respond
Misty Cloverfield	That wa the stupidest thing you could have done
sakura urchia	Plz don t die YouTube need you please be safe and love your video
zee smy	Jake y u so stupid
Cara Luster	Jakes logic Theres a demon in this doll And if i burn it it will release it and haunt me forever Fuck yeah throw some gasoline on that bitch
Ophles	OF COURSE ITS A BAD IDEAüëèüëèüëèüëè BRUH
lauryn .m	Hiüñ§
Hailey Farr	angelica is super creepy i wish reggie kept it
Maggie's weird animations	Oh God nooo don t burn her nooooooooooooooooo
XPLR Girl	I wa sitting in my living room and I wa like DUH ITS A BAD IDEA and my mom wa just like wtf
Sam goldencock !	That wa so stupid guy like bro she is pissed off now
Bethany Evans	This wa bad I idea to watch this pretty much at 1 00 and I need to go to school tomorrow also whyy jake u messed up pls stay safe
Ajla Mujic	Omg Colby ‚Äô s a sociopath SHANE DAWSON PLEASE DO A DOCUMENTARY
Colby's Editz	jake I
Al	ok i love your video but wow jake first you burn a box and now a doll both being possessed by a spirit both which you have now set free i hope you guy are safe but just wow
Pastel Prince	THIS SCARED THE SHIT OUTTA ME DAD
Cadence Stephens	Plz be careful guy I love u guy sm plz be safeüíïüò≠
Kaylee Stowell	i ‚Äô m not an expert on this stuff but i rly don ‚Äô t think u should ‚Äô ve done that ‚òπÔ∏è
Slade Congo	Bro your safety
Brooke Wood	That ‚Äô s creepy
iSMILE -	GOT THE CHILLS
anddielove	BRUH
Kenzie Mendelson	Jake I hope you didn t open a portal after burning the doll please be careful I love youüòçüñ§
foxy xxx	Earlyyy shhisteerr
HannahSocial XD	0 16 ‚Äú 50 thousand like doe hand motion of 30 ‚Äù üëèüèº only Jake
brooke lynn	Scary shit Glad you guy are okay Who wa calling you Stay safe
libby larson	I can t wait for the day that the girl who sold Reggie this see the videosüòÇ
J√™≈Ç≈Ç√øw√§√±t≈°f√¥√¥d	I hope your gon na be okay after you burn the doll but ilysm jakeüíï üíù Stay safe please üôèüèΩ
Ange1ina _O	this wa wild wtf
Sarah Faretta	me and jakes hair match
ashley longmuir	You don ‚Äô t have to but you should try to burn the rest of her arm I don ‚Äô t want to see you get hurt so you don ‚Äô t have too
Alan Diaz	Damn bro U let it out
Brailyn Truman	I wa watching this and the light behind me is literally flickering ü§™üò±üíÄ
Belicia Granado	Jake ur so adorable üòãüòÜ
Shayla Job	You put the fire out three time SHE called you three time and that equal She s coming for you man she s pissed off
Esmeralda Cisneros	Jake wtf Dude why couldn t you just give it back to the lady you released something that you aren t aware of This is so dangerous please please be careful We love you üñ§üò•üò• please be careful
Keyla Salinas	OMG
Kellie Klein	Jake this doll is very scary just burn it
Madison QR	God damn took ya long enough to post this week üòÇüò≠üòÇüò≠
Ash Cat	I have a really bad feeling after watching that doll burn I hope you guy just didn t screw urselves over
Janicide	It s getting to the point where if Jake and his roommate mysteriously die outta know where I wouldn t even be surprised
Ashley Amell	I swear I saw it blink just when Colby said yeah bitch light it up
Mack Cauxgiin Ward	Play the midnight game
Lily pad	oh my Jake
keith	You know what would be creepy if they wake up go down stair the next morning and the doll look the same before they burnt her sitting on the couch
Skye Wooley	omg im so early this time love the video i just hope everything turn out okay
Band trash	I ‚Äô m to tired for this shite but ok
yikesroxi	oh hell no I would ve ran a soon a the phone started ringing
ariana wyndham	Oh nooo
Dragonfly Fly away220	I GOT HIM DAT FIRST LIKE BRUH
Weronika Kathrein	Hi
MiLo Official	almost every video Jakes hair is a different colorüòÇ
mya major	Plz be careful Jake Sam and Colby
Ava Yee	Jake I ‚Äô m scared Me when my teacher is passing out our test
sophia bailey	i love youuuuuuuuuu ugh ur such a daddy tbh
Emilia Ashby	she always freaking scared me üí´üí´ and you always NEVER EVER BURN ANYTHING THAT THAT TRUST MEE LOTS OF THINGS WILL HAPPEN TO YOU LIKE YOU WILL HEAR STUFF IM NOT TRYING TO SCARE YOU BUT IM
Brianna Wise	sings the if your happy and you know it song if you think this is a bad idea clap your hand üëèüëè if you think this is a bad idea clap your hand üëèüëè if you think this is a bad idea and they re about to die clap your hand üëèüëè
Maliyah Houston	Why is the rest of the video black Edit Never mind my phone wa bugging out I need to stop watching scary video at night üòÇ
#BROBY4LIFE #SOBY4LIFE	Hi
Weird Bri	WELP FUCK THIS SHIT IM OUT Continues to watch even tho I wan na leave
dalia Madrid	Also Jake u might want to be careful
It's Shay	PART THREE
George Brown	bro cant believe u did this hope no bad karma
Sophia Amori	Ok so I watched Colby ‚Äô s video today and I wa looking at the comment and I saw half of them saying DONT BURN THE DOLL YOU ARE GOING TO SET THE SPIRIT FREE and here we are
Midajah Jesso	luv u jakey poo
Emma Tyndall	Why tf am I watching this at night ü§¶‚Äç‚ôÄÔ∏è
Juliet Hepburn	Love your hair
Bella Ella	Yep YouTube 2 view and 254 like
Vladimir ***	shoutout in the next vid pls
Stone_hearted_girl 13	KILL IT WITH FIRE This is why I don ‚Äô t have normal friend Most people think I should be locked up
skyylar__	Your hair üò™‚ù§
Summer Mcgachey	DUDE ARE YOU TRYING TO KILL URSELF
Emily Preece	It is nearly 1am where i am im home alone and already managed to spook my self shitless earlier so let ‚Äô s see what happens after i watch this
katelyn lhamon	Just saying love the video but when you go to get rid of stuff that ‚Äô s haunted I ‚Äô d look it up an see how to get rid of it properly for safety but hey I have no say in that lol you do you boo
Drew Drummond	I have to sleep with my mommy now
charlie caddy	Clicked a soon a it popped up
Kalina Lozano	We love an Usher preference üò´üò´
IVY DUH	Why is colby in love with that doll like what Lol
Melissa Lethco	Dude AT 5 50 A GIRL S VOICE CAME THROUGH THAT WAS RIGHT BEFORE YOU BURNED HER AT 7 17 A CREEPY MAN WHISPERS SOMETHING CAN T MAKE IT OUT AND THE SOUND ON THE CAMERA IS MSSED UP 7 48 MANS VOICE IS WHISPERING SOMETHING AGAIN 8 4 A WHISPER AT10 24 WHISPER SAYYS HAAAA VERY CREEPY SOUND THAT PHONE CALL WAS PROBABLY PARANORMAL BECAUSE OF YOU BURNING THAT DOLL THERE WERESPIRITS THERE SPEAKING THROUGH YOUR CAMERA
Caylee And friends	Burn the hand in the morning call the woman who Owens ‚Äô s it move out the house don ‚Äô t say anything about doll get the fu k away
Tegan Lynn	This is why we can ‚Äô t have nice thing
Janet Pe√±a	That s scaryüòï
Melissa Ford	Jake please be careful
dimond shine	you shouldn t burn the doll because you released the spirit in to our world so you most likely won t get the soul into the doll let alone it said it lived in the doll
Jaiden Thies	Jake smh bad idea
Kitana Tadych	Jake Hey Me oh hi jake how are you Good Well im going to kill you if you hurt yourself or anyone else in the house Mk go ahead with the video love ya
Isaiah Kithcart	4 41 she look 1 cm over at the camera
Isabelle Lol	Saw this video and thought I love Jake playing with scary stuff sooooooooooooooooooooooo let ‚Äô s click on this at half twelve in the morning with one person üò≠üò≠üò≠ so scared I ‚Äô m soooooooo stupid
Karina Del Castillo	You should have put salt
Macey Tuffy	You ‚Äô re crazy But no do more scary video I love them
Samster Sam	Omg that ‚Äô s just oh god ook bye that is way to weird
Emma Cheshek	This wa absolutely terrifying
LaElA	OOF
Eliana Ulufale	Ilysm visit Maui someday
Megan Stowell	I ‚Äô m going to shit my pant
Saryn Morrissey	Im early oof xd
Citlali Moreno	Love you
Bobby Smith	the doll didnt hurt you why didnt you just give her to somone else thats so evil the sprit probable just want to be loved
Lynn Rhoads	Sure it s a good thing to do it before Halloween üòÇüòÇüòÇ
Daniela Sos	Purple Hair üíúüíúüëèüèªüëèüèªüëèüèª
Random Ryleeness	Omg jake
M	oh HELLL no
Bella's vlogs	JAKE POSTED LOVE U JAKE YOU AR SO FUNNY
Annika Ramsey	Love u jake
Erin Duffy	ooof please dont die
Kayla Hoogerzeil	So you burned two thing that shouldn t have been burned Have you learned your lesson yet Actually nevermind you never willüòÇ Love you but please don t die and get all the roommate dead tooüò≠‚ù§
Amber Ruiz	I feel weird that doll
danielphilip	when there s more like than view
Marina Cox	I luv u ‚ù§Ô∏è‚ù§Ô∏è‚ù§Ô∏è‚ù§Ô∏è
Kaydance Johnson	Why would you burn it dude
Victoria Stinnett	Tbt when Colby made her hump a ouija board
hi hu g	Wow
Bam And Friends	I ‚Äô m scared üòÇ
Beyond Brooke	Ahh creeeeeeeeepy Good vid tho üëçüèª
Keana Prado	Thumbs up for Kevin ‚Äô s nipple
Riley	And if the lady you got here from watch this
Tabitha Riane	The like on this video is almost 666ü§¶
Breanna Eiden	B O I
Isabelle Organ	im early so i wan na come out and say that i love you sm x
Allison torres	I swear at 5 57 her pupil get wider or is that just me or the camera focusing
Isabela West	this is scary and this is the best comment ever
Kaylyn-Rae Trenka	NOTIF SQUADDDD‚ù§Ô∏è‚ù§Ô∏è‚ù§Ô∏è
Christina Hausser	you guy all have death wish i swear üòÇüòÇ
derpy lettuce	Jake your gon na die with that doll o o
Shelbey Anderson	Ok but where can I get Colby ‚Äô s jacket üòÇü§òüèª
Avery Crofts	I wa waiting for this üòÇ
Dead Soulzz	Jake
13. Shelby 13	we love a purple QUEEN YAAAAAAS GET IT JAKE
Owenthompson sports	Jake you re an idiot jk love your video but you made a stupid mistake I here
Adi H	jake you are just physco but u rock
Viyaa	I m scaaaaared it s 1 46am and I m watching this and scurry stuff is happening atm aaaa
Gianna Post	i ‚Äô m scared for him cause normally it ‚Äô s not ok to burn stuff with spirit in it üòÇ but i mean jake you do you i hope you ‚Äô re safe‚ô•Ô∏è‚ô•Ô∏è
Cailin Werner	5 30 the doll mouth opened I little
Rose The Gamer	earlysquad
Lil Yeet	My name is Angelica
kimmi bowlin	love you
Ala Haesel	292nd comment
Mahek Musani	AYYYE EARLY SQUADDD LOVE YOU JAKEY
Glee Aldc	I m sister early kween jake but I m not but I am but I m scared
Nadia M	I rlly dont think y all should have burned her I m worried now
michaela	Spooky Shister ü§™üíì I ‚Äô m ready but I ‚Äô m not but I am but I ‚Äô m scared Jake 2k18
jaidan infante	omg i love you
Fernanda Medrano	Creepy dollüôÅ Jake‚ù§Ô∏è
Sara Jendrusik	Woot Like 948 ü§ò
Keren Poole	Me I shouldn t be watching these video at night Also me But they re so much fun to watch üòÇüòÇüòÇ
Capt‚Äôn Normie	Gang shit
Bunny Shark	Nice
Britney Andino	You guy probably forgot to like the last video it happens Jake Webber 2k18
Kerielys Mora	we stan your purple hair ü§©ü§©üíú
Sara Saralynn	ok idk if i wa seeing thing but around 5 42 5 43 i think her mouth moved just a little i could be wrong but i swear it moved
Arianna Hill	lmao the 2 dislike are from Angelica and the one who sold herü§£
Trysta Hartis	Jake your not supposed to do this I can ‚Äô t believe you ‚Äô ve done this üò≠üòÇ
Klarissa Mendez	No Nameüö´‚ò¢
PastaGlitter	please don t die
Autumn R.	love you burn the hell outta that bish
Kaylee Gerdvil	ILYSM
Christopher Ervin	Please Be careful jake
Marissa Mcnair0x0	Y ‚Äô all should ‚Äô ve set her up with a camera overnight or for a while and see if she would move but oh well
Fatima03	You are so entertaining
Heyitssammykid	hey
Anna! At the Disco	YASS I love you Jake Be careful and keep putting a smile on my face üòòüòò
Tick Tock	your awesome
PiercetheBunny 187	me and my friend were just talking about burning that doll and now im fucking shook bc you posted this video WTF I CALLED IT I KNEW YOU WERE GON NA BURN IT LIKE IM SHOOKETH TO THE CORE RN
Ostrich117 _	Love y all
Billie .17	Jake I love you and all BUT YOU DUMB FUCK DON T BURN THE DAMN DOLL EVEN THO YOU DID THAT DOLL DEMON WILL RIP YOUR ASSHOLE OUT AND SHOVE IT UP YOUR NOSE THEN RIP OFF YOUR EYEBROWS I m sorry Jake Don t do stupid shit like that
lil colb	why is burning it always your solution
SMJ Vlogs	I LOVE YOU SO MUCHüíñüíñüíñüíñüíñ
eeth mccaw	There can t be no haunted doll if the doll don t exist
Kayla Miller	It didn ‚Äô t notify me I got the notification only on Twitter again
Kate X	He switched from the orange hair so fast I would ve too dude
rain berriess	we stan a spooky boi
Mini Moose	Oh no
Kyndall Gillenwater	Omg Jake that wa a very bad idea Wtf were you thinking We love you ‚ù§Ô∏è
Tera1 Tyler2 Toby3	jake you ll like this one though me look at the like 0 like me hm sad
kalm 1304	Why doe this definitely not sound like a good idea at all Please be safe I swear you guy in that house are so not good for my nerve and heart lol but also I love these video lol
Anna Kacer	Oh boy ü§¶üèª‚Äç‚ôÄÔ∏è
Ciara Shrader	WHY THE FUCK DID YOU BURN THE DOLL ITS JUST LIKE A OUIJI BOARD YOU ARENT SUPPOSED TO BURN CURSED THINGS YOU SHOULDNT HAVE DONE THAT IM WORRIED ABOUT YOU GUYS NOW
Alicia Ortiz	you re fucking stupid jake ughhhhhhh
Donna Stokes	Its gon na come back for uüëøüòàüòàüòà
Kid DMP	I only sub to you gy so i can see u do dumb shit like this üòÇ
Haley Patel	Ooof üòÖüò±üò®
Ruby Jimenez	All that came to mind when I got the notification for the video wa no you fucking did but yes you fucking did omg
Liana Watson	Please be safe i love you and the roommate so much You guy are the only reason not dramatic i m actually serious i wake up happy in the morning
Hailey	Whhhhyyyyyyy did you burn it Jake Why
Jadyn Oxley	Stupid idea
Karla Talavera	Luv u Jake ‚ô•Ô∏è
Aesthetic Moon	I ‚Äô ve been waiting si
Sophey Morris	Gosh dang it Jake you are not supposed to burn doll with spirit
alex the gay boi	no whyyy I m wanted her no matter how possessed ü§†üò≠
Issy Snow	I love ur hair
carmira ferrell	Love you jake
Aimee Thielman	Please be careful PS I think this wa a bad idea
Madison Feht	Shishter spooky
play gaming	yo
Luchi Catania	Honestly I m not even surprised it s Jake who we re talking about c mon hahshha be careful you idiotüíû rocking that hair color btw
Lauren Reed	YAAssssssssss jake good for you That thing frickin creepy Btw love ur hair but dont we all
Jade Pirrone	Heyyyyüíú
Brandi Jack	No no no you did not you really did not stop this is bad your bad bad bad bad you did frick no no ahhhhh
MastermindJenn	Haven ‚Äô t even started the video and I ‚Äô m already scared for Jake‚Ä¶
Mia Cardenas	HI
Aphmau The Wear Wolf	I love u so much Pls stay safe
- HyperWaveHero -	Apparently this ha 2 view but 117 comment And 550 like XD
Emmy Johnson	üíúüíúüíú
Samantha Roussell	I ‚Äô m gon na miss herüòÇ I love you
Winter MoonFrost	Notifications on point üñ§ btw your hair is perfect I love the color
gabbyplaysmsp 13	Oml this doll again
Klyn Alexander	im really early so hey love 3
victoria ray	Be carful with burning haunted item Jake they can be really dangerous
Alicia Ponzar	I love you so much and all your amazing video
yurikeu	IM SOOO FAST RN I LOVE U JAKEüíñüíñüíñ
Katie Burbank	Yaaasss ‚ù£
Cheese Fry	BRO an add with a baby popped up and I thought you were gon na burn the baby üò±üòÇ
E Peterson	it say 535 like but only two view
Avinash Maikoo	Hi
Eva Savannah	first the box now the doll imagine being this dumb
Broke bitch Dum 304	Why is the quality so bad
Michelle Anders	Good video
Sushi Dang	Hmm 2 view and 432 like and 137 comment
faithy bug	Yeah it s a bad idea it better to keep a bad spirit locked up not set it free where it can latch on to any soul lingering around you
Aundia Bastanipour	i have fun u know u could do so many other stuff for view but u wouldnt be u without ur craziness and ur mind that decides to do random shit
nadia knutsen	YOU BITCH WHY WOULD YOU KILL ANGELICA
HOLY SCHNAPP	Earlyyy
Selena Rivera	JAKEY BAB BOY
Trevor Christiansen	Here we go haunting the house even more
Amazingly ok	I seen the video clicked a fast a i could and then i comprehended what it said then j said YOU F NG DIDINT JAKE OH HELL NO
Desert Fox	Jake I don t think burning the doll wa a good idea The spirit could get loose and can attach to you or the house
Jazmin Bucholz	I love you guy
I'M DEAD INSIDE	Hi Jake be careful plz üôÉ
Anna Fest	Good idea üëèüëè
BriBriClark	Omg Sam talked you into it I haven ‚Äô t watched this but I think burning it let out the spirit
Natalie Davidson	That is a bad idea
Faith Brown	Earlllyyyyy ayyyeee
Moon_ Light	Did you not learn your lesson to not burn thing after the Dybbuk Boxü§¶‚Äç‚ôÄÔ∏è
Brianna Eidt	Love you so much
Dylan Navarrette	Ayeeeee
Jessamine Olson	love u
Yeemo Bands	JAKE WHY WOULD YOU DO THIS
Yeemo 928374	157th
Chloe Babbitt	Be safe In other word don t die
Emma B	ily 3 3
Luke Carty	Jake like you know just go over to the doll and be like hauntn t
Sammy Wdw	Im boutta have nightmare but fuck it i love spooky stuffüíÄ
Aubrey Corn	ü§¶üèª‚Äç‚ôÄÔ∏è my reaction when I saw the title üòÇ
Summer Nowwis	EARLY SHISHTARS
Red Queen	The fact that im on punishment and EVERY youtuber i watch post omfg
Jaylene Mcfarlane	i clicked so fast
Sophia Hay	why would you burn a haunted doll SHE TOLD YOU TO KEEP IT SAFEEEEE
Demon Players	You fucking dumb as you going to be haunted for life yall are strait up fucked yall should have never burned the doll Idk if I should still be subscribed because I find this very disrespectful Idk if it bacause I m emo or pretty much studying whitchcraft but what y all did to that doll is not right well RIP to yall and if it doesn t happen then good but still stay safe
Leslie Kennedy	Hi jake I luv u‚ù§üî•
Gracie Morrison	everyone is posting im so happy
Emily Hallard	Wowwww
Megan Lester	Love you jakey
Isaac Wood	Hey jake
Lizzia Peggerson	Bitch I thought you guy learned your lesson You SHOULDNT BURN HAUNTED STUFF THATS NOT HOW TO GET RID OF IT I ‚Äô m so tRIgGeReD
April Ramirez	Hi
maddy bock	I love you I wish he would reply
Marnia Owens	I love you and your vids jake
Kaylee Denton	hi
Mariceli Olvera	Kind of first lol
Person Dude	Angelica is just plain creepy
Kamber Stormy-Rainn	Early squad JAKE
Shareka J.	Notif squaaaad love you Jake
Rosaura Romero	WAIT HOLD THE F UP THATS YOUR DOLL THAT WAS IN COLBYS VIDEO WHAT ARE YOU DOING WITH YOUR LIFE JAKE
Emily R	üíúüíôüíúüíô
Madison Gutierrez	HI JAKEEEEEE I LOVE YOUR VIDEOS BUT BE SAFEüñ§üñ§üñ§üñ§üñ§
Pin-HeadLegend	Angelica can t watch me at night anymore if you burn it
jessica runion	No no no no Wtf no jake u r going to get hurt by what ever it is
:3 Sarah	Somtimes I think‚Ä¶you don ‚Äô t‚Ä¶ I love you tho‚ù§Ô∏èüòÇüòÇüòÇüòÇ
Angelina Maria	üîî NOTIFICATION SQUAD WYAA üîî
Kwishanti Webster	oHhhhhH HELLLLLLLLLL YEAAAAA
Jane JJ Szutu	Happy Early Halloween Day Jake Webber üòàüòàüòà
notreally brooklin	Oh God üòÇ
Angelica Agostini	NO NO NOO OMG I READ THE TITLE AND MY HEART SANK JAKE THIS WAS A MISTAKE i have a similar story to this and it wasnt so well you let go of whatever wa in that doll to your house or yourselves god bless you guy stop taking all this shit lightly dude im telling you something is wrong
brionna davenport	Hey Jake i love you so much üíò
Nana_ Kae	Please stay safe Jake üñ§ Ily
KidConrad Conrad	Jake you really messed up this time I mean I understand that you make scary video but your really scaring me right now
Elliott Playz	i love you jake ‚ù§Ô∏è no homo üò§üò§ notification squad üò§üÖ±Ô∏èüíØ
Princess Edwards	When your early and don t know what to comment
it's Nini	OMG he s gone insane
niightdreamer	Jake omg üòÇ‚ù§Ô∏è
Ellie Robertson	jake uploads and suddenly I ‚Äô m the happiest ever
Aimee Bowling	Post notification on üñ§ PS I stopped watching Kian and Jc s video for this üòÇüòÇ love you Jake
Fortnite Boy	Why
Lps WOLFIE	Oof wow üòÇ
Seddiqa Said	Post notification always ü§™üíïüôãüèΩ‚Äç‚ôÄÔ∏è
Unicorn Poop	4th COMMENT YAYYY
Yoongi Three Dollar Swag	Why do you always post when I need to sleep
Emily Ham	i love you but sometimes you are stupid
Issa Colby	ShitüòÇ
Clarissa Cura	Omg I wa waiting for this üò≠‚ù§Ô∏è
Izzy Paynter	Wow I m early wut
Grace Wozek	that wa a stupid idea
Rin The demon	Dude jake this wa scary I LOVED IT Thank you for being so brave And thanks for being amazing and AWSOME
Emo Nicole	Love you jake
TaehyungBias YoongiBias	Jake be careful doing thing like this Anyway good video boiii
Jackie 2020	Jake I love ya üòò
Isabella August	JAKE NO
LeAnne Favors	Notification SQUADDD WHERE U AT
41lexibaby	I clicked so fast üòÇüíû
Emilee Rocks	Did you really think that wa a good idea But love youuu‚ù§Ô∏è
Amanda And Riley	Why jake why
Polarpunk_ 72	üñ§üíúüòàAhhhh I love your hairüòàüíúüñ§
Golbach and Brock	What are you guy being for Halloween üëª
Beq Meq	Wassup jork wobsters
Sofia Vazquez	I am sooo early Hi Jakeüíï
Karekare Lifey	Notifications squad where the fuck are uüñ§üñ§üñ§üñ§üñ§üñ§üíôüíôüíôüê®üê®
Angie Bujanda	Hey hope everybody having a great day
Ava Gagnier	HELLOO
Madelyn	üíûüíû
Jessica Connelly	JAKE I LOVE YOU
hannah koppenhaver	Probably not the best idea Don ‚Äô t die
Amelia Sites	um ok the begging ha me shook asf
Kayleigh Alyssa	i ‚Äô m actually earlyü§∑üèΩ‚Äç‚ôÄÔ∏è‚ù§Ô∏è
Jackson McCracken	I love you Jake
Megan Cordova	I love you and you ‚Äô re video ‚ù§Ô∏è‚ù§Ô∏è
Brianne Nierenhausen	NO OMG JAKE WTF YOUR ACTUALLY GON NA DIE
Elise is spooky trash	We love an early Shister üíÅüèΩ‚Äç‚ôÄÔ∏èüíû
lilyxbrock ::	WHY JAKE üòÇ
Eli ___	Angelica ELIZA and peggy
Kiara and Leauna	And what ‚Äô s your favorite vine
louise sander	Love you Jake I wa the first like on this video
Angelina Joslin	Hi
Brooklynn 44	‚ò∫Ô∏è
Illeana Miller	Jakeeeee Ilysm
Deathvonsolo	Yeah um pretty sure this wa a bad idea
L I L R I C E B O W L	1st view
XO Elyse	Lovely
midnightwolf27 I LOVE WOLVES	Love you plzzz be carefull
mariah xxcrouchxx	notiffffff squaaaddd
amber kaleigh	notification squaddd
Nyssa Scott	Love October Videos üñ§üñ§
Sempiternal	Ayy üòÇ
Megan and Alenna	I LOVE UüíìüíØ
Raelee Brooks	First like I love you jakeüíôüíô
Kyle Pastel	Oooo no üíôüíúüíöüñ§
Susanne Kelly	First like love you i think the doll is haunted i dont like the look of it hope it dosent kill you in your sleep
Salem Grey	No shit it wa a bad idea
Casey Wilson	you guy are soooo smart hahah
Gage Odom	Hello
Alexia King	Omg I ‚Äô m so early ew
TheAub is Awesome	Love you Jake you re the best
samira Franklin two	Jake be careful I love you
Olivia Grace	Why
100 reasons to love Jungkook	Notification squadüëÄ
It‚Äôs Lee	Heyy in early and I love the scary vids
bella marie	JAKE WHY WOULD YOU DO THISüòÇüò≠üñ§
Dwight Berg	Hiiii
sky Lloyd	AHHH IM EARLY ILY
THE LLAMA QUEEN	Hiii
Jordyn Pace	yay i ‚Äô m early
Babygirl Ali	Clicked sooo fast
sky Vlogs	First like
kaitlyn Patterson	üíò
Lps Maplesugar	1 st
Size Master	Love u
