Hariprasad Malapala	Good exttra ordinary super back ground music by thaman
Basheer Basheer	Thanks to thaman ntr ki manchi music icchavu
partha sarthi	Home coming is the best opening bgm ever
Rama Reddy	24 35
sandeep ventrapragada	Home coming ♥🔥
che guevera	25 49
VIJAY VJ	RRR THOP BGM LINK http youtu be Cf7aenxetA4
Prudhvi Krishna Paruchuri	I listen to this daily What a composition THAMAN
shareef sk	BGM STAR tamman
Geetha Rani	19 04
Gurupadappa Mittha	Yallappa ntr
nagarjuna kumar	Home coming👌👌
Kadimi Kalyan	From 19 04 అరాచకం
potla harinath babu	Super hit bgm
Johnbasha Shaik	Supeer
Prem Chand Yadav	Homecoming bgm is super
Arjun Manda	SUPER
Arun Kumar Gubbala	00 to 1 00 superb
Madan Kumat	Adiresindhi bgm
ASHOK ARASADA	Good movie good bgm highest time watching movie in my life
Appala raju Regani	Superb background score
Balakrishna Gangavarapu	Superrrr brother
Unknown Wolf	Super Music
Vasantha Kumar Lakkineni	Ntr music superb thamans s nice movie
Annappa Kondur	NTR super Tarak
S. Kalesha	Superrrrrrrrrrrrrr Jai NTR Music keka 👍😎😎
Bala Krishna	👌👌👌👌👌✌✌✌✌✌✌✌✌✌
Narayana Majji	Best bgm for thaman s
Lucky 143	Interval bang
Naresh kurakulapalli	Super super super super
Najurulla Basha	Goosebumps
Bala Subramanyam Nimmagadda	Good 1
HARSHA VARDHAN SISTLA	Hat s off It s a SST musical mark
durga prasad	Super BGM Jai ntr
Kandukuri Anand	Give an goose bumbs hads off thaman sir
Praveen kumar Bolem	Superrrrrrbbbbbbbbb
gopi chand	After bahubali The bgm of asvr sst epatikyna tfi lo thaman value telsukondi
Naga Vivek	walk in to peace 3
Yashraj Singh	5 50 there is a hidden pain inside me which i realised at 5 50
Manoz Tech Solutions	Super SST
Tejash Shankar	Good composition
nani paleti	Supar
perike david	superrrrr bgm
R Harish Kumar	👌👌👌👌
Mahesh Mahesh	Torch berar
Rajesh Peyala	Awesome music
New ac	Kew kekaa
Bhanu Rock	Mind blowing music thaman Anna
Deepika Talla	3 55 daggara 👌👌
Suresh Mathangi	super good bum music
mahesh babu gaganam	15min daggara super
manda ravi	jai ntr
Sayeesh chowdary	26 11 Goosebumps
murali.v minchu	16 20 to 16 55
Ramesh Bantupalli	Nuvu anto chupichavu
Kondaiah Chowdhary	hatts off thaman garu
S. V. SRIKANTH	My all time favourite class bgms ❤️❤️home coming❤️❤️ ❤️❤️jeji mata❤️❤️
B.v.sivakumar budati	15 17 thop bgm 💪
raju 0619	RockStar DSP not even close to SS Thaman Now Take a bow SS Thaman more respect towards you by this BGM album
kota varun kumar reddy	24 00 peak
sumanth veer7	Plz up date movie first fight
vinodreddy palmur	Emotional and heart touching BGM Suberb Thaman bhai💝😘 🙏🙏🙏🙏🙏🙏
Trendy Anil	When i started to listening bgm movie scene are reminding me top cl bgms Take a bow ssthaman destroy thumbsup button 👍👍❤
ranjith kumar 1	4 20 👌👌👌
Sunil Sagar	Super BGM
ram ram	Nice bgm
Rock Anil	excellent BGM
Manish Gundawar	7 25
Patrick Holmes	25 52
Bhanu Teja Reddy Vuyyuru	థమన్ bgm ka baap copy copy అని మోరిగిన వాళ్ళకి ఇది చెంపపెట్టు
Vamshi luckkyy	Kantapaddava BGM💪💪🎶💪👏
pottangi raja	One of best bgm of thamn s music heartily congrats
sai nath	MANISHARMA tarvatha THAMAN E bgm lo 👌👌👌👌
Pruthviraju M	Sir pls video song 🙏🙏🙏🙏🙏
Logical Tech	ULTIMATE MUSIC THAMAN Hatts off to Thaman
Arjun Uhan	8 53 9 53 supppppppper hatts off to thaman Anna
buttaihgari babureddy	Ur given ULTIMATE THAMAN I ” ll remember you
naresh rock's	Super 👌👌
surendra varma p	29 00 👌
srinuk dora	Awesome BGM hat off
Udaya Bhaskr Rao Kandregula	Super
Mahesh K	Recent time lo one of the best BGMs in Tollywood
Shinagam Kishore	super
Kadali Tarun Sai Ram	19 34 👌👌
akhil palusa	bgm king
Balaji R	15 00
STR ANR	Thaman Anna elane nuvu music eche cinema background music elane petu I love you thaman music
Ashok B	31 01 Walk Into Peace Slowly Starts
Durga Prasanna N	Superb bgm
Thameem Thaj	Agnyathavasi bgm please
Ravikumar Katthi	Ss thaman super me bgm ki 170 Wark chesaru Ana tfi super music director ve nve Ana pane Pata leni valu nenu copy antaru west galu
Srinivasa Reddy Ravu	THAMAN IS BGM KA BHADHSHAH
Mailapilli Vasu	Best back ground music of taman career
durga reddy	one of the best musical album in Ss Taman CAREER i really enjoy and worship this bgms
Keerthi kumar	Malli Malli like kotalani undhii
Tharun Chowdary	22 13 nundi peak 🤙
Chandra 2016	Killing BGM if movie had even more good scripted this would be industry record with this BGM Guruji would have done better than this
Raghu B	excellant
Mani P	Rangastalam bgm is tooo good than aravindha Jai rc
Nikhil tns	Ghoosbums
Buchi Darling	BGM Ichutla Thaman Thope Vilayithe Apu Thaman big fan Prabhas anna fan ikkada
Devaraj H	Really I just got emotional after hearing bgm😍😘😘
PREM KRISHNA.K	Thaman❤
Vishwa K	Nice very nice
tarun chowdary	27 56 ela chesavayya intha adhbuthamaina music
Chaitanya Dinkar	give the working link of google play music the above link isn t working 😐
mani teja H	00 00 01 10 especially flute instrument dhaggara aithey 👌👌👌
siddhu shetty	9 48
Mr.Funny King	What the hell this look like a mashup hollywood original soundtrack
Rama Rao Aripirala	Home coming jeji maata bgm lover
yandra ashok	I love background music
RAJU PYDIPALA	Awesome bgm very hard work in this film thaman🎷🎸🎹🎺🎻🥁
Ganesh K	Home coming 👌👌👌
DEVARAPALLI RAJESH	Superb bgm superb
Donga Satya Vara Prasad	Only once fasak 👆👆👆 superrrrr bgm
Gokul Acharya	Taman bayya nuvvu keka
krishna kumar	Extraordinary BGM given by Thaman background score elevated the movie for another step Really i got goosebump when I listened in DOLBY ATMOS theater
The informative	Jr ntr entrance very cool
Gowtham Desaboina	Baitkivachina basi reddy bgm is super
Narth Krishna	Super
Sandeep Dudapaka	Only Dolby Atmos Lovers This is for All background musices
Mohammed Ayub JMR	KANTAPADDAVA BGM SUPERB
Harikrishna Thokala	No need of watching movie again can imagine it by this marvelous bgm
gowri shankar	One of the best BGM Jukebox ever ❤️
Mahesh kumar	Extraordinary BGM music by Taman S S
Sai Prasad	Home coming bgm 👌👌👌
Phani Kota	Thaman really I didn t expected this much range from your side Bgms vinna taravata ilayaraja gurtukocharu goose bump for everything you have done ni kastaniki kannillu vastunayi
Puladasu Ramanjaneyulu	Super thaman anna
Phone Number	10 15 excellent
Srinivas Maddineni	redammathalli
shanwaz shanu shan	Balamainodu pakkana vunte bgm super
Rakshith raxs Raxs	Thaman superb 😍😘😘
Vamsi Peddada	1st wa BGM is superrrrrrrrrrrrrrr☺☺☺
MULUGURU VENKATALAKSHMINARAYANA	Pls call me 9490962366
Sarella Madhu	Excellent bgm
rakshith sharma	Thanks for it Jai NTR Jai SS thaman 👌👌💗
Sandeep NKV	నిజంగా ఈ సినిమా లొ చాలా చాలా బాగుంది బాగ్ గ్రౌండ్ మ్యూజిక్ థమన్ గారు 👌👌👌 జై ఎన్టీఆర్
Ajay Ajju	bgm kumasavu anna
shaik.shakeer Shakee	4 00 Massey outstanding TIGER fan only goosebumbs
Anil Kumar	15 00 awesome
NADH BSOD	7 48
Hi Hello	Thank u very much for 😍😍😍😍
Boy Girl	How can I get separate track
rravella	Nice initiative by Zee Music and Taman to release Movie Official BGM Trendsetter
syam prasad	Jr NTR home Coming and Jeji Maata BGMs are 👌👌 ultimate BGMs and Music by Thaman SS S imply S uperb
SAI CHANDU	TAman bro ne tharuvathe eyadaina bgm antee
chalapathy G V	Your bgm is answer to whom opted out from Gpsk
somayajula srujan	Thaman bgm super
Vivek Reddy Medapati	Excellent thaman sir
venu mahesh	Very good BGM from SST I did not expect such an awesome BGM from him but I should agree that he ha delivered his best a he promised Especially Kantapaddava 14 50 \ \ \ \ I cant explain Goosebumps when I wa watching in theater
Hari Harish	Navo yakadiko yelthvo god bless u
Manikumar Thatha	Excellent bgm
shaik abdhulla	Marvaless music kantapaddava is super
azeez mohammad	Naa Peru Emmaneilu EE bgm music naa jeevathamlo vinaledhu keka thaman
dattatreya viswanadham	all time favourite bgm forever getting goosebump while listening
Sambrajyam reddy	first bgm when he come out of the train 😍😍😍😍
Somateja Chowdary	😍😍
Prudhvi Raaz	Each wave a goosebump Hats off thaman gaaru
O.T.B Harmony Limited	devudu nijam ga zee music
Hanif shaik	Crazy music
DLokeshwar Reddy	Super bgms
adhilhussain 888	Fab 👍 bro
Franchi Kumar	Super
Durga Prasad	Thaman anna bgm superrrrrr
Narasimha Rao	Kantapaddaavaaa 👌👌👌👌👌👌👌👌👌👌👌
Babu Doddala	SST s career best 🙌👏🙏
MALLI KING	That Kantapaddava Score is maaassive 😎😎
Ruthvik Manne	😍💖
Mohit Singh	Im hypnotised
Anil S	Sir metro station lo vacchey bgm pettaledugaa sir
B Swamy	Thaman Anna super BGM jai NTR jai Thaman
sairam lb	Jai NTR
Prince Harun	Superrrrr bgm jai N T R Anna
Nagu Allada	Nenu NTR fan kadu kani Ntr anna 🙌🙌🙌🙌hands offfff to you
rehman shaik	Thank you so much for this especially the Homecoming
Arunsai Vemula	Best BGM s of 2018 Best out of Best HOME COMING NTR Entry
ramavath sunitha	i love thamans music forevere mellodious music and massy power pakked music
sri kanth	am always like tamman music and BGM ki pranam petti mari kottadu i e TAMMAN BAYYA
ATHARVA KALYANKAR	Super movie Jai NTR👑 King of bollywood 👑😎
Sekhar Rj	Nice movie NTR sir super Bgm sir
ravi kumar	Thamman your bgm are super duper
Prasad Bobby	Goosebumps 🐯🐯🐯
Mahezh Burra	Background score Highted to this film awesome
ganesh gani	from 4 20 kirrakk bayya
Mr.Sherlock Holmes	7 24 8 30 No word wat to describe just dissolved in it hatsoff to Thaman
Satyanarayana Hanumanthu	3 54 4 17 super
Naveen Shaik	Awesome bgm
ABDUL GAFFAR SHAIK	Introduction bgm excellent Manisarma ni gurtuku tecchadu
Marvel city	All are very nice congratulation to the team on successful blockbuster of movie
Vineeth Marlapally	Intro bgm is bliss Best one after khaleja intro bgm No wonder thaman is best in bgm after manisharma gaaru
Sweety	Torch bearer bgm is kiraak 💯💯🔥🔥
NTR Raj	Thaman garu 🙏🙏🙏
DH MTM	aswome
Saikumar Badi	15 15
RISHI V	థమన్ భయ్యా bgm కేక నీ మ్యూజిక్ కి హాట్స్ ఆఫ్
chitti prasad	Already ntr అన్న చెప్పాడు Taman ప్రాణం పెట్టి చేశాడని
sake Narendra	NTR Anna ichina chance ni utilise chesukunnavu taman bgm osm especially Ishtam Leni marpu bgm suprrrrrrrr
MADANMOHAN REDDY BANDIATMAKUR	Awesome BGM
Phanindra Babu	Bgm ka baap thaman anna 👌👌
AJAY VISWAM	Jeji maata😍
Naresh Naresh	💪👏🎻🎵 S
prasad durga	Goosebumps
Kotareddy Karnari	Introduction scene is hilight
Nagaraj Yesh	Home coming jeji maata balamainavaadu pakkana unte 💪💪👌👌👌 awesome bgm
Raky Ram	Blood boil avthundi ra Babu super thanks thaman Jai ntr
Rajesh Gorentla	Home coming pomodoro kantapaddava peace making torch bearer 👌👌
Telugu Vijay Kumar	Home coming BGM take u into the movie 😍😍😍
Surya Surya	super
Sanju prabhas	Osm bgm Thaman love u ❤❤❤
Alif Masthan	Extraordinary bgms
karann abhi	Peace meeting bgm is lit AF
kalyan chakravarthi	Home coming kantapaddava pomodoro and reddemma talli my Fav I watched movie TWICE
kiran arts	Kantapaddava bmg is lit 🔥
Chandu Chandu AN	Home coming and torch bearer bgm r superb
Abhishek Pranav aditya	Heart touching bgm brother Thaman brother ur the super Thank you so much for a great 🎶 given to our NTR 🙏🙏🙏
Bhagyesh Ntr	Osm Thaman Jai NTR Anna
Krishna Mohan	Thaman sir super
nani rocks	Goosebumps
Varun Panicker	Bgm dwara full movie kalamundhu vachinattu undi this is thaman s answer to all the people who call him a copying music director
Siva Kumar Goud	BGm💥💥💥💥🙏🙏🙏🙏🎸🎸🎸🎧🎧 Vintaunte inko sari theater lo movie chudali aniundi Chustanu
Abhiram abhi nandhamuri	wonderful nice
RavikumarReddy m	I am waiting for this thanks zee movie 👌👍
Jagadeesh Madhupada	14 50 Real racha
Janardhana Rao	💯 kanna Chala Baga icharu bgm mind blowing taman Anna linelo ki vachesav👍👌
Kiran Thogadia	Basi reddy
Karthik Chebrolu	Home coming what a thought wonderful violin
Beautiful Status 2018	NTR fan oka like veskondi🙏
srinivasarao akkireddy	Super brother bgm
siddardha peddada	Simply Ke ka
Rinku pramod	Home coming Its my 50th time listening
RAM BALA KRISHNA	Jeji mata bgm extordinary goosebump
E AAdarsh	Super bgns ntr anna super
Srinu Putta	Thaman SS super bgm👌🙏
hari prasad	Introductions bgm goosboms
kommu bhasker	very nice though thaman bro bgm jukebox 👌👌😍😘
phani kumar simhadri	Excellent thaman Rocking bg
Shaiksha Shaik	I loved it very very nice music thank u thaman garu
anilkumar k	Thamman anna super bgm superb elanti music maku ntr anna movie loo malli kavali thamman anna very very best music of this year anna jai ntr anna
Allabakash Allabakash	Thaman super bgm
K Harish	Super song thanyou s sthamangaru
Vishnu Keesari	Awesome
aluru anji	Super thaman
Sandesh Devkota	15 00 ✌👏☝
Prudvi Chekuri	Home coming Rumrudhiram Torch bearer Awesome BGM😘
Bala Chandra	Home coming and kantapaddava 😍 and also all are 👌👌👌
Thirumalesh.v Thiru	Especially Home coming bgm mathram keka bayya
Vechalapu Lokesh	Hats up thaman anna👏👏👏
khasim vali	Walk into Peace is the Best BGM in the movie
Maharshi Veeramalli	Jai Aravinda Sametha NTR SST TRIVIKRAM PENCHAL DAS
Rakesh Narapaka	Wowwwww
Daya sagar Daya sagar	Super BGM thaman sir
Lithin Reddy	Who go goosebump wile hearing the BGM like
Narasimha Kumar	Loved this BGM Good thought to release BGM Tamann u did fabulous job
Sri Creations Official	BGM s lo thaman Keka movie ki ela kottalo ala kottadu
Thoti Babu	Super Jai ntr
Sai Teja	bgms are super
mantha vasudev	only because of bgm we all involved and feel the theme
Noor Mohamed	Mass bgm pomooroo
prabhat 03	Istam leni marpu
Tulasi Vegi	thaman bro great music congrats
Netheti Kishore	wonderful thaman
PAPPU VENKATESH	Istam leni marpu 👌👏
Avi Chowdary	Mass movie ki em bgm ichinav Anna thaman Anna nuvvu keka antey music lo ninnu kote vadu ledu jai NTR
Katiki Hemasrinija	Thanks zee TV Jai NTR
Chintu Undru	The best bgm in Thaman nd NTR career
Goutham NANI	erra padda thadika leru part 2 is awesome bgm
Vannoor Vali	Pecace meeting Rachha Bgm 23 57 👊👊
NSPN CREATIONS	YOUNG TIGER JR NTR ARAVINDA SAMETHA VEERA RAGHAVA MOVIE THO INDUSTRY HIT KOTTADU MA ANNAYA AND BGM JUKEBOX ARE EXTRA ORDINARY SUPERB JAI NTR 👌👌👌 👌
Chaduvula Chandu	Reddamma thallus ❤️❤️👌🏻👌🏻
Kishore Sanaboina	Home coming 😄
Thaneri Munendra	Torch bearer music
Sai Maddy	15 min kantapadava mass
Akhil Powanisa Akhil Rockstor	Bagrund super aravinda sametha move bgm vall nilabettesadu
maheshReddy Yr	34 50 awesome marvelous extordinary don t miss
ROCKSTAR NAG	Every bgm touch me to make goosebump on my body awesome
NTR Abhimanulam	Keka
prabath sandhi	3 52 visuals kanipinchaaye bgm vinagaaney 🔥🔥
Gowtam Reddy	Home coming and Jeji Maata BGMs class and superb
vinay ganesh	Peace making and Torch bearer Goose bump
Srikanth Chava	Powerful bass and sound Feel like in theatre Thank you Thaman
Srinivas Kumar	Peace meeting best heard in theaters🤞🤞
Ganga Bhargav Goud	Reddemma thallus 👌👌👌👌👌👌👌
vaishnav tarak	super👌super👌thaman 👦Anna 🎻🎶🔊music super👌
Jagadeesh KJ	This is the video I am looking for ThankYou All😘😘😘
Siva Yadav	Hats up thaman bro simply superb
vijay k	3 3 3 3 3
Leela vardhan reddy	Ante copy antaaru gaani bgm superb
raghav reddy	Awesome bgm loving it😍💕💕
prudvi raaz	👌👌👌👌👌
bathina ram Kumar	10 00
Team Music	32 35 👌👌👌
byluppala nagarjuna	Good sst
Pilot Cinema	7 25 what you have all been looking for
Anand C	14 51 You are welcome
Sathwik M	A perfect symphony orchestration 👌
Rajasekhar Peetla	SST best Bgm Thanks to zee music
Wasim Wasif	Heart touching bgm👌👌
Rajasekhar Reddy	10 18 love BGM
rajesh naidu	Super by AVSR team
Sai Raghavendra	Homecoming bgm 👌👌
Swaroop	Songs kantey ekkuva repeat esthunna Thaman Mass Scene lu kalla mundhu thiruguthunnay TERRIFIC Stuff
Srikanth Ram	Thaman irgatesindu
vikram varma views	15 15
UrstrulyVivek45	Em kottav thaman babai👌👌
Nagarjuna Chowdary	Music Excellent Osm
manoj kumar kodali	Kantapaddava ki okesari goosebump vachesay Meeku ala jarigithe oka like veskondi
Venkat Rohit	Tnx thaman Anna Am cheppagalam intha kanna
Sunny Sai	Jai ntr Anna
status lovers	Endi reddy sampinav po em acting bayya dinamma jeevtitham
Sudhakar Eluru	Anna audio function lo cheppadu thaman pranam pettesadu ani adhi movie chusina tarwatha artham ayyindhi nijam GA thaman pranam pettesadu e movie ki only thaman matram nayam cheyagadu chesadu kuda Jai ntr jai jai ntr
Anil Surya Manda	KANTAPADDAVA babu thaman heart konchem sepu aagipoyindi 🙏🏼
preetham reddy	Home Coming 00 00 Erra Padda Thadika Leru Part 1 01 14 Erra Padda Thadika Leru Part 2 03 14 Jeji Maata – 05 21 Balamainavaadu Pakkana Unte – 08 33 Pomodoro – 09 48 Mondi Katthi – 12 19 Kantapaddava – 14 50 Bathikochina Basi Reddy – 20 03 Chavuganna Gonthu Vunte – 21 27 Peace Meeting – 23 56 Torch Bearer – 25 49 Ishtam Leni Maarpu – 27 56 Walk into peace – 31 00 Reddamma Thalli Film Version 32 34
Veeru Chintala	Jeji maata full emotional bgm💘💘💘
karankula mallikarjunarao	Anna keka
Srinivasa Chaitanya	Excellent BGMs Hats off to Thaman 👌🏻👌🏻👌🏻🙏🏻🙏🏻🙏🏻❤️❤️❤️
karna mothilal	Home coming goosebump
Abhilash Venigalla	Hats off Thaman You ’ ve nailed it 👍
Hemanth Kumar	14 50 to 18 00 fucking awsome
Funny Videos	26 21 amazing
Kowsalya Kowsalya	Superrr jai Ntr
A Siddiq	Only ntr movie gert
vito corleone	5 55 super
Kishore Kammari	03 32
Balisina Rana Chowdary	Thaman you are marvellous
kumar chettari	Once again proved by thaman a a music director aravinda sametha is one of the best movie in thaman career All the best thaman sir for your best future
seshadrik k	fantastic bgm by thaman and the bgm took movie into another level all the best thaman from ntr fan hope your brotherhood relationship ship with NTR sir will continue
Yash Bruce	Thaman fan hit like here
Manju Lakshmi	Ultimate BGM music super sir
Syam Prasad	00 01 to 34 46 fantastic bgm sir offer search with you sir
Mynuddin SD	Amazing😚😚😚
Pallam Krishnamurthy	3 55 peek
Bala Pojula	Best BGM Thaman
Raja K	ultimate bgm bgm kottalante thaman
Johnson Boodoty	Awesome 👌 BGM
Nani Abhinav	14 50 is sensation and best bgm in thaman life
Bapu Ch	Nice
Vinod Kumar	Super bgm
Karthi Keyan	00 32 01 08 06 04 06 39 11 17 12 11 24 33
Prasad Medisetti	Best bgrm in his career 👌👌
Naveen Annepally	00 32 To 01 08 varaku bgm highlight asalu 🙏 👏 aa flute music 👌
V Dilli Rao	Fantastic bgm
venkata rajesh	09 48
Akshay Kumar G	Tq very much zee Become a top Soon with aravind sametha
Balu majnu	Super nice bgm
Panduri Chandramouli	Super
Ganagani Sathyanarayana	One of the best BGM in thaman career 1111
Bhanu Prakash	Waiting actually thank you Soo much for uploading officially
bhargav gudala	Kantapaddava 👍👍👍👍👌👌👌👌
Vijay Nene.!	JejiMaata 👉👌👌
Teju Legend	Ossm bhayya 😍😍👍👍
markanda reddy	Super excelent owo jai ntr
duvvu ravibabu	Just awesome
tejaprasad teja	Upto1 10 bgm ultimate Taman rockzzzzzz
Raman Lucky	Individual track pettandi sirrrr
k venkatesh	Ishtam leni maarpu 👌👌😘😘🙏🙏🙏
SaRmA MuSuNuRi	05 21 27 56 24 33 👌👌👌👌👌
vishnu chinnu	Thaman at his best 👌👌👌👌
Telugu Comedy Club	24 33
phanindra sharma	For the first time Telugu lo official BGM S release chesaru thank you zee and SS Thaman 😍😊👍🏻
Harsha Vardhan	Kantapaddava super bhayya
uday kunar	What a bgm thaman sir really mind blowing music in your career 💪💪👌👌👏👏
MS NEWS	24 30
Sai Mani	Torch Bearer super
Lakavath Devendhar	Bgm Baap ka badshah thaman Who is not beat Thaman
mahesh bobu	సెలవుల తర్వాత కనిపించని అరవింద జోరు
enn krishna	3 54🔥🔥
Raja Reddy	Thaman back
Chandra Sekhar	Yenduku thaman meedha copy chestadani vimarsalu kuripistaru evari style vaalladhi manaku music nacchadam kavali
Bharath Paidipala	Use🎧
Sudhakar Susarapu	Xlent collection New phone with NTR Trivikram sir combination hit ringtones Awesome moment for me Thanks a lot Gooooooooooseeee bump eheyyyyyyyyy
Akshay Kumar	😍Jr NTR tarak9999🙏 🎶 kekka 👌
mighty	King of bgm Full stop no ifs no buts
sivaganga nanaji	nijamga super vundhannaa penimidhi aithey mind blowwww
Arju Mallikarjun	BGM mathram Excellent i never expect from this type BGM from SS Thaman😍😍😍
Mahesh Naidhana	You just rocked off anna
V Chandraiah	exlent music
ANKABOINA MOHAN	Excellent BGM of this year
Teja D	Okati minchi okati undhi I can t rate it Thaman best work till date
Siva vadrevu	Most Awaited BGM of the year
Kiran Kommu	Super
Suresh Balu	Goose bump super thaman anna Super tarak anna ki bgm super
Harishankar Velpula	Bgm super
ram prince	All are goosebump Hatsoff THAMAN ANNA 👌👌👌👌👌👏👏👏🐅🐅🐅🐅🐅
Lagadapati Gurunadh	Supar thaman garu first time your bgm nachindi ofter baadshah
vijay santhosh	keekaaa
charan raj	Confirm ga goosebump vasthunnai ee BGM ni vintuntee
Mohan Krishna Reddy Tupakula	Pealssa
Aaryan Rajesh	Hats off man Thaman
Suresh Yerrarapu	Istam leni marpu 👌👌👌
vinay mamuduru	Excellent BGM
R N	Super bgm
simma devagiri	BGM super
` `	Kekaaa
VENKATESH RASAMSETTI	Super bgm thaman Anna
Madhu N T R Jr	DSP CHUSI NERCHUKO BGM YELA KOTTALO
Naresh Tarak Nadhi	All are Goosebumps bgm s
Basha Shaik	Excellent
MURALI N	Arey Devi sri ga bgm yela kottalo thaman ni chusi nerchuko
kolipaka pavankalyan	Kantapadava awesome
Teja Sumanth	Home coming 👌👌👌
chandra shakar	Super
Naveen Kumar	Thaman Sir e movie Tho Mi Sthanm Oka Range Loki poya I mean Telugu Industry lo Top 5 music Director lo miru okaru pakka untaruu
Velugondaiah Induri	Supper
Aasish Chand	Thaman proved himself again
#its_sai Ruth	Kantapaddava BGM ki ok like veskondi 15 02
Sriram V	Thaman sir great job proud of the lineage in work ilayaraja sir mani sharma sir thaman sir for bgms
Gopi Chand	Jai ntr anna
Kiran Bhat	Finally
Ravan shashi	I wa waiting for this😍😍😍😍
Sandeep Reddy	3 51
sreedhar goud	Superb
Gandhi Gowda Jr NTR	Jeji Maata 👌💔💔💔
mani kanta	Entry bgm super
jayadeep DS	Hatsoff to Thaman Jr NTR rock once again superb mind blowing
Ramprasad. Nadapana	Nice BGM
JOHNPEERA SK	Kakelu anthe nachhithe like kottandi
Satish Kumar	Nice bgm from taman after ilayaraja
Prudhvi Akula	Who liked B G M of torchbearer
Kedar Nath Pradhan	super
Swamy Munna	Aravindha sametha 💝 mind blowing movie Bhayya 👌👌 ntr gari acting level peak 😎😎😎 s thamman sir mee bgm ki mathram 🙏🙏 abbabbabaa m music Bhayya champesavvv po 💝👌
Shiva Kumar	💓Pomodoro Music 💓
Aadhi Laveti	Super super
Vijay Rajendra	Any pomodoro fan
Raghu K	Supar
Kumar Bonda	Reddemma thallus song super
rishi roy	Super b
naru ycr	Hat s Up Sivamani Garu Thamman also Whole Team
Satesh Kumar	If you like all BGM ’ S like me Which BGM is your favourite Plz comment
Ntr Bigboss	Love drama romance emotion sad happy Roudram em balance lekunda BGM kottav okkA movie lone Nuvvu thopu Ra thaman Kummesav pooooo 🥁🥁🥁🙏
Joshi daimand	Plzz upload one nenokkadine bgm
prashanth kumar reddy	Thaman entha kashapaddado artamavutundi hat off to u thaman
siddhu govada	Bgm credit should also be given to Legend Sivamani
nithintechintelugu	1 14
Kommoju Kishore	Very well come back from thaman by tholi prema and asvr
P GANESH REDDY	BGM Wenali Ente fast ga gurtukochadi AravindhaSametha VeeraRaguva So Nice Music SS Thaman
ch srikanth	Hats off
Sameer Khan	Superb BGM Hatsof to Thaman 👍
Naveen Chowdary	Osam bgm feel the bgm NTR fan s
P. Chandu P. Chandu	SS Thaman super music😉😊👌👌
muni sai kumar	Awesome Perfect BGM
imran shaik	Great job by Zee music👌
mithun manohar	This bgms are awesome just like the movie all hail Jr NTR sir
niddana venkataramana	Movie release Kaka Mundu Thaman copy music annaru eppudu arthamaindi andariki Thaman ante ento congrats Thaman from NTR cult
VENKAT 191	Upload Spyder bgm jukebox
tarak balu	kantapaddava okati chalu nve BGM lo thop ani chepadaniki
Shashikumar N	Excellent bgm he is one of the best music giving in Telugu industry goose bump in bgm great job SS THAMAN SIR PLEASE DO LIKE THIS MUSIC
sai charan	👌👌👌👌👌👌👌👌👌
Nishanth reddy	29 07 peaaaakssss
Charan Thej	Taman oka mettu yekesadu
Suresh Akkavarapu	SST Great work really your r the best product from manisharma sir you r a true all rounder for music u can do any kind of music especially i love KANTAPADDAVA design track 👌👌👌👏👍
Shaik Md.ghouse	bathikochina baasireddy 20mnts 👌👌👌👌
SAKINENI VENKATA SAI KUMAR	Nice one
shaik ali	Nice
Deepak D	Thaman excellent bgms after business men
tiger teja	Supar
Shiva Nm Shiva Nm	33 00 goosbump
Mazin Arif	Awesome awesome
raghu ramkaikala	Terrific BGM by Thaman especially first fight bgm sequence
Dudekula Jabeevulla	Excellent
Jagadeesh Tulugu	Excellent super bro
Koteswararao Dodda	3 55 goosebums
Sai Kumar	19 30 to 20 00 promise you pakka goosebump
Kushal Dk	Home coming ❤
sireesha mandava	26 15 bgm http www tenor co NcdQ gif http www tenor co NcdQ gif
Sai Eshwar	SST for a reason ❤️ please release racegurram bgm also
Shaik Javeed Hussain	Super bro it s really awesome
sureshanka1	No word simply listen and enjoy Tamales deserves every accolade coming in his way TAKE A BOW THAMAN
NAVEEN M	24 34 awesome one and good idea to release these official jukebox for BGM looking forward for more from thaman
Ajay Chander	Ek daaam BGM 👌👌👍👋 DSP ae anukuna but even thaman is also flying 👋
Pranith Pawan Kalyan	Hat s off Thaman bro Home coming bgm keka
VIP FREELANCER	I like chinise flute
Dendukuri Manikanta	Super Anna you nailed it
Svcc 777	Taman u did great job Bgm is awesome
BABU SHAIK	Jai NTR
Chandra Matam	Not seen movie yet but after listening BGMs feel like watch movie immediately Thaman you ROCK
Ram Vlogs	8 45
Kamini Chandrakala	Super sir aripichharu keka bgm
Chandu Daya	Very fantastic bgm
Ulthappa Kumar	Jai ntr
DSP Creations	The fluit sound reminds me chinese movie bgm great work Mr Thaman
Bharath Kumar	7 50
naveen kumar	Thaman anna is BACK
Hari Kishna	Super
mahesh pasunuri	Thank thaman sir Thank you for whole team
Chaitanya Sai	Glad that they released BGM
moto C plus	Thank you very much to whole team Thank you thaman ji
Shaik Abdul	Jai ntr
g Shivakrish	Superb bgm SST Jai tarak anna
Veeresh Vadla	Home coming bgm super
POLURU NAGARAJU	Jai NTR
Shekhar Teja	Keka
Pavan Kumar	Where is thaman hater ye patiki vacheyaley adi akadidi edi ekadidi anukuntu Jai thaman super Anna champav Ni kastam ekadidi podu kastapadu Anna alaney keep it up
Mahi Royal	6 50 goose bump
Naga Raju	Simply super bgms
Subbu Vavilala	exellent bgms
Naga Kumar	Thanks a lot guy bgm is the one of the biggest asset of this movie
Krishna FollowerOf NTR FanBeyy	Kantapaddava highlight
Jagadish chandra kumar	Kantapaddava is the lit part of this bgm
samyuktha reddy	Home coming peak heavenly feeling
Srikanth Baadshah	Jaiii Ntr
surya karumanchi	Torch bearer arupulu
Gowtham Eluri	Kekaaaaaaaaaaaaaaaaaaaaaaaaaaaaaaaaaaaaaaaaaaaaaaaaaaaa
bolishette karthikanand	EXCELLENT FEEL GOOD MELODY REALLY
ARUNSAI DEVARAKONDA	Kantapaddava supb
kadabohina jaswanth	Home Coming is super 👍
Srinivas Naidu	ishtam leni maarpu🔪🔪🔪
Naidu Vanjarapu	15 18 super bgm start
Barath Naidu	19 30 to 20 00 😍❤🔥💯💣
Vinay Kv	Thaman s best bgm till now
Yash Joshi	who all are here for Reddama Talli song Hit a like here
Srikanth Thattikonda	10 18 😘
Tarsen Pottabathini	Jai thaman
sagar m	So soothing ❤️
Saikiran Dharmaraj	15 20👌👌
Arun Vedula	7 45 and 9 47 That soothing music
G 1	thaman
Kranthi Neelam	S s thaman gave melody bgm goosebump
Venu Gopal	Kojja gallu dislike kottinolu
PEDDI SHANMUKA RAO	32 35
nagaraj Polisetty	Super
Naveen Maharaj	Jai Ma Anna ntr
sudheendra rao	Istham Leni marupu my fav BGM in movie ❤❤❤👍👍
Vittal Kumar	Top Notch BGM
johny ntr Sk	Super Super
charan pyla	Flute ni violin ni vadatam lo thaman tarvathe andaru
g ravi	Superb bgm 👌👌👌 jai ntr Anna✊
Bhuvan bhuvi	26 12 Thamann Anna mass elevation 😍
Sudheer babu Boddu	Bgm music Lo Thaman Anna ne top
Chenaboinanaveen Chenaboinanaveen	Home theater ki kanet chesi vina music matram👌👌👌👌👌👌👌 undhi
palla krishna	osm baground music
PALADI BALASWAMY	Super bgm by Thaman
Mahesh Kotla	జై ఎన్టీఆర్
Anjaneyulu Bandari	Super
NaveenTechTalks	Superb 👍👌
Kapil Siddunuri	Tarak anna fan oka like vesukondi Jai ntr jai jai ntr
Mani Kundeti	Super music
Yetukuri Teja Nikhil Chowdary	Jai ntr
VIJAY THALLA	20 12
Raghu Yaggoni	One of the best ever in Thaman music career
Nagaraju Chelluboina	Superb bgm
Rahul Jana	3 53
Hemanth Yadav	Thaman hater take this🖕🖕
vjayjob	Goosebumps
pavan kumar	Introduction music amazing master class from thaman🙌🙌🙌🙌🙌🙌🙌🙌🙌🙌
Gande Satish	14 50
Duggirala Madhu	16 45
srikanth chiru	Jeji talk bgm awesomm execellent feel
siva subbu	kantapadavo scene bgm 👌👌👌👌
surya varma	Manisharma after Bgm King thaman bgm mind blowing 👌👌👌
Kolli Sivanagaraju	JAI NTR
jyotheesh jyotheesh	nee tarvate evaraina background music lo
Mahesh Madigapogu	Thaman bayya bgm excellent flut kamalakar super sir
Mohith Naidu	Thaman bhayya ah bgms nti bhayya pichekuthundhi 😘
Ganesh Nakkana	one of the best background score goosebump vastunnav thanks to creater
sai harshith	hai bhaya i am director of short film plz i want these backgroud music plz give me a link to download
Kalyan rockzz	11 39 to 12 12 very sweet
SHAIK BRAHMAM BASHA	Floot music super duper hit and heart touching music
vamsi krishna	Super👌👌👌👌👌👌 Jai NTR Jai Jai NTR
y Srinivas rao	32 34 reddamma talli super🆒🆒🆒🆒🆒
g sai	Mondi katthi 12 40 👌🏽
Shankar Sardar.R	My faverarat music s thaman Super keke exlentent movie super music sir
Madhu Kumar	Film is block buster BGM is mind blowing
Saiganesh Sibbena	Serials be like Kadhirappa eeda bgm lu lev mana serial lo avasaram raava
KIRAN RAJ	Goosebumps
Vamshi Luntic	Super bgm
Kiran Madhira	Jai NTR superb s Thaman
rajender bekkam	Superbb BGM Thaman Superbbbbb
Rohit Kumar	First time Super BGm música televisión good BGm
Medapothula Rambabu	super bjm Jai NTR
Dhanush Raju	One of the best bgm in Telugu move First time I like fell taman music
Akkidasari Baburao	Thaman Anna bgm superb ga vundi Anna Keka
Siva Kampa	Reddamma thallus
PS Prashanth	Total toooooo nice
Sravanthi chary	Peniviti song bgm peytandi
sai kumar	Thaman S🙏🙏🙏🙏🙏🙏🙏🙏🙏🙏🙏🙏🙏🙏🙏🙏🙏🙏🙏🙏🙏🙏🙏🙏🙏🙏🙏🙏🙏🙏🙏🙏🙏🙏🙏🙏🙏🙏🙏🙏🙏🙏🙏🙏🙏🙏🙏🙏🙏🙏🙏🙏🙏🙏🙏🙏🙏🙏🙏🙏🙏🙏🙏🙏🙏🙏🙏🙏🙏🙏🙏
Thousif Thousif	waste
Shaikkalam Kalam	23to25 excellent bgm
Nani Naidu	🙏
satya Gumma	ishtam leni marpuki pranam posavvv annaaa we love u thaman anna
Satyanarayana Murthy	Edhi pakkana pettu aa saaho ki aaa bgm anti bhayya Pichi akkinchav asalu
mallu kishor reddy	Super BGM
Veera Babu	Super music thaman ntr saport tu jai ntr saport is the best wish for you
Bhargav Musunoori	16 29 17 04 🙄👌
manikanta tangella	BGM extraordinary super
RGYV RAJU	27 57 30 55 Ultimate 👌👌👌👌
Captain Jack Sparrow	👌👌👌
DORA BABU N	I liked bgm chavukugana gonthu vunte
Sudheer Dany	I love you thaman bhayya
Prâdêép MÇĀ	Kantapaddav 😘😘😍😍😍
TRINADH KOYA	Home Coming and Kantapaddava and POMODORO were awesme
Rajahuli Raja	Super BGM
sanath kumar	Serial maker be like kadhirappa thaman leda bgms lev
Anil As All categories in here	Thaman all time best musuc
naveen mogallapu	14 51👌👌👌
Manu S love You	reddamma thallus song is awesome
LAKSHMI SAI WEDDING AND EVENTS	Thaman best of life
Srikanth chary Vadla	I like this song and love it
baba farid	BGM Awesome love u Anniya Jai Ntr
Praveen Goud Praveen	Taman kaka 😍 ergadishnav po 😘😘😘😘
vinod t	Love it love it
J K Abhay Ram	Superrr 👌👌👌 2018 THAMAN YEAR KUMMESTUNNAV
Uday Nani	300crs pakka
H Pk	Super Bhaiyya
Ramesh Bandlamudi	😍😍😍😍💓💓💓💓💓💓💓💓💓💓💓💓💓💓💓💓💓💓💓💓💓💓💓💓💓💓💓💓💓💓💓💓💓💓💓💓💓💓💓💓💓
S Hafeez	Blockbuster ARAVINDHASAMETHA
P Mallikarjuna	Super
shanth kumar	Jeji maata 👌👌
Sagar Gupta	Nothing can beat Kantapadava BGM hit like of you have same feeling
Smartboy Ram	Nuvu BGM lu release chesav bagane undi kani Repatinnundi serial lo ivey yestharu 🙄
Bhavani Shankar Yong Tiger NTR	music vintu unte romalu nikkapaduchu kuntunnahi Anna wonderful music
Hareesh Meduri	Hilarious music compose by s thaman garu
Balu Vasu	Awesome BGM Thaman Bhayya
srinu kola	One of the best BGM in recent year Another level of Thaman
linga n	Thaman anna u r also main pillar for this movie what a bgm pichi ekkutundi ekkada edict iepoyinam bro mee bgm ki💖💖💖🙏🙏🙏🙏🙏🙏🙏🙏🙏🙏🙏🙏🙏
manikanta mokidi	jeji mata 👌👌👌👌👌
Vinod Pawar Vislaa	Home coming \ 👌❤ TARAK anna intro simple n cool thaman anna bgm goosebump moment 😍😘
itsme_ vinay	Jzt love for home coming🔥🔥🔥
pavan star	torch bearer bgm is very great super heroism music
ADIREDDY MANIKANTA	Peace meeting 😘😘😍❤❤❤
praveen kumar muthamala	Thaman got it right it from manisharama
Asadhi Kranthi kumar Nani	Ss Thaman Garu frst tym the Best Music🎤🎼🎹🎶 Aravindha sametha The best music BgM thaman garuuu
gouse basha	Thalaiva
ESUB SHAIK	Super kantapaddava Awesome job
Vinay Mylavarapu	Superb After Baahubali series this is the best acrion bgm Missed that climax music bit when Basi Reddy come to meet Raghava and when Subbadu go off with sunil and aravinda Short yet effective
nandini n	what a bgm hat off thaman garu you have done a great job
Uday Tota	Pomodoro BGM wa really fantastic 👌👌👌
Tapasi RY	Dhaanamma Kantapaddava ki arupulu anthe ❤️
vivek cena	How to download this bgm track s where is link
Surya Gen	Balamainavadu goosebump
alam damodar	That Bathikochina BasiReddy theme is awesome Thaman did justification with these bgm s
Venkatesh Mudavath	Home coming BGM wa such a beautiful melody
Bharath Karthick	Musical king THAMAN 🔥🔥🔥🔥🔥
gopi sgr	Jai young tiger ntr Anna 🐯 🐯 🐯 🐯 🐯
Ravi Teja Chanamolu	Thank you Thaman
Jaswanth Jaswanth	Jai NTR taman pranam posadu super bgm ear phone pettukuni vinandi please
Deepak Kishan kumar Reddy	Ram Charan rangastalam tho hit kottadu jr ntr ASVR tho hit kottadu and next rajamouli s RRR movie tho industry ni oka voopu voopestaru idi confirm rasipettukondi
Yenamaladoddi Harish Reddy	Ntr action ki thamana bgm thodite ala untadoo chupincharu
రాంబాబు కడమంచి	Super music 👌👌hands of thaman bro👍👍
pavan kalyan	Goosebumps Bgm music super 👌👍👍👍Taman jaiNtr
PUJARI RAMANJINEYULU	super anna
TULASI RAM	Awesome BGM Music Thaman
anand Gone	Such a nice idea to reavel the BGM Hats of
Doddi Sreedhar	In Tollywood one of the best BGM S JAI N T R ANNA
Zxcvbnm Mnbvcxz	Ji ntr
Satya Satya	jai ntr
Sangameshwar Reddy	What a background score mind blowing
Sandeepnani 731	Fantastisk Super Mind Blowing Amazing
Naresh Tarak	Super BGM Jai NTR Anna
Kethu Sravanreddy	BGM irragadeesav Ss THaman
Nandamuri Balakrishna	Jai ntr
Mana TV	Trivikram sthayi ni and taman copy music ane boundary nundi tesina NTR because of NTR
Vijay kumar	Supper
Sameer Hussain	Die hard of asvr bgm 💖 pspk fan💞
Prasad Nandhivargam	NYC bgm thaman sar
prasanth kumar	Super bgm SST garu
shivakumar Raju	super anna SST
Urimela Suleman	BDM is super Jai ntr
Hari krishna	istam leni maarupu
dk shortfilms	Bgm superrrrrrr Entry bgm and torch bearer bgm Keka
Srinivas Veeravalli	Torch Bearer BGM Awesome
claty	Thamam kept his 100 ♥️ Movie ki life ichadu Thaman anna 🔥🔥🔥
vidya sagar	Goosebumps for the Strategy BGM from Thaman SS a great hype to me from his every BGM
rajesh nammi	చించి ఆరేసారు తమన్ భాయ్
Surya Siva	Superb 😍😍😍
Nash Ashok	Home coming👌👌👌
samar amar	Bhayaaaaaa Thamman💪💪💪👍👍👍👍
kumara swamy muddada	15 14 peak asala
Ravi Teja	Osmmm BGM jukebox thaman 😘😘💖🔥
Harsha	0 47 15 10 best
Nataraju Raju	Jai NTR Anna
VASANA VENKATESH venkat	Super bgms asalu super movie
Srimanthudu Subbu	JAI THAMAN ISM 2018 BIGGEST BLOCK BUSTER AUDIO ALBUM AND BGM 👌👌👌👌👌👌👌👌👌👌👌👌👌👌👌👌👌👌👌👌👌👌👌👌👌👌👌👌👌
Hari Krishna M	Super BGM
Sathya Gunde	Super
manu raju manu Creations	Thaman anna supar music direktar BGM complit very😎
Bhargav Goud	Jai ntr
Kondal Rao	super bgm anna
saivarun mapaati	3 5 awesome composition it getting goosebump super super💪💪💪💪☝️☝️ thaman bgm ka badsha
Harish Badugu	Excellent Bgm👌👌👌 king of Bgm is Thaman 😎👌
Rohit Venkat Gandhi Mendadhala	Johar SST keep it up broo
Mr. Prank	Bgm ka baap thaman s
Nagesh N	Super anna
Akash Chintalwar007	DSp ki Gatti poti evvala nvv
ganesh revanth	Movie chaaala bagundi
Abhay Ram	Home Coming BGM my all time favorite Ringtone ❤ also
Pakira Pakira	Wow super bhayya
VNaik IIIT-N	Thaman sense of music is feel vibe n rocking Thanks for Special effort for our యన్ టి ఆర్
harish Boya	Super bgm
Sriram Kappala	BGM super thaman bayya
Manjunath Jlr	Peneveti song super
Sudhindra008	Intha manchi BGM ni serial vallu inka news channel vallu vadakunda unte chalu 🤗
uma mahesh uma mahesh	One movie more bgm hatts of thaman 👏👌✊
Veranjaneyulu K	Fantastic bgm thaman
Gowri Sankar	BGM gusoobumos Anna You are Badsha in BGM 🙏🙏🙏🙏
Jipson Pathur	Arachakam bgm thaman sir
Pothuraju Durga harish	Super super Anna ntr
Reddeppa Naidu	Super bgm thaman
Raavi Rao	The Best BGM in recent time Thaman done a Great Job
Vinodh Kumar	One time chudochu music super
Amer Basha	Rammm rudhiram Rammm sesheram Maranammm🔥🔥 👌🙏
Suri Suresh SS	Super
SH Hareesh	Osm Bgm Thaman Anna
rama rao	Super exlent BGM Tqs to thaman Jai young tiger
Uday Raj	Recent time one of the best bgms
S RAVIKISHORE	Super jai ntr
venu galinki	Jai Ntr love you thalaiva
masterprofession	Thaman poured life through his music into this movie Too good BGMs on par with Manisharma
Malli Bezawada	All bgms osm keep it up thaman anna
Jamu	Home Coming 00 00 Erra Padda Thadika Leru Part 1 01 14 Erra Padda Thadika Leru Part 2 03 14 Jeji Maata – 05 21 Balamainavaadu Pakkana Unte – 08 33 Pomodoro – 09 48 Mondi Katthi – 12 19 Kantapaddava – 14 50 Bathikochina Basi Reddy – 20 03 Chavuganna Gonthu Vunte – 21 27 Peace Meeting – 23 56 Torch Bearer – 25 49 Ishtam Leni Maarpu – 27 56 Walk into peace – 31 00 Reddamma Thalli Film Version 32 34
RaviChandran Chittella	After han Zimmer it s thaman bgms I am listening in repeat mode proud of you thaman you have given a tight slap to your hater
Dandu Sreenivasulu	Super
venkataramana vanjarapu	Thank you for uploading this jai ntr annayya
bharath bbs	Hero entry music osammmmm Kantapadava bgm super 👌👌👌👌👌👌👌👌👌👌👌👌👌👌👌
prabhu das	16 00 my heartbeat raising along with beat super thaman 🎧
Guduru Venkatesh	Thaman Career Best Music and Bgm Aravinda Sametha
sai prasad MS	15 00 start my fav scence osm bgm Goosebumps antheyy
Uday Kiran	Really BGM theme were awesome 😘😘😎😎
maddala hemkumar	Jeji maata bgm is awesome
NANDHA METHARMETLA NANDHA	Blockbuster bgm goosebump bgm taman great bgm jai ntr
Dileepanu 268742	3 52 starting raam Rudhiram simply superb
яαʝ αккι	Thaman music wa awesome All the best thaman Garu Jai NTR
Ramana Aganti	సూపర్ అన్న
rajesh ch	Amzaing bgm hate up Thaman Anna 🔝 Killing music
prashanth dhe LOCAL	Bgm ye ee cinema ki pranam posindhi
Bhanu chand chowdary	Adhiripoindi BGM jai thaman
rama krishna	Super thank q for release the bgm
Ravi Kumar	Taman all movie lo best bgm asvr
NAGARAJA.G Raja	Jai ntr
Ramesh Gowd	Ntr entry music superb
chlkkonda Shiva Kumar	Inta varaku itlantindi tollywood lo ledu raledu radu sir exalent
mass Suresh	I love you raja
shashank adla	torch bearer
Prasanth ss	Goosebumps music👌👌
Srikanth Patel	This time thaman rock s love u thaman
sreez goud	In theatre 25 min goosebump
Manojrocker 7702	Inka TV serial lo mingutaru 😭🙏
Pratap Pratap	Lv u thaman Anna keep it up
Muchamarri Prakash	Thaman anna super anna ntr fan ki kavalsina emotion ani echav
Lokesh Chowdary Vutla	Wow amazing bgm Music vintunteeee aravinda sametha veeragava mv malli kalla mundu chusenattu vundiii kallu musukunteee kalla mundu tiruguthunnattu vundiii Simply superrbbbb
gopi gaddam	dsp iragotte vadu inka ane vallu like kottandi
yatish kaveti	Jai ntr
Prasanth K	Super
gopal gopalakrishna	Excellent
Praveen Siddu	super sst
Venkatesh Geesala	Excellent Thaman Anna superrrbbb ur best RR
gold govind	Super Anna music jai ntr tq maku man hi music eechavu ntr carrer lo tq taman
Ravi raja	10 12 27 58 32 35 👌
Sandeep Raja	What a superb bgms really really awesome awful emotional connect every song when we are listening to this bgm keep reminding of movie U put ur life to make this such fabulous effort taman jee
mgp M	Nice movie back ground music Exlent Sir super wowww aravinda sameta unit team ku thankx lot congrats thaman Sir garu woooow nice back ground music Exlent
V Bhasker Reddy	jai ntr
Pedireddy rajukumar Raju	Super
Shaik Nabi	Kantapaddava bgm I have never seen this type of bgm any movie vry nyc thaman anna whole bgms are superrrrbbbbb
Anil Krishna Manne	I m getting goose bump
khaja mohiddin	Music at 27 13 awesome
raviteja sd	best bsm in thaman career awesome
Adithya K	Manisharma tarvatha thaman anne great bgm god
Vamshi Yadav	Superb 😍 😍 😍
Vivek Dasari	Mind blowing Huge respect brov
Manju nath	Not expected but thanks for posting
Justin Paulose	Where is teaser last part bgm It wa sooooo good
SIVA SIVA	Intha varaku elanti BGM sound aa move lo vinaledhu hetusup s thaman really awesome gu bomb 👌👌👌👌👌jai ntr jai tarak jai talaiva jai ntr
Madhu Chandra	Vinnantha sepu goosebump 😍❤️ Ilanti soundtrack kada mana industry ki kavalsindi 🙏 NTR anna cheppinattu Thaman anna ee cinema ki praanam pettadu ❤️🙏
Masthan Noorbasha	Jai ntr jai jai ntr
Rama Krishna	King of BGM ssThaman bro awesome bgm bro Hollywood clip vini njy chese maku nv vachi ni style bgm ichav mamulu ga ledu Telugu movie music level penchav Tq 🙏🏻
Subbu Keatha	Super jai ntr
Saiprakash Saiprakash	This is called ssthaman sir he is a great hero for bgm after the manisharma sir excellent rythm bgms fidaa ayipoyaaa Anna nee hard work ki
Praveen Chary	What a music 👍
Asif Asif	Supeeeeeeeeee r Anna
Jagan Goteti	Nianmaga tamman ah music I feel we Rehaman type soul in music
Sajid M	Thaman rocked for Aravindha Sametha 😍❤️👌🏻
atluri tarun	Every scene is playing in front of eye no word to Express u reached next level Thaman bro
Boinavenkatareddy Venkatareddy	Spr bgm ssthaman annagaru
mera bharath mahaan	Reddamma thallus song 👌👌👌👌 Beautiful voice by Mohana Bogaraju
Yerra Kirankumar12	super jai ntr
Sudheer Yadav	Kirrak
B NARAYANARAO	Today vzm thaman comming
Pujari Sudheer	U missed BGM of scene with sunil they are beautiful still haunting in mind
Kiran Kumar	Super bgm and excellent
ASH TECHNOLOGY	Torch bearer BGM Dammn SST Gud job Keep it up
thota ragavendra	How many of you r confused to pick ur one fav bgm from all these
Har sH	That Kantapadava OST ❤️ Em kottev ra Thamman ❤️💕
Sriram Ib	One like 👍for those who are watching the comment
Vengala Srinivasulu	Super thaman Bhai for bgm
Sreedhar Popuri	This is the best BGM of the year thanks thaman BGM ki inta fan following choodaledu
sai kishan	Am the only one fan for last bgm
ENaveen Goud	I like u SST best bgm music in
Manideep Kondeti	13 24❤️
Surya Prakash	Keka super
Kumar Swami Kumar Swami	thaman fan ipoya
Bramhanandareddy Jalla	3 58 super bgm👏👏👏 sst
salute to blady people	Thaman is proved and no more critic and comment for thaman wonderfull bgm
Pavan Kumar. N	Jai ntr
Hemanth Gowlikar	Jai NTR ram Sudhiram highlight Bgm 😍👌👌
Vijay Kumar 3039 Yadav	Fantastic
kathi lantodu	Goose bump music hair raising
Its me Susmith	14 50 bgm🤩🤩
SANKAR ARJUN	Mind blowing
kalyani B	Thank you Thaman your BGM really helped the movie alot keep going wish you good luck
MANIKANTA Manikanta	Supr
Proud Indian	Super move all movie have 2 release there BGM s
Nanda Kishor	Tq sir door this bgms
anil kumar	BGM raakshasudu mana thaman Fantastic
B Rajasekhar Yadav	Songs Baground Score lo nee tarwaata ne avarainaa You are the Rockstar SST
Vishnu Teja	Anna neeku enni dandaalu pettina saripodu anna SST saavu ki pranam posav kada anna JAI NTR
Eshwarnath Kothur	Thaman given best music Fantastic
Ravi Chandra	Jeji matha super bgm
raghu tarak	Anna thaman 🙏🙏🙏🙏jii NTR 🙏🙏🙏🙏
Basavaraju S	Super bgm
y Ravi kishore y r k	9 48 Kya Original Sound Track Bai👌
kapil gowtham	Thamans best bgms
balla pradeepkumar	BGM IS EXELEANT
Ntr bablu	i loveu you ntr
Pradeep KV	4 15 sec vetaa modhalu 🔥 🔥 🔥
Shabbeer Shaik	Kantapaddava BGM abbooo endhi guru aa BGM chittakottesadu o thamana yedapoyinavu saamiii inni dinalu inni dinalu yochana jesi chaana manchi ga kottinnavu abbii
Vishwanath. R	I don ’ t know Taman how you did this BGM and song I have no word to Describe Just telling from bottom of Heart awesome and fantastic That s all Keep rocking
Abhinav Aditya	Guru laane sishyudu Appatlo Mani Sharma ippudu SS Thaman Thaman is the torch bearer for bgms in telugu industry
Vijay Reddy	We r proud thaman This bgm international standard 100 quality music
Harsha Nimmakayala	BGM album not available on Apple Music Please upload
vinod alakunta	TOLLYWOOD THE NO 1 BEST BGM JAIIIIIIIIIIIIIIIIIIIIIIIIIIIIIIII NTR 💪
Jani Miya	super music cinemaki oopiri posadu taman
Ajay Beniki	19 31 🙏🏻🙏🏻🙏🏻
Medepalli Subrahmanyam	Excellent Fantastic Music by Taman
GR Arts	No word in bgm fab superrr
tarak jai ntr m	Super BGM sir
Karimulla Munna	Links plzzzzzzzssszzzzzzzzzzzzzzz
tippu sultan	24 24 superb 👌 gundelo train parigitinatu vundi superb bgm 24 nunchi
Rajesh Devarakonda	Peace meeting is highlight
Khader sharief Shaik	It s not our ability make what we are it the choice we take thaman for redemmathalli
Hema sundhar Reddy	Thaman career best bgm
naveen mungamuri	1 14
Chaitanya	good
pavan Kumar	By listening to this bgm we can easily visualize the scene Awesome bgm by thaman Keep rocking jai ntr
Kesava Reddy	27 35torchbearer
Meda Satyanarayana	Super bgm Jai ntr
Phaneendra Duvvuri	All track are superb thaman Amazing bgm
Abhilash Reddy	Best till date bhayyaa goosebumpss😘😘🙏🙏🎸🎸🥁🥁🎻🎻
Lokesh John	Plz upload seperate separately each one
Dinakar Dyagala	Amazing bgms
sai rakesh	Home coming highlight raa baabu assalu NTR entrance pichi ekkinchaadu
gorati jaipal	దీనికి కూడ dislike ఏంటి రా దరిద్రంగా
PREM KUMAR	అరాచకం
Mahesh Dadala	Nooo word
Vinod Polaki	Home coming super
hiranya gurujupalli	Jeji maata flute music lover hit like
shankar bharat	excellent background music
Nagsai Ands	3 54 littt 🔥🔥🔥
Venkatesh oggula	15 25 Goosebumps 🔥
Konda Nagaraju Goud Konda Nagaraju Goud	29 00to30 55 varaku no word
Balu Varma	Thaman really awesome music
trilok sai	16 10 heart beat sound la undhi thaman garu thq u so much thaman garu
TIRUPATHIRAO SURISETTY captain	19 30 🤗😍😍😍😍😍
mavullu eluri	thnks for the video guy
pranay kumar	Great Bgm Looking forward for more movie to release their bgm jukebox All the best AS team and NTR sir
praveen kumar	I wa waiting for this since release day thank you for uploading I love this movie
Kumar Janga	Jai Ntr
Jameer khan RC	bgm ka badsha thaman Yenti e bgm abba addiripoindi no 1 music director lo thaman ku da okkaru Heart touching music thaman bhayya
rasool Abdul	Home coming ithe goosebump
Prashanth Pambala	BGMs lo 3 8 14 Music🎶 Kirrak👌👌👌
Ranjeeth Kumar R	A dislike entra babu picha na asalu valaki mana movie hit review vene vene cheuellu pagellipoyinayi As told by NTR SST ha kept his life into the music for the movie for Anti fan this is not NTR it s the appreciation alaround for Tamman a a music director try to encourage him ur hero also will need him in near future just keep in mind
venkat mouli srh	3 00 to 5 00 full mass
M. నాగరాజు	కళ్లు మూసుకునీ Bgm వి౦టు౦టే ప్రతి సీన్ కళ్లకు కట్టినట్లు కనిపిస్తో౦ది నేనూ 4 సార్లు చూశా మూవీ ఇపుడు 5 వ సారి సినిమా చూసిన ఫీలి౦గ్ వచ్చి౦ది నాకూ Hats off Thaman Sir No doubt మీ కోస౦ చాలా అవార్ద్స్ ఎదురుచూస్తున్నాయి
Rupesh Kumar	BGM ka thop thaman❤️
jakeer asif	Super bgm S S thaman bro 👌👏
Madhu a	15 12 nunchi start avtaadi choodu headphone peli poddi baiyya asalu BGM ayte undi❤️❤️😎🔥
Shashank Naidu	Thaman jeeevitham lo till now only businessman he gave good music rr bgm Now this is top First aravindha samedha
Raghu Master	Goosebumps teppinchaav thaman bhayya superb
Maheshbabu Govindu	If u watch movie close your eye and listen U will visible in 3D effect Love u Ntr nd sst
lavu ganesh	Thaman 🔥🔥🔥🔥🔥🔥what a BGM u have taken the movie to next level
Tirupatirao Vanjarapu	You nailed it thaman Anna TTT Tarak Trivikram Thaman Trimoorthulu
G SUNIL KUMAR	Peak level performance of the cinema music credit go to lovely music director young Dynamic real hero my lovely Bro S S TAMAN
phani kumar	4 20 small bit superb thaman anna
naveen chandra	Home coming BGM ayithe NTR introduction ultimate total cinema inko level idi asalaina NTR ante
Bussa Vk Reddy	Evadra music le fellow 165 dislike kottaru siggu ledu ra meeku Jai Thaman anna
T- Series WhatsApp status	Super song 😍😍😍
koppisetti nari	Bgm adurs
ALL IN ONE	14 50 nundi aa bgm ki Salam ✊✊✊
Chintu Arela	All super 👌👌 Home coming Istamleni maarpu 👌👌👌
Pavan Pavan	super 🎻🎵🎶🎺🎹
tripurna chary	Telugu BGM king Thaman Bagamathi aythe BGM valle cinema hit And This video is a Straight answer to all the critic
Uday Surya	Thaman gave his blood and soul for BGM especially congratulation
GIRI DARAPANENI	💕💕💕💕💕💕💕🙏🙏🙏🙏🙏
madhusudhan n	Suppperb
pavan pavan	Nice first bgm album in tollywood keep rocking thaman congratts for the big success of aravindasametha
HD STAR	jr ntr is super actor ntr all movie super hit jr ntr fan hit like here
eswar jm	4 25 ❤
Shaik Khaja	Amkottav anna super 👌👌
ashok kumar Gajula	Kantapaddava bgm అరుపులు అసలు
Prathap Pothi	Finally 😍😍😍 Thaman😘😘😘
ravi chandra	Thank you so much thaman gaaru maa Anna movie ki jeevithamlo marchipoleni music play chasaru hat s of Jai ntr
kishore chintada	Move ki main music next NTR action and next Jaggu bhai character I m pk fan
soma satheesh	29 10 no word
Sandeep Chepyala	Reddamma super👌👌👌👌
bhaskar reddy	Inka kaavalsindi ntr Kada Sari poodu
Ultimate creative	Nice bgms thaman bro 😘😚😚
Charan Tej	In 5 1 sound wahhhh first time Taman bro you rocked with ur BG score Especially from 26 13 👏👏👌👍 Keep doing like this bro And hatsoff to SoundEngineers Champesaru anthe BGM
nag bs 117	After long time I am big fan u thaman sir
bhamidipati chaitanya	Anna thank u thaman very special music director all BGMs are🙏🙏🙏
manish aravind	King of bgm after manisharma 👌👌👌👌
Sandeep Kumar	BGM SUPB 👌👌👌 👏👏👏👏👏👏👏
Vayalapalli Mahesh	Beautiful music thaman tq
Krishna Krishna	Atttt 9 10 goosebump
thangem surendra	Thaman Anna No word
Sampath Bunny	Thaman is bgm king💪💪
Nagababu Gundabattuni	Super music
THRISHUL REDDY	The peace meeting bgm raccha asalu vinna prati sariii goosebump superb
Mandadapu Saiteja	8 50 waha
sharon satvik swaroop	Superb background score by thaman
Pandu Ntr	Jai ntr thaman super bgm
manju nath	Super SST Anna Jai NTR
Yashwanth Nani	Home coming bgm superb From 19 33 to 19 56 Chala bagundi 😍😍 😍
BHUMAN	Some part of the bgm are not in the movie 🤔
Bharatkumar bobby	How to download individual track
Subra hmanyam	Kekka
Venkatesh Peram	Super
kiran kumar namburi	Superb music thaman after manisharma the best bgm by you
Prakash babu	Nice idea Officially BGMs released 👌🏻👌🏻
Mahesh Babu	Jai ntr
Ramesh Matukumalli	Awesome BGM 👍
Subbarao Guntupalli	Super jai ntr
HARISH RAO LINGAMPALLY	Super
Parineeti Chopra	Anyone is after thamans BGM s
lakshmi prasad pilli	Super Bgm
pandari krishna	Wow amazing background music
GAGAN SAGAR	Upload download version
jyothi prasad	Bathikochina Basi Reddy and Istam leni maarpu superb BGM
PAVAN REDDYPELLETI	Inni Manchi background score kottinavi vodilesi Edo okka song copy la undi ani dhaanni pattukuni velaadithey ela bro
Manjunath Chandrashekar	Thank you
Puneeth Kumar	Ee music ki kuda dislike kottinavallu aevarra baabu
p.yugandhar Sai	Istam leni marpu I can feel basi reddy emotion literally 😲👌👌
Veerapogu Adenna	Super excellent
Subhani Shaik	Woow Jai jr NTR🔥🔥🔥🔥🔥
ARUN KUMAR M	I think this gon na be a trendsetter
virat	😍Thaman career best😍Jai NTR Anna😘 goosebump vasthunnae ra Babu yam pettav thaman Anna music lo 🤩
murali prakash	✊✊😍👌👌👌👍
SHARATH KUMAR	4 25👌👌👌
Anirudhreddy Reddy	15 15 oora mass intervel bgm
Bhuma Pakki Reddy	Super b music composed by thaman sir
Narigarikumar Kumar	I love thaman
Mamillapalli Sai Prasanth	😘😘😘
Gowri Ch	Super SST sir love your music pretty much
Mani Milky	Jai NTR and Taman music wonderful
Venu Mrichi	Super
bobby mullapudi	Thaman anna😍😍😍🙏🙏
sai divakar sanjeev Yanamadala	intro music highlight
Praveen Goud Bingi	wow BGMs ke Jukebox release Cheyyadam 1st Time IN The Industry PowerOfThaman Awesome BGMs Tq For Uploading BGMs THAMANSS
gandham bhanu teja	Kantapaddava no word just next level bgm 🤘🤘🤘😎✊✊✊✊✊✊✊✊✊✊🤟🤟
rana reddy	Hats off Thaman 👌👌👌
Shekar Pavan	jai ntr ntr is amazing in this movie
Thuvvapalli Giri	Hatsap thaman anna జై నందమూరి తారక రామారావు అన్నయ్య
Surendra R	SST goose bump many time
Shankar N Shankar	Hsm anna
Special Focus	Thaman anna ni vimarshinchevallaki idhi chempapettu
Mouly Prasad	హాయ్ తమన్ గారు నైస్ మీ మిగతా సినిమాల కూడా అప్డేట్ చేయండి
Sai Nani	👂👂👂👂👌👌👌👌👌👌👌👌 tqs to Thaman SS
Mahesh Vadnalam	I loved very much Love you taman Nee bgm ki ye cinema Aina gurthundipovali Asvr ki major pillor meeru anadam Lo apoha Em Ledu Hit like for taman 😴😴😴😴😴😴😴💆💆💆💆💆💆 taman ki like veskondi fan
sagar kaluri	Super bgm challa bagundhi
Pad's Madhu Anumula official/youtube.com	19 30 to 20 00 super thaman bayya Interval scene superrrrrrrrrrrr👊👊👊
kesiraju gowrisankar	👌👌👌👌👌👌💐👌👌👌👌👌👌💐💐💐👏👏👏👏👏
Shivanna H	24 35 to 25 40 varaku Thaman Bhayya🙏🙏🙏🙏🙏
BIKER 400	JEJI MAATA 3 7 20
Pavan Peruri	28 5 to 30 5
Ankaiah Ankaiah	Superb BGM GOOSBUMPS ✍️
devendra devendra	Meanwhile copy bgm decoder situation after this jukebox 😂😂
Lokesh Reddy	Awesome album bgm s do the same thing for all movie
satish m	🙏🙏🙏music super
Jay chandra kk	Ram Asurasam Samaram 🔥🔥🔥🔥🔥🔥🔥🔥
Bandlamudi Ramesh	8th wonder
Panuganti Ashok Kumar Ashok Kumar	Telugu indistriki inthaki minchina director ledu That s sst
Naveen Mudavath	నా జీవితం లో ఇంత వరకు ఎప్పుడు కూడా ఇలాంటి bgm విన లేదు సూపర్ భయ్యా
Mk Pk	Super bayya
ramajineyulu.k anji.k	Super thaman bro🔥🔥💫💫
Rly king's arjun	BGM S ALL R AWESOME THAMAN BAYYA 💓 HEARTLY 💓💓💓💓💓💓
Naga Nagaraja	I am from Bangalore 👌SST Music best music world BGM mind blowing MY next movie music director in Kannada jai ntr
Deviprasad Bennada	Best cream from SST👏🏻👌🏻
Saivenkat Sai	14 52 to 20 00 between this bgm take the movie into next level Jai NTR Blockbuster Aravinda semetha
kallakula gopal	🙏🙏👏👏 SST👌👌👍👍
balaji LM	You are the trendsetter sir
Suman Palle	Jai ntr annnnnnnnnnnnnnnnnnnnna
Praveenkumar Sankala	This is the best in thaman sir carrier Bgm Goosbumps
Gollu Ganga	🌾🌾🌾🌾🌾🌾🌾🌾 🌾🌺🌾🌾🌺🌾🌼🌾 🌾🌺🌺🌺🌺🌾🌺🌾 🌾🌺🌾🌾🌺🌾🌺🌾 🌾🌾🌾🌾🌾🌾🌾🌾 ☁😊☁☁😊☁😁☁ ☁😊☁☁😊☁☁☁ ☁😊😊😊😊☁😊☁ ☁😊☁☁😊☁😊☁ ☁😊☁☁😊☁😊☁ 🌱🍯🌱🌱🍯🌱🐝🌱 🌱🍯🌱🌱🍯🌱🌱🌱 🌱🍯🍯🍯🍯🌱🍯🌱 🌱🍯🌱🌱🍯🌱🍯🌱 🌱🍯🌱🌱🍯🌱🍯🌱 🌼🌱 Hi honey 🌱🌼 🌾🌾🌾🌾🌾🌾🌾🌾 🌾🌺🌾🌾🌺🌾🌼🌾 🌾🌺🌺🌺🌺🌾🌺🌾 🌾🌺🌾🌾🌺🌾🌺🌾 🌾🌾🌾🌾🌾🌾🌾🌾
Krupa varam	Superb
Appalanaidu Ch	Wow
Venkata Sunil Kumar Duggempudi	Very very very gooddddddddddd👏👏👏👏👏👏👏👏👏👏👏👏👏👌👌👌👌👌👌👌👌👌👌👌👌👌👌👌👌👌👌👌
raju gogula	Super jai ntr
Sultan Mirza	3 54 My Favorite Mass
K. Hari	Reddamma thallus super 👌👌👌
Ramana Venkata	Very nice music 🎶 jai N T R Anna 💐
Nanda Kishore	Guru mani sharma tagina sishyudu apdu aayana BGM ki raaju ipdu thaman BGM ki Raraaju
Palnedi Mahesh	Peace meeting my favrt 💟💟
shiva rama krishna	👍 👌🙏Reddemm thallus సెంటిమెంట్ song ki goosebump వస్తున్నాయి
NAVEEN YADAV	Ram ram rudiram wow what a bgm irrakottesadu akkada naku chala istam ippudiki ennisarlu vinnano thaman nuv keka
Vishnu Vardhan	06 55 is highlight 👌
Sudheer Dorepalli	SST nikante avvadu best evvaledu not only for this movie nuv king
kotesh yarlagadda	Goosebumps BGM 👌
MB Mani CREATION'S	PURE GOSSEBUMPS 😎 BGM VINTENE MALI INKO SARI MVE KI VELI CHOODALE ANIPISTHUNUDE THAMAM TNKS BHAYAA ENTHA MANCHI BGM ICHEANDUKU JAINTRANNA✊
Kotakonda Mahindra	Ntr
Suresh Kalyan	Superb bgm and one of the best BGM in NTR carrier this bgm only best in Taman carrier
Palavelli Bala Harinadh	32 35 NUNCHI REDDEMMA SONG FEMALE VERSION HOW MANY ARE WAITING FOR THIS
Telugu Updates By Akhil Akshar	Jr ntr big bos show full entertainment http youtu be 8Do9fBmcUcs
Chandhu Dasari's	7 25 8 30 👍
Suryanarayana B	Bgm ka bos thaman bayya salute bayya
V Mani	20 0 superb
Status King	20 50 👌
anand raju	Nice background music you rock thaman
raja ravi	What a music brother BGM is superb brother recent movie lo vy top music i am listening with continuesly
пруут Рссйя	I want all these bgm in mp3 format were can i download these Pls help A BIG FAN OF ANNAYA JR NTR LOVE HIM FOR ETERNITY
r.k harish r.k harish	No word supper supper Jai ntr జై జై ntr
DERANGULA SAI PRAKASH	Neelo Unna talent bayataki teesthe intha appreciation vachindhi adhi okka cinemakee Dinni continue chey nuvvu oka manchi position lo untavu Idhi nijam
raj shekar	20 02 scene matram movie lo rocking scene bayaa
Arif Mohammad	mind blowing awesome Super
Jayanth Chowdary	19 35 MASS🔥
Sai Krishna	14 51 goosebump bgm in movie 👍👍👍👍
Nareshks Nareshks	super jai ntr
satyanarayana Pasupuleti	BGM Superb Ra ayya🙏🙏🙏 Thaman 🎹🎹🎹🙏🙏🙏🙏
Babu vasa	Hatsof bhyaaa 🙏
Narendra G	20 20
rakesh boddu	34👌👌👌
Manoj Midde	Thaman anna cinema Ku ni bgm tho pranam posav anna superb
Jujjuvarapu Dinesh Kumar	Kantapaddava 14 50
Aloji Bhukya	Super BGM THAMAN ANNA GOES BUMPS
GH production's	please release one by one
Raj Kushal	Superb SS thaman sir
Sanath kumar raju	32 28
Kolapudi Indra Kumar	15 15 ite just arachakam aslu
Manju Brs	Supar♡♡
Boyakrishna Krishna	superb jai nandamuri family fantastic movie
Kasigari Deva	superb
Sai Lanka	So quiet music highlight
khaja molla	Tamman sir ur rock
Naga Vamsi	Seriously ntr Anna chepinatu thaman pranam pettadu bgm
Upendra Yadav	What a bgm pranam pettaranna Thank u Thaman anna Listening home theatre
jaffar hussain basha	Superb👌👌👌👌👌
Jagadish Jaggu	Thaman is a brand ambassidor for bgm like bhaagamathie sarrainodu race gurram etc
Wenuuhh Wenuuhh	Career best bgm thaman
Mahaboob Basha	పీస్ మీటింగ్ అండ్ టార్చ్ బీరెర్ సీన్ పీక్స్ అంతే My ఫేవరేట్ bgm
Mani Supraja	32 00 to 55 mind blowing voice
machagiri siva	Taman you are a torch bearer of this great bgm 👌👌👌👌
PC WORLD	Pomodoro Bathikochina Basi Reddy Home Coming Redamma Thalli Jeji Mata Kantapaddava istam leni marpu BGM S WAS OSM GOOSEBUMPS SUCH A DIFFICULT MUSIC
Mahesh Wara	When we r lisitening 2 THIS bgm taking some were really thaman bro u bgm wa luscious
Dance with SURYA	Thaman sir 😍😍😍
madhu babi	Home coming and kantapaddava bgms are vibrant and marvellous composing ya
Sathibabu Majji	Tamana Anna great nv
Nagarjun reddy Cv	Jai NTR
jk temper	Last bgm is asume One and only best bgm in this movie
thumati mohan rao	Kantapaddava 😘😘
Sai Vineeth	Thaman Anna champesav😍
Sai Mamidisetti	Superb Thaman
Nagendra Nani	Taman Bgm 👌👌👌👍👍👍👏👏👏
Dudekula Shafiulla Shafiulla	Super
Guru Swamy	Super taman sir
Shivakrishna Msd	This album is awesome jai ntr anna
Nagarjuna Khandavalli	Thaman hatts of
srikanth pallerla	This definetly deserves a National award
Reddy Shekera Shekera	👌👌👌👌👌👌👌👌👌👌👌👌
mamidi srinu	Last one👌🏼👌🏼👌🏼😍😍
Shobhan Babu	Super BGM
yerragunta harikumar	Bgm superrr thaman sir
Mahesh N	6 10sec dhaga nundhi super
Imran Khan	Speechless so much thanks for releasing this bgm
Mahender Chinna	Thaman bhaiya Ni fan GA Maranu bhaiya 🙏🙏🙏🙏🙏💐💐💐👍
Kranthi Kumar	Impressive bgm from thaman 👏🏻👏🏻
shekar ganta	Awesome Background Score
Rajesh G	👂 👂 👂 hear phone Super
Sayed Ali	Home coming BGM music super Thaman sir same like Ar Rehman sir music And jai NTR anna
lakshman sriramdhasu	thaman super bgm bro
Aravind Harsha	kantapaddava lo variation abbabba peak rachha music niyamma endra aa music intha detailing aa prati instrument di electronic composition di 😍😍😍😍
vengalarao vr0333	SST BGM super 🤛🏻
Sai Smart	Best bgm taman it s great job
My God power star	First this kind of bgm jukebox tq taman
Gowda Jagan	Super
Liteesh Kumar	Excellent
Pesarubharani Pesaru	SST super music anna
jyothi prakash	Hit like for reddemma talli song👌👌
harish velkuru	Addicted to reddamma song 👌🏻👌🏻👌🏻👌🏻👌🏻
Raju Mindi	మూవీ ఇంత హిట్ అవ్వడానికి SS తమన్ మ్యూజిక్ కూడా ఒక కారణమే 🔈🎼🎶🎵🎹🎙👌👌👌 👍👍👍
Gangadhara Kookati	Xlent BGM
Rajkumar Dharavath	6 33
Mohan Nice Good Krishna	The best👌
Prashanth Tarak	Super
Arjün Jãi Räm	ꜱᴜᴩᴇʀʀ ʙɢᴍꜱ ʙᴜᴛ ᴛʜᴇᴀᴛʀᴇ ʟᴏ ꜱᴏᴜɴᴅ ʟᴇᴅᴜ😔😔😔😔
Sj Jeevan	ohhhhhhho WONDERFULL BGMs awesome searching for this bgms everywhere finally got it salute to THAMAN
Manikanta Veeramallu	jai reddamma
Venkataravamma Vemireddy	ఉహాలకందని రీతిలో మాటలతో పోల్చలేని విధంగా Back Ground Score ఇచ్చారు Thaman గారు
Ravikumar Thomas	Thaman mind blowing music
AKJ 21	Tamann goosebump hit the like if like this BGM
komma nagesh	Wow fantastic ultimate word won t enough to say about AravindaSametha BGM 👍 Thaman gave best BGM of the decade👌
Sanapathi Ramesh	22 15
krishna chaithanya reddy	Kantabaddava BGM awesome
Sathish Varma	Redamma thallus film version super
Ramulu Jinugu	Super sst anna kaushalarmy
Dhanush Venkat	👌👌👌👌
phenomenal 1	32 34 hit like if u r waiting for this
Rudroju Gnaneshwar	massacre 👍 SSThaman AravindhaSametha OriginalBackgroundScore
Gireesh Kodali	0 32 NTR appears for the first time in the movie Goose bump 👌
মারিয়া মিলি	joss
Sivakrishaa Battula	Jai ntr Anna
Purushotham Ranjith	Sst best
Saiprasad Katragadda	10 30 ❤️
Chityala Ajay	Thaman show
Peace - 8D Music	checkout 8D effect Anaganagana Song frm Aravindha sametha Here http www youtube com watch v QFQp286akYM
syeklone kiran	First time u proved that you are a student of Manisarma
Anil Kumar chirra	Reddama thallus song singer super voice
Kondalarao Patine	superb Thaman bhai continue congratulation and all the best
mubarak ali	Thaman bhayya yemanna kottada 👌👌🙏🙏
SOMESH K	Peace Meeting Super
JAYACHANDRA RAJU	Homecoming sound a lot similar to “ unlocking the mind ” from the movie THEORY OF EVERYTHING
King Maker	He nailed the peace meeting bgm
Anjaneyulu Komera	super 👍👍👍👌👌👌👌 jai ntr
NTR RAKESH	19 35
Shaik Rehmat	Some music pspk and trivikram combination lock unnai
PUBG Telugu - Bekaar Aatalu Bekaar Muchatlu	Naa darling Thaman ni hate vaallandaru chevulu tappa kallu noru migatha anni randhraalu muskuni vinandi okasari I personally feel this is his career best work So many new instrument in single album Love you Thaman 😘😘😘😘😘😘😘
sai prasanna	Pre release event lo tarak Anna taman kakunda inkovaru music evvadam oohinchukolem ani adi Matram really fact asall enti music oka range lo undi super thaman garu ee movie tho nenu neeku pedda fan ni ayyanu
Narsimha . . .	Super guroo gaaru😍😍😍😍😍
Kondala Rao B	Super
Sekhar Uppati	jai ntr
Sambasiva Rao Vijanagiri	Kantapaddava😍😍
raama krishna9	not bad not good ee BGM sarepodu NTR ki
patnam vijay	Use headphone and enjoy the music😍😍😍
sudheer kumar	BGMs intaa unte movie scene kalla mundu kadaladtunattundi balreddy
devagudi rahamad	Super bos
Basheer Basha	Super
Ranjith Rk	NTR Anna fan 😍👍
Indra	Thaman just nailed it Elevated the scene with his music
Srinu Srinivas	Its like Horror film bgm Omg awesome Goosebumps
surendar banoth	Super bgm jai ntr anna
Semanth Kota	Jai NTR
Sekhar Raja	Outstanding BGM one of the main highlight of the film
SRAVANKUMAR REDDY	♥️♥️♥️
sriram 24268	Simply superb Great job thaman s
Gangadhar Karthik	Kekaa
ganga dhar	Ntr fan hit like💯🔥😎
Y Srikanth	Ss thaman music blockbuster awesome superb bgm anna ni music kaika ni ku padha fan jai ho thaman
CHANDRA SEKHAR POLEPALLI	osm Bgm
Kiran rana	Emi chebuthamanna ee BGM kosam Hatsoff thaman anna BGM amma moguduki amma mogudu thaman anna yantha cheppina thakkuve avuthundi 🙏🙏🙏🙏🙏🙏🙏🙏🙏🙏🙏🙏🙏🙏🙏🙏🙏🙏🙏🙏🙏🙏🙏🙏🙏🙏🙏THAMAN best music director in tollywood vintunte goosebump vastunnayi minde blowing BGM Jai THAMAN anna 🙏🙏🙏🙏🙏🙏🙏🙏🙏🙏🙏🙏🙏🙏🙏🙏🙏🙏
Manikanta Geddada	Super
Muzeeb Md	Devadasu Bgm please Manisharma
Sai Srinivas	Super 👌👌👌👌👌👌👌👌👌👌👌👌👌👌👍👏👏
Rakeshchowdary Muppaneni	Bgm super🙏🙏🙏
Mervin Yesuthasan	7 50 8 30 ♥
ashok gorantla	Super
dheeraj varthi	BGM 👌
SAHIL PATEL	BGM is SOUL of this Beautiful film 💝
urstruly suresh	27 39 Torch Bearer 👌👌👌👌👌
sai bharath	Superb bgm s brilliantly composed by thaman
Kalyan Chakrawarthy	Nice BGM Liked Mondi Kathi especially can t describe the emotion and feel
jambi sreenivasulu	Thaman anna super BGMS sampesaav anna
badrinath b	Extraordinary BGM
Bhukya Ashok	Enti bro super taman bha
Prashanth Gundagani	Thaman love u I ’ m always u r fan ❤️❤️
Sreenivasulu Reddy	Super Bgm But how many got remember BB Bgm
siva krish	Reddamma thali song🎵 and remaining songs👌👌👌👌👌👌👏👏👏👏👏👏
Harish Kumar	Peace meeting and Walk into peace 👌👌
Pk Tech Rider	Really osm
Ch Mallikharjun	4 20
vishnu podem	bgm super super super
Gowtham Mahi	19 30
raju jeevan	Ventastic BGM 👌👌👌👌👌👍👍👍👍👍
CHERUKU NAVEENKUMAR	19 35
tulasi reddy	super
sunilkumar balu	Excellent Bgm of thaman album
Manoj Manikanta	Zee music thankyou soo much 🙏🙏🙏
santhosh 7	kekka bgm
Kalyan Kumar	Super bos tolly wood top 2nd music director
SS Creation Shekar Videos	బ్యాక్ గ్రౌండ్ పగిలిపోయింది మైండ్ బ్లోయింగ్ థమన్ సర్ lot of thanks AA Fan s
samba siva	Exoridinary music from thaman one of his best performance thank u from NTR fan
g.nikhil 112233	Super super super super SST BGM
AyaanLokesh 753	Torch Bearer 🤘👌👌
V Sanny V Sanny	keka bgms
Naveen A	Vintuntene Goosebumps vastunnayi Taman gaaru 👌👌Maku ilanti music ichinanduku Meeru 10 kalalu paatu sallangunda 🙏🙏
Abhijith Viswanathan	Jai Ntr
RAKESH KOTHAPALLY	సూపర్ థమన్ అన్న
Prasad Chowdary	7 45 goosebump Music 🎶
Konreddy anjaneyulu	Reddamma thali super 👌👌👌👌
NTR the LegenD	Jeji Mata ringtone matram 😘😘
srinivas jadala	Awesome bgm by S S THAMAN 👌👌👌👌👌👌👏👏👏👏👏👏
Pillipuram Mohan	Superrrr Bayya
sujith Fanof Ntr	Reddamma Thalli Mohana Bogaraju Voice ❤❤
Chiluka Anirud	Superbbbbbb 👌👌👌👌
Sri Krishna	Anaganaganaga 8D effect Song http www youtube com watch v QFQp286akYM
sravan teja	The best bgm till date by taman and also it will remain a the best for ever and ever and ever
Somayajula Trivikram	Mind blowing BGMs awesome😚😚👌👌
naga SU5884627	one of the greatest background music of thaman
Kusume Sandeep	All BGM lo naku bagaa nachidi TORCH BEARER😍😍😍
Suresh V	Super
Naresh Rockzzz	Super BGM s thaman bhai Good Job 👌👌👌
Whatasapp stueas Telugu	Jai Ntr bgm super 👍👍👍
Sunny Creatives	6 08 😍
Dilip Kumar	Thamanaah majakaa
Ragi Rajesh	Thank you for official BGM Jai Zee Group
marripudi siva	Jai ntr anna
Mahesh Kota	Home coming Erra Padda thadika leru part 2 bathikochina basi teddy and peace meeting
Suresh Gurrapu	Reddamma thallus Climax song highlight who is singer plz tell me
A.Naveenchary Avusali	Super thaman bgm
uma maheswar Subhasiny	All time telugu best bgm s ASVR 👍 💪✌👌👏 Thaman gaaru 😍💪👏👏👏👌👌👌👍👍👍👍👌👌👌✌✌✌💝💝💖💖💖💓💓👏
Deepak R	26 05 I can listen all day
Venkat CH	Mohana bogaraju pulled a blinder Great work thaman 👌🏻
Sujitha Mani	4 20 nunchu my fav part
R venkata ramana	Super
Azamali Azam9255	👌👌
Sai Mamidi	Ntr entry seen bgm kosam nenu 7 time chusina movie
Illapu Harish	home coming kantapaddava torch bearer awesome 19 33 goose bump
srikanth mallela	Superb thanks to zee music
pavithra kumar singanodi	Akkadakkada copy tune anukunna parledu konchem difference undi
Sandy28898 Sastry	At 7 55 😍
Vidhyasagar Reddy	Wow super
Nuthalapati Narasimharao	అద్భుతం 👌👌👌👌👌👌😍😍😍😍😍😍 N T R
Hari Babu	Superb thaman s
ashruf ali	Okkasari oohinchu kondi MB PK NTR kalisi movie teesthey elavuntado
RC Lheen	My lover is crazy about you JR ntr He even love you more than he love me Hehe
bhadra bhadra	amazing music by taman
kappalamohansivareddy reddy	Anna thamn music adhrindhi
Ra dha	Gift bay all fan NTR
Saleem Shaik	31 00 to 32 30 goosebump 😱😱😱
G Vijay	Extraordinary bgm love you thaman
Syamjebedla Syamjebedla	Super duper Backgrounds
Vikram ringtones world	We want aravinda sametha karaoke song also Please upload
Venkatesh Y	All bgm super
Vineel kedarisetti	Torch bearer 25 49 njy guyzzzz
Koppaka Hiranya	bgm avsr 👌👌👌👌👌
siva koti rambabu v vudatha	super
lakshmi narasimha	24 and 29 super
MOHAN	i want these song in mp3
K Murali Krishna	15 56 BMG super
palakonda rayudu	Jai tarak
GUVVADA PRASAD	Nice tone
raju seera	Super BACK GROUND MUSIC great job taman
VenKy Virat	TFI lo BGM amma mogullu Keeravani Manisharma Thaman 🙏🙌👏🏼💛
Gopal Tarak	Jai Ntr Anna
Telugu inspiration and information	3 58 Goosebumps❤️❤️❤️
santosh kumar	Jaiiiiiiiiii ntrrrrrrrrrrrrrrrrrr
reddypogu ravi	Super anna
ch venkat	Super
Saicharan Venkata	Thaman career lo best bgms padda movie
Pradeep reddy Gangula	15 21 awesome sst
suresh reddy yaparla	At 15 17 BGM no word Peaks
ashok kavali	SST BGM FOR ASVR TTT MOVIE 🙏🙏👏👏👌👌
Tiru Malesh	thanks thaman annayya bgm super jai NTR
imraan Jyash	Dhummu lepaadu Thaman bhayya
jayachandra gudla	Block buster movie ki BGM unte ilane untada
Praveen kumar	19 50
Lalitha Vaddadi	7 48 antha bgm kadha thuuu different ga vayinchaidu anthai 😂😂 thuu thaman
Victoryyugesh Re-turns	19 33 Bassi reddy fan hit like
Nagesh Maharshi	Aim Mahesh Babu fan but IAM enjoy NTR ASVR movie success 👌👌👌👌👌
arjun reddy	Super thaman Garu good job
Rakesh shava	Goose bump bgm s hat off thaman sir
Bharath Krishna	Thank you so much for giving this album 👏👏🙏
SEKHAR KANE	Best Bgm in thaman career
vamsidhar kolluri	Nice every movie should release official BGM like this especially DSP movie
Ntr Fans	Jai ntr
vinnu vinod	home coming BGM 👌👌👌👌👌👌👌👌👌👌👌👌👌👌👌👌👌👌👌👌👌👌👌👌 block buster move💞💞💞💞💞💞💞💞NTR acting super super BGM
Krishna Gedela	Thaman u rock the 🎶 cinema hit lo ne help chala undi
Veepu Ramesh	Nice music thaman garu keep it up
m Manohar	What a Bgm Mind Blowing Superb No Word s Thank You Thaman Jai Ntr
Theyda Singh	Thnq zee music Fr BGM
Venkey Venktesh	Super 👌👌👌👌👌
Rohit Saketi	BGM mental ekkisthundhi
yellesh putta	మాటల్లేవ్ only one fasak anna fan one like maar 💪💪👈
Ram Ramudu	32 34 reddamma thallus
Venky K	only one fasak bgm thaman 🔥🌟😎💪👌🎧 tiger ka bgm baap
Mohan Sai	Peniviti and Reddamma thallus BGM just wow
Kiran Chowdary	Peace meet and torchbearer bgm s next level 👌👌 Goosebumps music great work thaman garu Torchbearer NTR 😎
Trivikram Srinivas CBRE	Great applause to you Thaman
sudhakara dandoji	Good work Thaman Real sishya of manisharma emannaa kottavayya Mental lestundi RG2 tholiprema baaga
Vinay Ram	Greattt
vijay Kumar	Guys u can listen in 5 1 home theatre wow same theatre effect
NEW AGE	My favs😚😚4 20 9 55 PLUGIN EARPHONES 😚😃😃 Night effect please
Narendra A N	Super 👌👌👌👌👍👍
Kar Thik	Tq tq sooo much
HEMANTH gamer	Super bgm
PsPk Fans Club	Super thaman Garu Mee dream project ni blockbuster chesaru👌👌
Vijay Swaroop Ramadas	10 46 to 11 16 is just heaven ❤❤❤
Sahitreddy T	I m waiting for Mahesh Trivikram combo Mahesh fan hit like if you agree
Rajesh m.v	BEST BGM in Thaman Career 👌
prasad geetha	Jeji maata super 👏👏👏
Siva Siva	Super taman Anna nee music vintu mimarchi poya
Srikanth ms	Super
Hari Krishna	Awesome awesome awesome awesome awesome awesome S S Thaman Bhai
S Harish	Most satisfying BGM THE BEST OF SST TILL DATE 👌👌👌👌👌
Pranaii 1729	Thaman ante thaman e Super
srinivas chess	21 27 25 49 8 33 14 50 7 23 Thank me later Thaman rocked
Ramakrishna Reddy	Bgm chala bagundi movie bagundataniki plus ade mondo kaththi bgm content goose bump vastunnai
Manish Siddamsetty	SST rawwww🤩
BHARATH REDDY	ASVR bgm Businessman agree I mean best
ganesh varma	Wow next leval bgms thaman bhai 🙏🏻🙏🏻🙏🏻
Ajaykishore Mahakul	Superb BGM
viswanatha reddy yapamanu	Thanks zee music South team for made this
Pawan kalyan updates	15 20 👌👌👌
Raju Thalaiva	10 20 👌👌👌
Likhithkumar Bathala	11 00 🔥
saikumar kokkera	Wonderfull bgm tenkas thanks Jai ntr
Sri goud saab	Loving BGM Thaman ji keep doing ur amazing work
Achanta Hari	0 48 to 1 10 awesome
Mahesh C	Niddarani irisesei Reppalni therisaanu Nuvvocche dhaarullo Choopulni parisaanu Onteddu bandekki raara Sagileti donkallo padilanga raara Naligeti naa manasu Guruthocchi raa raa Galaboti koorondi Pilichina raa raa Penimiti enni naallainadho Ninu zoosi kallaaraa Ennenni nallainadho Ninu zoosi kallaaraa Chimmati cheekati Kammati sangati Erraga kumpati Ecchaga duppati Kommallo sakkati Koyile okkati Kommallo sakkati Koyile okkati Gundene gonthu chesi Paadathandhi raa raa penimiti Chimmati cheekati Kammati sangati Erraga kumpati Ecchaga duppati Kommallo sakkati Koyile okkati Kommallo sakkati Koyile okkati Gundene gonthu chesi Paadathandhi raa raa penimiti Polimera dhaati poyavani Polamaaripoye nee dhaanini Kodavali laanti ninnu Santi vaadini Konguna daasukune aali manasuni Soosi soodaka sulakanu seyaku Naa thala raathalo Kalathalu raayaku Thaalibottu thalusukoni Tharali tharali raa raa penimiti Hey thaalibottu thalusukoni Tharali tharali raa raa penimiti Naragosa thaake kaamanduve Naragosa thaake kaamanduve Nalapoosavainaa kantikandave Katiki yendalalo kandipothivo Ragathapu sindulato thadisipothivo Yelaku thintivo ettanuvvuntivo Yeta katti thalagadai Yeda pandukuntivo Nuvvu ganna nalusunaina Talasi talasi raara penimiti Hey nuvvu ganna nalusunaina Talasi talasi raara penimiti Niddarani irisesei Reppalni therisaanu Nuvvocche dhaarullo Choopulni parisaanu Onteddu bandekki raara Sagileti donkallo padilanga raara Penimiti enni naallainadho Ninu zoosi kallaaraa Ennenni nallainadho Ninu zoosi kallaaraa
Shaik Wajed Ahamad	Awesome SST sir
Akhil Abhinay	Awesome Bgms By Thaman
TRUE TALKIES	Super
skshajahan shajahan	Super bgm
Manasa Anannya Creation's	That Peace Meeting Bgm ki Dandam Thaman Sir No Need To Prove Sir U already Proved Sir No more Orgue To Unpord Fellows Love u sir 😍
Siva Prasanth	15 00 Goosebumps Kantapaddava
ramakrishna reddy Gondhi	Thaman Anna nvv intha different extraordinary bgms istavani aslu expect cheyaledhu super Anna only bgm kosam movie ki vellevallu kuda unnaru ante adhi Ni kastam Anna
Abhi Ram	BLOCK BUSTER 👌👌
nagendra kumar	Awesome BGM Thaman Ji Please upload it to Itunes also
U Maruthi	Goosebumps BG Score And Great Job done By SST 😍😍👌👌👌😍😍👍
Naveenkumar C. N	Introduction bgm uper
Pavan Chowdary	Goosebumps bgm👌👌👌
Kvn Nagesh	Sema bgm super thaman keep it up
Ajay Ntr Bakthudu	వింటుంట్టే gosboomps vasthunnay 🙏🙏🙏 thaman Anna 💪💪💪
polavarapu umesh	Maree dheniki kuda dislike enti brother
pavan kota	Thanks a lot for uploading this Eagerly waiting
Bujji Tarak	ram rudhiram bgm pls
Suresh V Suresh	nice bgm thanks taman garu
Rahul chinntu	Okkati miss aindi bgm track sunil poojahegde vallu ooriki enter aithu untaru aa atm card gurinchi matladtaru tarwatha flute tho oka music start avuthundi aa music a climax lo malli athanu antadu valla naina ni champina kuda nannu em analedu ani brahmaji tho ilantonni champithe mattikottukapothamani apoudosthadi oka music adhi miss aindi aa music okkappudu indra movie chusinantha feel tho untadi one of the best and emotional bgm ani chepachu ❤️
shaik gouse	24 30 peace meeting bgm awsme 👍👍👍
suri suresh	Anadaru copy cat adi edi annyvallu e oka movie tho meru ento prove chaysaru sir pranum payytaru sir king of bgm
SAI KALYAN GOGINENI	Pomodoro reflects the class touch of taman
pudinaidu chinna	Bgms ki music cheyadam lo Taman and keervani ni beat chesevare leru 🙏
Md Azharuddin	Thnq taman Sir
Vashi Forever	Wowww Thanks to ZeeMusicSouth create this from NTRFans NTR Trivikram AravindhaSametha Thaman TTT
Narasimha Prasad	After listening I came to know without background score no film Excellent hat off to all musician 👏👏🎊🙏
Sudhakar Kuruva	Keka bgms
harish goud	Wow goosebump bgm anna
venkatesh rudrapalli	Oooposthundi
Manohar Jai ntr	unbelievable ultimate goosebump bgm thanks taman bayya jai Anna talaiva
Shivaram Ntr	It s gave u goose bump in theatre
Shafi A Shaik	Vvvv good bgms
B LakshmiNarayana	16 38
yadagiri gadenaboina	BGM superrrrrr
vinay kumar	Nice move by Haarika Hasini creation by uploading BGM straight away on YouTube
sagar s	0 48 goosebump
Ram Ch	Ntr intro bgm 😍😍 Just loved it
Jai Reddy	రెడ్డమ్మ తల్లి at 32 34 click and watch 😍👌
shaik mastan	Super thaman
Ganesh Vs Ganesh	super thaman anna
ARUN SAI	Thaman lover hit like
Karam Madhu Karam Madhu	keka Jai NTR Anna
D.J rohan	Thaman given a nice bgm
shaik Moula Ali smms	superb jai ntrrrr jai jai ntrrrrrrrrr
aglyreddy aglyreddy	Bgm super
Harshit Kumar	No೧ bgm movie ೨೦೧೮
Bodasingi Sattibabu	super sst bgm music
murthy narasimha	Part2 is super
N.Chinmaya Creations	14 50 keka jai NTR👍
Dileepbasha Dileepbasha	keka
allu suryanarayana	Nice bgm
Prasadkallepalli Prasadkalleplli	Super
Vishnu Vilas	Great music by thaman 😍👌👌
VARUN CREATIONS	Reddamma Thalli highlight
pulukuri jeevankumar	That is THAMAN 😎😎😎
vemulawada adarsh	19 32 goosebump 🔥🔥
venkatsaikiran jampana	Jaiiiiii NTR annaa😍😍😉🤘🤘✌️
vamsi kumar	Marvelous 30 12 on
Nithin Vyas Ravipati	BGM ka baap 🔥🔥🔥
ARUN TILLU	Reddamma thallus song 🎵 Osm song like 💗 here 👌👌🙏
Naveenkumar reedddy	Ee video chusthunte madhyalo evarikainaa phone vachi disturb ayina vallu unnaraa
I'M INDIAN	Pk fan one like
vinaychowdary maddipati vinay	jai ntr jai jai ntr
SARVESH Shetty	Can anyone plz tell me what is bgm
Ramanjaneyulu Vusa	Thanks alot thamann Garu for giving the mind blowing bgm
Nisssz Productions	👌👍
NAVEEN VELPULA	07 25 awesome keka JAI N T R TAMAN
B Jayaram	jay ntr
naresh shatharashi	Anni bgms Vinna tarvata malli movie chudali anukuna vallu oka like veskondii endukante edi mana Anna cinema Anthe UNANIMOUS
Kumars Karthick	Super
B CHANDU	taman rocked the music
Katti Raju	All are awesome
Manzoor Ilahi	Homecoming bgm pure goosebump Such a cool and pleasant music Taman anna fidaa aipoina neku 😍😍
Prasad Ramisetti	Super bgm
PRASANNAKUMAR J	Mind blowing BGM
Rajesh Hema	Bgm super
F I L M Y 2.0	3 53 Goosebumps
suresh karri	Keka
JMJ SCHOOL ACHAMPET	Kantapaddava is awesome
Surendra Tarak	Home coming 👍👍👍👍 Kehi maatA👌👌👌👌
BhanuPrakash Reddy	32 36 who is the singer
bhaskar Pasupuleti	Super bgm s 👏👌 ssT
Narasimhan Elamadri	ఊరికి ఉత్తరాన దారికి దక్షిణాన ని పేనిమీటి కూలినడమ్మో
Eswar Padala	6 45 goosebump with earphone Hats off thaman
bhukya ravindernaik	Mind blowing BGM Thaman TTT Tarak Trivikram Thaman Jai Ntr
Ranjan Reddy	5 21 Teji Matha
V Ravi	Super bgm score 24 27
NAGENDRA KALYAN	8 00 to 8 27 highlight bgm supeelrrr
Nanibabu T	Ishtam leni maarpu bgm gusebames
Nagesh Jamadar	NTR
santhosh kumar	Out standing BGM
sivasnr 7383	👒👌👌👌👌👌👌✌✌✌✌✌✌
Sai Shyam	One of the best work of SS Thaman👍👌👌 Eeraga teesaadu✌️👍👌👏 Kantapaddava BGM wa the highlight one for me💪💪😊
Naveen Kumar PC	Best of thaman career you nailed it bro
Gopu Latha	Extraordinary BGM 👌👌 NTR is the best hero 😘😘
Anjineya Anji	Super brother
kiran kumar	Superb
DLS Gopal	Thankyou harika hassini what a great release Thaman you work fantastic A r rehman tollywood lo kodithe etta untadho telsa ittaa
GN PRODUCTINS	JAI NTR
Srinath Parnapalli	Best from Thaman
Rudhra Yn it's a New Ism	Superb Bgm
pradeep kumar	Machipani chesaru bgms release chesi first time telugulo bgms release cheyatam
SandeeP SandY	Reddamma thallus 👌👌👌
Venkatesh Venky	I am a big fan of thaman from Gore gore song kick
venkatesan rajagopal	JEJI MATHA Keka 📣🎼🔥thaman sir congrats
nagalla srikar	Its not just a BGM for the movie Its a stress reliever Music taste vunna imkevadu THAMAN ni marchipodu We support u thaman bhayya for ever from all NTR PSPK MB fan
Peddayya Mulinti	NTR fan ki anni like
Sabaree Nadh	15 15 16 06 bgm super
David Ashok	Bro download option kavali
Shyamsundar M	Meeru music echhina 50 movie gurinchi okka mataga matladukunte Ee okka movie lo unna music gurinchi vandha matalu ga matlada vachhu
Suresh Gumpula	Best from thaman 👌👌❤️❤️
Vikram Katravula	Superrrr bgms thaman is back
P Brahmaum	AM PM NTR CM ✔👌
Jaswanth Gadde	Thank you soooo much for uploading BGMs
Madhu Madhu	kaka 👌👌👌
JayRaj .!	The song reddamma talli play a uge role to get cool claimax
Prasanna Kumar	Ishtam leni maarpu is haunting
Molugumati Vijay Kumar Vijay Kumar	Thaman talent trivikram garu bayatapettaruui
Gogineni Gopi chowdary	Jai ntr jai jai ntr
Ashok Bandari	Anna ntr movie super bgm excellent I l u anna
kofta kofta	tollywood all film scene are same to same no diffrent
Steel Plant Babai	30 00 to 31 00 super BGM few day lo e BGM Daily TV serial lo venipesthundi
balaji galpalli	9 21
Chennur Kishore	Extraordinary Thaman
G.manikanta Ntr	Sorry taman Garu first mimmalni tittesanu maa annayaku manchi music evvaledhu ani Kani theater Lo chusina taruvatha nijam ga super danchi kottesavu taman Maa annaya fan expect chesina danikante 100retlu yekkuva echhinava Maa Tiger cheppinatlu e movie ki Nuvvu tappa yevadu nayam cheyaledu thaman sir hat offff
WhatsApp status	Reddamma thallus sprbbbb 👌👌👌❤
Naveen Badsha	Google Looo Upload Cheyandii please Mp3 Download kavadam Ledhuuu
gunnam saikrishna	Taman anna👌👌👌
r	very happy to listen this and i think it firsr ever official all bgm are provided great gift to tarak fan
LIFE IS BEAUTIFUL	super bgm music thaman
BPD creations	Super bro
Taxiwala full length movie Telugu	100K view 12K like Super 🔥🔥🔥
Naveen Reddy	Jai ntr
Saikumar Vinodkumar	Ji NTR
Chetan v	Bgm ni saava gottadam ante edhe jai ntr
BABU PRASAD	Super
Peruri Purvika	super 👏👍👍👍💪💪💪
vinodkumar ganteda	My Samsung earbirds were shaked when JB sir bgm entered
sweety box	😶🙏🙏
Sudhakar Jessy	Thaman bayya music bgm supar
AKHIL CRICKET	7 23 the best
Kotlapalli Seshadri	Super thaman Anna Ne died of fan
srikanth kannedari	00 00 to 01 10 goooose bump happen Ma ooru gurtochhindi
jagadish jorige	Super bgm s
Ravi Kumar Dowluru	Ee bgms vinna taruvata thaman gari pai respect perigindi
jinugu vihas	Super thMan anna
Akash R	Thaman ❤️
Janardhan sayiri	Thaman bro super ❤️
Nalluri Venkat	7 48👌🏼👌🏼 Jeji mata
Pavan Yalamarthi	TØRCH BEARER
Satyanarayana Kondeti	👌👌 anna awesome undi
zakeer hussain	32 23 it Feeling High Love From Palnadu People 🙏
Vinnu Garad	Nenu song vinanu bgm s vinta Prathiii movie ela special ga bgm release chesthe bavuntadi
akash reddy	Ntr fan only like
Parushram Goud	ReddammathalliFanshitlike
Deepu u	Thaman Anna super
Dear Youtube	Peace meeting bgm supr
Anwar Pasha Sheik	Thaman 👌 always extraordinary he is not coppy song only king of bgm s in tollywood 😍😍😍😍😍
bejawada nagesh	extardinary music jai NTR
GADDAM SATWIK ee14b025	Reddamma Thalli Film Version 32 33
venkat sai	Need mp3 link
Batti Ganesh	IT S FENTASTIC BGM ASVR NTR
surya sai Chinnu	7 23 👏👏👏
Zaheer zaheeR	15 20🙏🙏
Saikrishna Simhadri	💎💎💎
John Satwik	Reddama Tali female version nice
Lohith Nagalla	Supper
hari jaladi	Reddy Nagar thallus singer name please
Rajasekhar Goud kuruba	What a background music abbaaa
Rishi Varma	Plz sir singel ga vodhalandi female reddamma song meru em antaru guy
All In One Channel	http www youtube com watch v MqYEsE0mpCg
SIVA SHANKAR REDDY	తమన్ గారు నేను మీకు పిధా అయిపోయా ఈ మూవీ నుంచి
Dasari Madhu	Fluet Music Excellent Gaa Undi
chethan.r.e chethan	Erra padda thadika 2 goosebump
Vamsi Srivathsava	Who is going to stick to this video
Hari Nath	Super bgms
Madhu kalyan	Tq soooooooomuch
SHIVA SHANKARA	BGM gurinchi cheppalante matalu vethakalsi vastundhi Matalu ravatledhu entha baagundhi ante matallo cheppalemu
B THIMMAPPA	Super
koti kranthi99	Super massive music
MANO CHILLS	PENIVITI FLUTE version edi bhayya 🙄
Chandram Madhumanchi	outstanding bgm
unnam venkatesh	Walk into peace bgm highlight tamman bhayya superb
Narasimha Rao Chennuru	BGM lo nee tarwathe ewaraina
sivakumar పేడ్డ	Goosebumps bgm thaman super
krishna vamsi	thaman bro ishtam leni marpu theme tho ilayaraja gari standard ni touch chesaav bro hatsoff lifelong gurthundipoye theme adhii
Narashimha Chowdary	Superb
veera bhaskar	31 20 best bgm ever
SANTHOSH DAGGI VLOGS	Super
Bala Chandran	Wow kekaaa
veeresh yadav	Adigo bal reddy yelthunaduu vadeee TORCHBARRIER
Punnapureddi Santhosh	Thaman Bgm Super Ma Annaki Tiruguleni Manchi Music Itchav Neeku Thanks Anna Jai Ntr
Sajid Sk	Super And mind blowing bgm 😎😎
Sharath Reddy	14 50 kantapaddava 😎👌👌👌👌👌 25 49 Torch bearer 👌👌👌
karipotu lijo	Kiraak
harsha vardhan	This is not music this is magic
lankotu nagapadmarao	Ultra bgms ♥️♥️♥️♥️
Jamalaiah Kukka	superr 😘😘😘😘
DILL DULL	Great BGM maker after RAVI BASRUR
Vijay kumar B Vijay kumar B	👍👌👌👌👌👌👌👍👍👌👌👌👌👌
SAI GOUD KURIMINDLA	Thaman beark they sound Who say copycat
Srikanth daravath srikanth	Super bgm thaman love u ee movie bgm ki nenu fan iphoyanu
varadi Durgaprasad	4 30😘😘😘😘
Jr lava Kumar	Super
RAKESH GONA	Anirudh Aite Chedagottevadu Sure Ga Taman Bro Superb
Nikhil egn	Stunning and classic one from s ntr and trivikram
ravi theja	Guys trailer lo flute bgm vosthundhi adhi ye theme lo undhani chepandi i haven t watched movie yet but i liked that bgm thank u
king 123	Bgm s anni vinnaka inkosari repeat veyali anipistundi movie How many of you feel so hit like pspkfan
Lucky Mahesh	15 26 asaLina bgm
Vijay Kumar	2018 best music director award Thaman
Revanth Chilukuri	24 30 peace meeting bgm suppurrbbbb no word for that
avish kotha	Hats off bhayya thaman addicted to your bgms❤️❤️❤️
Srinivas Parvathini	Tarak super acting jai ntr tank taman
Srinu Srinu	superb jai ntr jai thaman
ramamohan koyyana	Super
villan villan 143	32 40 sec e okka song kocham 10 sarallu chusanu aa song movie ke high let
Shaik Aadam	Super
ESWAR CHOWDARY	చాలా బాగా BGM ఇచ్చావ్ అన్న ఈ సినిమాలో సూపర్ సూపర్ blockbuster
Prudhvi Raj	24 00 music super
Naveen B	Superb
Kranthi	👌👌👌👌👌
bharath kumar	Evitiki kuda dislike ha chi chi sorry u guy don t no this back ground music no thats why u dislike movie is superb Ntr is back wish from mahesh babu fan
Narendra Royal	4th dhi highlight
Kishore Kumar	Jio music lo e bgms vastay baggunu na callertune marchey time vachindi 😍😍😍😍
Subhan singh bondili	Sound sinigipoindi tammudu
ramua9169 9160401059Ramu	Osm
Satish Shaganti	Jai ntr
ASHOK KUMAR VIZAG	1st time choosthunna BGM Ki intha appreciation vasthuunte especially thaman superb anthe
Parthasarathy Trivikraman	28 10 basi reddy fan hit like
Sana S	Ila anni movie ki release chesthe baagunnu BGM era is this 🤘🏻🤘🏻🤘🏻
Raju Royal	🔥🔥🔥🔥🔥🔥🔥🔥🔥🔥🔥🔥🔥🔥🔥🔥🔥🔥🔥🔥🔥🔥🔥🔥🔥🔥🔥🔥🔥🔥🔥🔥🔥🔥🔥🔥🔥🔥🔥🔥🔥🔥🔥🔥🔥🔥🔥🔥🔥🔥🔥🔥🔥🔥🔥🔥🔥🔥🔥🔥🔥🔥🔥🔥🔥🔥🔥🔥🔥🔥🔥🔥🔥🔥🔥🔥🔥🔥🔥🔥🔥🔥🔥🔥🔥🔥🔥🔥🔥🔥🔥🔥🔥🔥🔥🔥🔥🔥🔥🔥🔥🔥🔥🔥🔥🔥🔥🔥🔥🔥🔥🔥🔥🔥🔥🔥 Any doubt 💪💪
rajeev atluri	6 19 flute version of peniviti best work of thaman till date
shyamsundhar muga	Hatsoff Thaman Anna
xpert SAI RAM	32 32skip for REDDAMA song
Sathish Siddu	20 10 awesome bgm
Bala Mahesh	I am waiting for long time to this one yet now I am happy for giving This is 1st time BGM of full movie osm
sk creations	Osm
venkatesh kolati	One of the Best bgm Istam leni maarpu awesome
Santosh Katta	Recent ga e range lo bgm vinaledu aladinchav thaman anna
raju m	Kantapaddava n peddamma simply awesome
afroz zabeen	Bgm kickass 😘😘😘
MANOJ KUMAR	Wow super Jai NTR
SRI RAM	Superrr
Suresh Suri	Superrrrrrrr
MAHENDRA GURIGINJAKUNTA	Superrrr
Ravilla Gunasekhar	26 00
sridhar bandlamudi	Thaman bhayya bgm lo ninnu beat chese valle leru Awesome background music 👍
Sandeep Goud	Super bgm love SST
kp donepudi	BGM super Next level thaman super abba
Vali Shaik	Tamil lo katti bgm Telugu lo aravinda sametha bgm Emi kottav Anna taman Anna Love u
Dendeti Kalyan	That is s thaman
Sk Yakubpasha	27 6 my Favourite Bgm Trach Barar👌👌👌👌👌👌👌👌👌👌👌👌👌👌👌👌💛💛💛💛💜💜💜💞💞💞💞💞💞
Somuashekar Nadichagi	👌👌👌✊✊
Kodirla Kv	thaman bgm backgroud music amajing super
kanni lie	Uriki utharana dhaariki dakshinana neee peniviti kaalinadamma all time hit song supperb song fanatstic thaman wa great
Vaddadi Santhosh Kumar	Awesome taman
saddam ni	Super super super super super annaya
Srinivas M	Reddammathalli singer evaru
Rakesh vanacharla	👌👌👌👌
Durga Prasad Nunna	Sir please give for downloading
chaitu smily	2hr 30min lo 34 min hero meere taman garu
chava suresh	BGM ante Thaman Thaman ante bgm
ashok kumar	thaman bayya🙏 no word
Telugu Prajalu	First time bgm jukebox pettadam Well good thinking
Ravi Kumara	Super block buster
yaswanth kumar	Thaman 😍😍😘😘
Ramanji Bannoth	Superrrrrrrrrrrrrrrrrrrrrrrrrrrrrrrrrrbgm rockkkkkk
Taddanpally Chinna	Jai NTR
Entirenenment Guru	Superb
Suryareddy Kilimi	thanks thaman Garu jai ntr
Karthik S	JAI NTR ✊✊✊
epicerie bakers and grocers	Tnx for uploading
Nagaraju deshamoni	Super
Aravind Pogu	Nicd bgmss
Murali Krishna	TorchBearer 🤫
prasanth B Tech	Kantapaddava 👌👌👌👌👌👌👌👌👌👌👌👌👌👌👌👌👌👌🏽👌👌👌👌👌👌🏿👌👌🏿👌🏿👌🏿👌🏾👌🏿👌🏿👌🏿👌🏿👌🏿👌👌👌👌👌👌👌👌👌👌👌👌👌👌👌👌👌👌👌👌🏽👌👌👌👌👌👌👌👌👌👌👌👌👌👌👌👌👌👌👌👌👌👌👌👌
only chai	thadika leru 2 pomorodo kantapadava torch bearer redamma thallus best in album dont miss
sashi kalyan	9 05 👏👏👏👏👏👌👌👌👌
Ramesh Ram	Super
Chandu Chandu	Superb Jai ntr
manoj rajupeta	Loved it
Sai Srinu	Thaman is best at BGM
Đâñģėř Mąň	Intro is awesome ever
PaladinHelm	Praanam posesadu Thaman movie kosam 😭❤️👌 Major highlight 7 25 11 26 22 08 ❤️❤️👌👌 Im a MB fan but honest ga tega nachesindi movie because Im a Tollywood lover ❤️ Congrats from MB fan
Siva Mani	Woww
G Venkatesh Goud	Taman kante dsp baga tune echevadu
pambha Regudhi	👌👌👌👌👌👌👌👌jai ntr
sai krishna	Awesome bgm jai ntr
balu abcdefg	Home coming bgm awesome 👌😘
Kiran Kumar. R	Super 🙏🙏🙏🙏thaman anna🙏🙏🙏
Ramesh ramesh	nice exclent
Urstruly Rahul	Kirrck Bgms superrrrrr
bangaruraju pinninti	Excellent thaman
annamaiah yellapagowni	It is music or magic
BHANU PRAKASH	Mind blowing
Manoj Myneni	Successfully completed 4th time today for asvr movie ❤❤😘😘😘😘😘😘😘😘😘😘bgm backbone movie ki thaman bro 🙏🙏 jai NTR 😘😘😘😘
Raja sekahr	Supar
Sunil Kumar	super music back ground
Teja P	Thank you thank you thank you very much sss Taman
AURA 2k18	Bro I need peniviti song bgm
Mani Chinthapalli	Keka bgm
Sri Media Ltd	Aaaaaaa a cry 9 26
naga babu	Thaman carrier lo best bgm music
Muni Kandati	Kantapaddava
MN Kranthi	Emotional BGM s super Jai ntr 💪💪💪 Jai Jai ntr 💪💪💪
AD W.E.I	15 16 19 32 17 30
Surya always	హార్ట్ బీట్ ని బీభత్సం చేశావ్ థమన్ సర్❣️❣️❣️
vijaykumar m Vijay	wowwwwww
ANIL BONU	Awasom Jai ntr jai ntr ✌️✌️✌️✌️
Venkatesh B	Output super
Chimmili Harish Chowdary	Appudu Brundavanam Eppudu ASVR supar
Telugu facts factory Telugu facts factory	Super
Shaik khasim saheb	Pranam petti Taman cheyaledu Taman techukunaa rent person kamalakar garu chesaru ee tune Ani
Maruthi Prasad	Reddamma song singer name
M. N CREATIONS	Awesome Music
Kamal syed	3 54 and 15 17👌👌👌👌👌👌👌👌👌👌👌👌👌👌👌
Zubaer shaik	Kantapaddava best ever bgm👌
Anish Anumasa	Pomodoro
Narasimhulu Kasetti	Ntr fan like vesukondi
Sai Siddhartha	fantastic bgm by thaman 😘😘
gopi thirumalashetty	Rocking THAMAN
Yuganadh Namburi	jai thaman
devendra chowdary	Best interval bang kantapaddava reddama thallus
NELLURI GIRIDHAR	💕👌👌🙏
reddy bargav	32 35 reddemma
sai uttej	👌👌👌👌👌
jaya prakash	No word thaman bhayya Just goosebump
srikanth rasula	Bgm ka baap
VENKATESH KOTIPALLI	E bgm vintuvuntey vollu pulkaristhundhe hat of thaman
S K	27 56 Ishtam Leni maarpu👌👌👍
Ajay Gajangi	Wow nice music😄😄
shaik sohail	Copy copy annaru kadhara Copy kottevaaditha a dhairyam tho bgms release chestaaru thaman always give a fresh but u troller troll him for Ur satisfaction
sriram bhagavan	Kiraak bgm thaman
Venkata Satish	Pomodoro😘😘😘
NaVeen Ash Ley	Came only for Reddamma song Hit like 👍
Uday Vikram	Jai Young Tiger 💞✊💞
Sathambeti Rosshayaa	Ntr andhari hero tho bagunna andhariki premapanchuthunna Inka dislike aa
darling madhu	రం రుధిరం రం సమరం 🦁🦁🦁🦁🦁🦁🦁👌👌👌👌✊✊✊✊ jai ÑŤŘ jai Balayya ✊✊✊✊✊🔪🔪🔪🔪🔪🔪🔪🦁🦁🦁🦁👏👏👏
SONY MOBILES	DSP BEST
k bheems	Excellent bgm music
Devsingh Daravath	Super
Surendrakumar lanka	Jai thaman Anna
Vj	Thx for upload
Murali Krishana	jai ntr
shaik jakeer hussain	ssthaman Anna fan like here ❤
Nirmala N	😘😍😘😍😘😍😘😍😘😍😘😍😘😍😘😍😘😍😘😍😘😍😘😍😘😍😘😍😘😍😘😍😘😍😘😘😘😘😍😘😘😘😍😍😍😘😘😘
Jithu Anu	👌👌👌👌👌👌👌👌👌👌👌 No word
Balam murali Krishna	Ok don t waste the time 32 30 is reddamma thallus
Steven rock zz	all music s are rockz jai ntr
karun kumar	wonderfull bgms thaman exceeelled keep it up thaman we are all with u
Lokesh Valluru	Thanks to thaman for giving this amazing music 👌👌
chandra DEVU	Super thaman bhayya
Srikanth Vutti	Peace meeting bgm 👌👌👌👌👌 how many of u like this
Tarun kumar RAM	Jeji matha bgm👌👌👌👌👌
lucky boy murali	15 29👍👌👌😊
Rafi S	Txs thaman for giving osam music for ASVR movie jai ntr jai jai ntr
Nagaraj Meti	Really awesome bgm ’ s
Løçäl Bøy Mäñî	Maa Dhevudu🙏🙏🙏 Jai NTR✊✊
Chaitu Pappala	😍😍😍😘😘😘
AKB Media	0 34 My Favorite OST ❤️❤️
RAM Hemanth Kumar	Mind blowing bgm superb I love you taman
pavan prataap	correct hero padithe gani content bytaki radha thaman bhayya jai jai NTR im fan of power star
Jathavath Lokesh	Superrrrr 👌👌👌👌👌👌👌👌 Tnx Thaman adirindi bgm
Venu Chilukuri	Super
Harsha Ninnvi	Home coming bgm outstanding
NARESH KUNAPAMU	Super bgm
Red Marble presents	Mind lo ekkesindi bayya
Gundu Anil	BGM lo ninnu minchina vallu learu swami 🙏🙏🙏🙏 SS thaman garu congratulation sir
Kiran Rockzz	Home coming repeat mode😍✌️🎶🎵🎧
Dileep dil	Osm music Taman keep it up
Devender Madupoju	Kantapaddava erra1 ultimate bgms excellent thaman JAI NTR ✊✊✊
CM CREATIONS	Super Bgm
guna vardhan	Reddamma thalli😘😘😘
g Bharath	Fantastic bgms
jai kumar	jai NTR 😍😍😍💪💪
Yakub Pasha	Before still and ever Thaman bgm superb
sai sundeep	Awesome loved music to core
C Saravana	I love this
Ntr fans Club	Supeb jai nyr
rajakumar gk	ಸೂಪರ್ ಜೈ ಎನ್ ಟಿ ಆರ್
Mohan mangam	Bgm super Dolby atom tho evachuga
Karthik Ragani	Excellent
Vinod P	The bestt bgms in Telugu film industry
Madhav Madhavlenka	Super bgm thaman sir
Balu B	Peace meeting katapaddava 🤘🤘🤘🙏🙏🙏🤙🤙🤙🤙
Bandi Kishore	Thaman best bgm in telugu movie
shiva shivu	Super bgms
Jagadesh Vatambedu	Highlight bgm keep it up thaman ntr fan here
Naresh Lucky	Awesome bgm thaman the best ichavu thanks sst
NITISH KUMAR	Super Anna Thaman
harsha chowdary maddipudi	make these avaialble in jio tune please
Praveenkoppisetti Praveenkoppisetti	సూపర్ బి జి ఎం👌👌👌👌👌
Hari Harikumar HR	Superb
ajay kumar	Bgm king thaman
Marri Vamsi krishna	👌👌👌🎶🎶🎼💜💜💜✊✊✊🐆🐆
Chakali Ramu	Superrrr
Rahul Kitti	best ever bgm thaman anna jai NTR
Achal Kumar	One of the Best album in thaman anna carrier lo
Bhukya Nani	super
ashok rayapati	Home Coming 00 00 Erra Padda Thadika Leru Part 1 01 14 Erra Padda Thadika Leru Part 2 03 14 Jeji Maata – 05 21 Balamainavaadu Pakkana Unte – 08 33 Pomodoro – 09 48 Mondi Katthi – 12 19 Kantapaddava – 14 50 Bathikochina Basi Reddy – 20 03 Chavuganna Gonthu Vunte – 21 27 Peace Meeting – 23 56 Torch Bearer – 25 49 Ishtam Leni Maarpu – 27 56 Walk into peace – 31 00 Reddamma Thalli Film Version 32 05
rajesh rajesh k	💥🔥🔥🔥🔥🔥🔥🔥💪💃
Likith Sai	Peace meet bgm
Krishnamraju Krishna	Really excellent bgm
B.UMESH NAIK	BGM lo ni taruvathe evaraina supperrrrr bayyaaa
Mahesh The Rock	😍😍😍🔊🔊🎵🎧
top 10's to know .	32 35 reddamma song
hanumanthu chowdary	Exlent BGM taman jai ntrrrrr
Guriji princee	06 54 is the best ever BGM IN MOVIE like if u Agree
Venkateswarlu Pinni	Awesome back ground score
haritha reddy	Superrrrr BGM
Anvesh kumar	Thaman Anna 🙏🏻 🙏🏻🙏🏻 big salute n huge respect Bgm ni marchipolem haunting music
Vishnu Duddukuri	Kantapaddava 💥💥 Torch bearer 💪💪 king of bgms Thaman
Giridhara Sai Pavan Kumar Gurram	14 50 5 30 26 00
Papana Sumathi	IT S SO INTENSE ND DARK BGMS
shukoor mahmmad	Ji ntr sst music superb
meeravath sri harsha	home coming bgm goosebump D D
Repakula Kedhar Nath	Thanks thaman
sandeep jacob	JEJI MAATA peak
TIMEPASS RAJAA	come on keep it up taman gaaru
Yakama Harsha Vardhan	BGM Is Awesome 🔥🔥🔥👌👌👌
nanda kumar	N t r fan 1like plz
kc babu	Salaa baagundadi Anna bgm goosebump anthey
Tech Frenzy	15 01 Gave me goosebump lovely BGM
venkatesh puppala	Hatts off thaman garu I love ntr
Uday Raje	Great BGM I love it 👌❤️
Tejkiran Reddy	Intro wa awesome
ganne seshu	Torch bearer💪💪💪💪💪💪💪💪
Venkatesh Babu	Please upload individual bgm s waiting here
pothina anand	SSThaman you rocked No word brother hope you will speak with your music only in future
NTR Rak S	Jai NTR jai jai NTR 💪🙏💪💪🙏🙏🙏💖💖
JR NTR ENTERTAINMENTS	Anna fan hit like
pavan kalyan alla	Mind blowing
SAI ANURAG CH	Super
raghu gs	What a music Super undi
Srinu Bidika	Dsp music aithe inka keka putenchedhi
Impressive 757	Thanks
Mohan Bathula	Torch Bearer
HARISH SAJJANAR	Super
Divya Vani Poloju	👌👌👌👌👌👌👌👌👌👌👌👌👌👌👌👌👌👌👌👌👌👌👌👌👌👌👌👌👌👌BGM this is just to say JAI NTR
abee viru	19 34
Filmy Doper	Home Coming 00 00 Erra Padda Thadika Leru Part 1 01 14 Erra Padda Thadika Leru Part 2 03 14 my favorite Jeji Maata – 05 21 Balamainavaadu Pakkana Unte – 08 33 Pomodoro – 09 48 Mondi Katthi – 12 19 Kantapaddava – 14 50 Bathikochina Basi Reddy – 20 03 Chavuganna Gonthu Vunte – 21 27 Peace Meeting – 23 56 Torch Bearer – 25 49 Ishtam Leni Maarpu – 27 56 Walk into peace – 31 00 Reddamma Thalli Film Version 32 30
CHARAN S	Hw to set caller tune is thr any code link
WhatsApp Status Adda	Thamman anna 🤘🏻🤘🏻
srinivas goud	jai ntr Home Coming 00 00 Erra Padda Thadika Leru Part 1 01 14 Erra Padda Thadika Leru Part 2 03 14 Jeji Maata – 05 21 Balamainavaadu Pakkana Unte – 08 33 Pomodoro – 09 48 Mondi Katthi – 12 19 Kantapaddava – 14 50 Bathikochina Basi Reddy – 20 03 Chavuganna Gonthu Vunte – 21 27 Peace Meeting – 23 56 Torch Bearer – 25 49 Ishtam Leni Maarpu – 27 56 Walk into peace – 31 00 Reddamma Thalli Film Version 32 05
viswanadh vallabhajosyula	0 35 ntr entry
Kolakaluri Yesubabu	Super
Sanjuu	6 10 thaman melted 🤗🤗
Saikumar Nandipati	Super exlent
Surendra Guduru	Jeji maata music
indrakumar kovi	Super bgms jai ntr Anna
Suresh Chandra Suresh	Gym trainer for NTR for RRR movie is Lloyd for ASVR also
SAITEJA TIRUVEEDHULA	Home Coming 00 00 Erra Padda Thadika Leru Part 1 01 14 Erra Padda Thadika Leru Part 2 03 14 Jeji Maata – 05 21 Balamainavaadu Pakkana Unte – 08 33 Pomodoro – 09 48 Mondi Katthi – 12 19 Kantapaddava – 14 50 Bathikochina Basi Reddy – 20 03 Chavuganna Gonthu Vunte – 21 27 Peace Meeting – 23 56 Torch Bearer – 25 49 Ishtam Leni Maarpu – 27 56 Walk into peace – 31 00 Reddamma Thalli Film Version 32 05
HELLO MAMA	Bgms ka baap 🤘
Murthy Nandu	Goosebumps
Siva Dasthagiri	Lovely music
LOKESH E	Thaman music lo song baagundav but BGM matram irragadeestaadu 👌 bgm
Ramesh Rammi	Niec 👌👌👌👌👌💟👌
simha kumar	Thaman s best bgm in his career till now
Nikhil Nick	Home coming bgm keka asala
Manu Unhappy Soul	Music is Heart of This film
revanth reddy	inka serial vallu chelaregipotharu
prudhvi Keerthi	KANTAPADDAVA is 🔥🔥👌🏻👌🏻GooseBumps 🔥🔥
VINAYKUMAR SANGALA	Thank u so much
Mohammad Imdad	Thaman Bhayya 👌👌👌😍 Nee Songs Emo Gani BGM s Matram 🔥🔥 O Level Lo Untai
ssk sds	Excellent no more word
ramesh pilla	Guruje 👏👏
sai prasad	Kantapaddava super on headset
Anil Ck	Thaman u nailed it
Bezawada siddik	11 28 super BGM ♡
Posina Vasu	👌👌👌👌👌👌👌👌👌👌👌👌👌👌👌👌👌👌👌👌👌👌👌👌👌👌👌👌👌👌👌👌👌👌👌👌👌👌👌👌
Avinash Pandiri	7 47
Yellesh Janapati	All bgms r super jai Ntr s thaman music wonderrrr
suri entertainment	http youtu be M4eFc97f3zw Highlight fight sean aravinda sametha ntr fan like here 👌👍👍
Nani Online	Telugu serial be like eka vaadeydham rum rudhiram 😂
Rushendra babu thammannagari	Superb
Rahul Kumar	15 16 goosebump
Viraj Vijay	asl BGM baa baap correct time lo vadilav anna Thaman anna thanks Best BGM
bandi giri	E cinema ayina bagunte akkadike super anipisthundhi Kani ee cinema chusina tarvatha intiki vachina kani 2 3rojua ayina kani mali chudali anela anipistundhi
pavan dhanush	Super bgm
kumar5761	With this movie you re fabulous at BGM in all type of scene especially KANTAPADDAVA is next level of tollywood Hats off to SST
Jai NTR	Thaman Sava Gottav bayya
shaik salman	🔥
Krishna Prasad	Thaman is the king of background music Hit like if you agree
sirigisetti satyanarayana	Ultimate background music for u ntr Anna
Ayyappa Alia	3 54 🔥🔥🔥🔥🔥
Indian gaming gamer	Torch bearer and kanatapadava are my favourite
Patteparapu Venkata Krishna	Thaman great music director
Bal Raj	Pomodoro cool and breezy lovely bgm 😍😍😍😍😍
Gubbala Satya	Super music
ÑävèéŃ KümáŘ ŤhïkkĄ I Love Movies	🌚BGM 🌚 adhurs
Sandeep Abhisheak	8 33
Nirmal Nallu	06 09
well wisher groups Amalapuram	Best BGM Thaman Anna
Dhanamjaya Reddy	Waiting for RRR JAI NTR
Kuppili Patnaik	7 45 to 8 33 title bgm that wa awesome 😘😘👍👍
Chaparala Neeraj	Jai ntrrrr
Vicky un lucky	14 50 the part we all want
Manu Manu	Reddemma thallus song is awesome 😘😘😘😘😘😘
ram raj	3 54 to 4 46 kirrak love u jagapathi babu aa Sean kosam 10 time chusa movie hatsoff thrivikram Garu 🙏🙏🙏🙏🙏
Madhu Mourya	Jai YounG Tiger NTR
RMB TARAK9999	Thaman Anna ❤️❤️❤️💪💪💪
swaroop tarak	Super tank you zee company
Sreedhar Nani	Osm bro
Charan Gv	Dabba
Palisetti Lakshman	Ntr fan ikkada color eggareskoni tirugutunaa
siva ram	thanks bos much awaiting for these
Anime Shadow	After a long gap taman copy kottakunda icchina music 👌👌
suresh sandeni	Super sst
Vasu Chinta	Super
Rabbani Syed	Reddamma thalli😍😍😍👌👌👌💪💪💪Thaman Anna champesav bgm asalu💪💪
Nandhakumar Radhakrishnan	Superb 👌 egarly waiting for this Jai NTR
Chandrashekar Kodadala	Bgm wa ultimate
Venkatesh tech Telugu	Tollwood best music
uday Cena	06 09
Gooty Vasu Deva Reddy	👌👌👌👌
Gandepalli Venkatesh	Bgm God Of Bgm after Mani Sharma garu
Shivraj Yadav	Was waiting for this 🔥🔥🔥 Best BGM in recent time Thaman u beauty 👏🙌 NTR u rocked dude Unanymous
Hussain Basha	Jai ntr awesome bgms 👉👌👌👌👌👌
vikas gouda	Just hear every bgm with earphone ur gon na feel every inch of the scene What a work by thaman bhai Jai ntr
kilari sumas	Awesome tqq thaman garu it not a music it feel of heart
Naga Naveen kalyan	Super wow amazing bgms 😊😀😃😍
Dvj venky Dadi	Reddy Amma thallus 👉👌♥️
SST NTR	Bro Bgrd music composing me tharuvathey yevadu ena Asm music 🔊🔊🔊🔊📯📯📯🥁🥁🥁🥁🎺🎺🎺💪💪💪💪💪👏👏👏👏🤝🤝🤝🤝 😱😱😱👌👌👌👌🙏🙏🙏
avula venkatesh	3 50👌👌👌👌
Hemanth Prasad PETA 2	😍😍😍😍😍😍😍
B.srinivasulu Nandyala	Thank you very much zee music I love bgm
manikanta surampudi	Excellent thaman hatsup mind blowing bgms
Sai Praneeth	10 20
karthik REDDY	8 10
Rasool Power.	32 34 Reddama thallus
vineeth myneedi	Torchbearer BGM🤩
Stylish Kiran	Kekkka Block buster movie Reddam Thalii song Peniviti song 🙏🙏🙏🙏
chetan rockss	26 13 my favourite one
Uday Uday	Great background music
manju n	One of the best BGM of the decade
p. baba	Idi success ante prati moment celebration chala kastapadaru e cenimaki memu marchipomu thaman sir enjoy lotttttttttt inka filims chelani kurukuntu NTR fan jai ntrrr ntr
Suresh Sharma	8 10🙏🙏🙏
venky ch	Hit like peace meeting bgm is greater than all bgm
ELISHA BABU	jai NTR Anna
Bharath Padharthi	Ntr fan like here
Maverick	I ve been waiting for this Terrific BGM
Pavan Ponnekanti	Black baster super hit bgm
Vali Vali	Reddamma thallus awesome
Vamshi Uday	Kantapaddava and torch bearer wa superb Thaman also superb
Arvind creations	Super
sai ram	14 50 kantapaddava 🤗
Rakesh Nyamathabad	32 35 reddemma thallus Original female version 👌👌
Venkat Narayana	Bgm vintunte goosebump asala Jai ntr
Dattu Sai	32 35 Reddy Ammathalli
kumar srujan	Many People are waiting for Reddamma Thalli Official Audio Song Why won t U Guys Upload it seperately
sheshendra kandregula	Mohana bhogaraju 👃what a voice
Mahendra Raju	Supper hit bgm
Raju Pedada	Super Fantastic
Tolly films and update	Thamans best work SST DSP mutual any one like me
Mahender mahi	How many of you like Ram Samaram BGM
Sai Satwik	Torch bearer at 25 50 is nyc
GENUINE UPDATES YouTube channel	New trend
Hari Ram	Abba Abba Taman anna 🙏🙏🙏
Srinu Palingi	Excellent bgm
Balu G	Torch bearer my fav 👌👌👌 all BGMS r awesome
Abbu Powerr	Interval bgm like yeskondi Jai NTR
madhav Nampally	Thaman music nachina vallu like kottandi nachani vallu comment cheyandhi
Red Mirchi	మచ్చల పులి గాండ్రింపు చూసే వాడి వళ్ళు జలదరింపు
muralikrishna chowdary	Jai ntr jai thaman
S5 Vlog	Thanks for uploading
Raju Kadali	19 34 osam ram rudhiram 👌👌👌
BHASKAR AKKARABOTHU	25 50 TORCH BEARER
G Akshay	Jr NTR fan like here jai NTR jai jai NTR
Venkatramana Nandipagu	Super
sayed ammu	9 20 incredible voice over
Yadav Arunkumar	15 20 bgm next level ram rudhiram
soma sekhar	3 54 goosebumps👌👌👌
Kamal Pathi	No more word thaman s real work please continue like this for all up coming project congratulation to all team jai ntr jai Hari Krishna
Srinivas kgt Bhukya	Sirnivasa bhukya
naresh young	NTR cult oka like veskondi
Ramesh ntr	Wow what a bgm thaman bayya
Paandurangarao Vittamsetty	Background Bramha Thaman Super music😘😘😘😘😘
Upendar Reddy Musuku	Jai NTR Superb 😍😍😍👌👌👌
Suneel Sunny	Thaman🙏🙏🙏🙏🙏🙏🙏🙏🙏🙏🙏🙏🙏🙏🙏🙏🙏
lahari Atmakuri	Superb😍😘
Nemba Ajay kumar	Reddamma thallus song 🔥🔥🔥
teja k	Istam Leni marpu bgm nice
rahul chowdary	Music vintunte cinema kalla mundu chusi nattundi
Harsha369Madiri	Super BGM Annayya Best music 😍😍😍😘😘😘🤩🤩🤩
Tracers Comedy	Listen in headset Bhayam esthaandhi raa aa bgms vintunte etta kottaav anna 🙏🙏🙏🙏🙏🙏💓💓💓💓
Rajesh Karna	Super Thaman garu
Pradeep Sai	Torch bearer bgm 🙏🙏🙏
pratap kumar	Jai ntr
kosanam nagendra kumar	Fantastic
Tàñjil KHÀÑ	Waiting ikkkada for BGM
chitturi santhu	Super
Anjani kumar	Standing Ovation to Thamman Bhayya 👏👏👏
Velaga Naveen Chowdary	Ntr fan like her 👌👌
Rajesh Chetukuri	Wat a bgm incredible sound Kodithe pagilipovaali annatlu undi Sound bayamkaramga undi
Praveen Kumar	Thaman bro👌👌👌
Jana Jana	Up load video song pls
Naresh youngSter	Ishtam leni maarpu music 👌👌👌 what u say this song
Nammi Krishna	Super
Pilla Shyamprameed	Aarachakam asalu
Aadi	🔥🔥🔥
Sanjeev kumar Kolli	Wow superb
Harish NaiDu	😍🔥💥✌️🙏👌👌
SAI CHAITHANYA	Super thaman anna thanks for the wonderful output
nagendra babu nagendra tarak	I like bgm who like SS taman please like hear
venkatesh lankhaiahgari	What a emotional taman bayya thanku
Surendranath chow	Next level asala🔥🔥🙏🙏
Naga raju	Thaman Tollywood Top Music Director specially in BGM This is already proved in Kick Sarrainodu Aravindha sametha Veera Raghava And lot more
Cm Bro's	7 10 waited for this one💖
Vani K	😍😍😍😍
sainath suppala	6 50💥💥
Anush kotanala	Bgm extraordinary 😍😍😍😍 But movie average 👎👎👎👎👎
Kalingiri Sridhar	Iam so excited n early waiting for bgm of this movie N finally it s came out thanks for zee music 🎶
Sujith TARAk	J A I N T R
Nani Ntr	Ne penimiti kalinadu Anna🙏🙏🙏
theertha rameshwara	Uriki uttarana super song
somu pujari	Jai NTR
Jai Ravan	Wow
satish varma	SSTHAMAN JINDABAD
happy happy	Anna thaman anna bgm 👌👌👌 Love u anna 💋💋 Jai NTR 😍😎
Madhu kummari	Awsome 😍 goseboms
prudhvi yadav	Thanks thaman annaa adigina ventane BGMs icchinanduku 😘😘🙏🙏👍
Nammi Purna Chandra rao	26 11 goo bump bgmm
P. V Narayanaswamy P. V Narayanaswamy	Super thaman ann bgm pagilipoyindhiiiiii super
Vemuri Srikanth Sri	thaman anna nvu keka yee
Venkat Shoury	Thaman Anna nee career best jukebox
Shaik Karimulla	jai NTR
mahesh g	first dhi HOME COMING dhi Ultimate 😍
surya dama	BGM King Only Thaman 🙏 Goosbumps
kumar swamy	సూపర్
Sai Ganesh	Extraordinary bgm👌👌👌👌luv u thaman😍😍😍
Aswin Kumar	Jst wow❤❤
Sekhar Medisetti	Jai ntr jai S S T
Madhu Udayagiri	Thanks thaman Annaya 😍😍
guda karthik reddy	Jeji mata
Vinay Kumar	Devi sri aithe inkaaa bagundedhi any way block buster movie jai ntr jai PAWAN KALYAN ✊✊✊
Bunny Smile	Abba em icchav thaman anna Abba bgms kosame puttinattunnav Patalu oka etthaite bgm inko ethu All the best bro
Parevell Appa	Nice nice Jai ntr
LOKESH P S ntr	JaiNTR 😎
Nadapanna Vannuru swmy	Totol bgm super thaman anna😚😙😚😙😚😙😚😙😚😙😚
sunil kumar	Kantapaddava BGM 💕❤️💕🎼🎶 kekaaa
V Sesha sai Tata	🔥🔥🔥
Sivaji Garikina	జై ఎన్టీఆర్ జై కాకినాడ ఎన్టీఆర్ ఫాన్స్
BSBBM CREATIONS	http youtu be XCy3jiMuagM
Prasad Kandregula	excellent
Karthik Yadav	What bgm jai NTR
Indian ad world	32 34👌👌👌👌👌👌👌👌👌👌👌👌👌👌👌👌👌👌👌
Veerashekar Talari	Super sir
Pranav Gutta	32 33 REDDAMMA THALLI
Gummadi Madhubabu	Superb
Ashwin Ashwani kumar Ananthoju	JEJI MAATA 👌👌top among all
Surendra Mailary	Iraggottaw Taman bro
Omer Ali	I can see musician sorry magician thamman
Ramesh Dasari	Thope🔥🔥🔥bgm👌👌😁
Velagapudi Venkatesh	Super Idea Asalu BGM Juke box Vadalatam Tollywood industry Lo frist Time Jai Ntr Anna
Laxman lucky LR	how many of you like tamam music especially this movie
Mahesh Glory	Superb background score chinchesaru😍
Jagadish Jaggi	super
saiganesh taduri	0 31 goosebump
Vijay yadav	Chala movie bgm ela pidite bagutudi
Kasi Yaramati9999	Thaman Anna Background music lo Thopu 🔥🔥🔥🔥 thank Anna
Balaji Kalva	19 30 asalu ala kottav ra babu
C Nagarjuna	Thanks
Love U	Super
Obili Srujan	Minde blowing 🙏🙏🙏🙏🙏🙏🙏👍👍👍
Sri Maan	Home coming🏁
G.b.s. Bharadwaz	How many like Thaman bgm 🎶 🎶 🎶 👌👌😍😍😍😍😍😍😍
srinivas sharma	JEJI MAATA Heart Touching
gotika pawanreddy	thanks thaman sir superb music ila ya Raja music
betapuram sahul	Massive masssssyyyy background score awesome thaman Anna superb Goose bump overloaded with full of BGM thaman Anna NTR
bhaskar tarak	Superb bgm jai ntr anna
Raghava L	Super thaman garu
Hemsundhar Hemsundhar	Superrrr taman
Rayavarapu Someswara rao	Super Anna
Telugu Rajasekhar	Super music
shaik johny basha	Super
Bhargav Chitturi	Tq u zee
D Mahidhar	Super bgm
Manohar Manu	4 time chusina naku bgm vintunte malli chudalani vundhi
Rajareddy NB Raja	Super thaman sir
Skotayya Skotayya	Thanks super super bgm
Mandi Vamsi	Amazing work by thaman anna
GALI ASHOK KUMAR REDDY	BGM super 💓💓👌👌👌👌👌👌👌👌👌👌👌👌👌👌👌👌👌👌👌👌👌👌👌👌👌👌👌
Ash12	Jai Jai thaman keka Anna nee music gani bgm kaani eraggottesav pooooooooooooooi
Sumanth J	14 50 🔥🔥🔥 Oba gi dhamki ichina Veera Raghava Reddy
Syam Tarak	Superrbb thaman anna
Brahmaiah Poreddy	సూపర్
SaiRam Mortha	Music Thaman 👌👌👌
Thirumal Kumar	Superb thaman Anna 💕 bgm superb
venkat ntr	Superb BGM
Vishnu Temper	Torch bearer BGM🔥
Kesava Boya	Music just goosebump 🙏
raviteja cheruvu	Thaman 🙏🙏🙏 bgms jukebox tho kuda 1m datali 100k like Ravali inka ekuvey Ravali e cinema ki Pranam sami ni bgm 😘😘😘😘 Jai ntr Annaa
KrisH	Jai Thaman
ARJUN YADAV	Not bad
ganesh bablu98	Jai NTR Jai NTR Jai NTR Jai NTR
sirasavada nagaraju	My lovable bgm awesome thank u thaman bayya
Madhu Gullapalli	Jai ntr jai balayyaa
Tejesh Teja	Wow superb
SK Ntr	Super Anna thaman
Anvesh Parimi	Kickass BGM
Lovely Chandu	Osam Bayyaaa👌👌👌👌👌
NTR TrendsTM	Jai NTR From Hindupur
Ramesh yacherla	Thanks Thaman
Praval Chintu	Peace meeting bgm🙏👌👌saav kottadu
Sri hariChk	Home coming bgm 👌👌
Prashanth Chowdary	Super
Saikumar Music	Homecoming ☺
C Mallikarjuna	Jai NTR
ramana anasuri	బ్యాగ్రౌండ్ మ్యూజిక్ తిరుగులేనిది
Hemanth Hemanth	Super bgm
the walking undead	Intro✌️❤️
ghouse creation	EXLLENT bgs
siva rekha	Wow Wat a bgm thaman ji Simply superb
shiva shankar	Super tiger
Ramesh Reddy	Erra Pedda Thadika Leru Part 2 Goosebumps 🔥
Rishika reddy	Reddammathalli goose bump
Bora Jagadeesh	Jai ntr
basava raju	😍😍😍
sai kumar yadav	Super bro
Harsha Surapaneni	Trend setting
Venkat Talasala	Sooooooooper jai NTR
Saikrishna Devarakonda	Thammmman 👌🏽
Sai kiran Bonu	Adirindi Obaa Thaman😍😍😍
giri mohan	Great Job by thaman 👏👏
Krishna Krish	Wow mindblowing bgm
Ardhani Dhana Prasad	Jai ntr Jai kakinada
Sarath Thalaiva	Ee Bgms Miku Nachithe Oka Like Veskondi
siva kumar	Awesome BGM
Suryachandram Bandela	Thaman Masss 😍
hacking world	jai NTR
manoj manu	1k like 😘😘😘😘😘😘😘😘😘
Mathew Mathew	Thaman fan like
daruvuri phanith	simply awesome quite better with earphone than normal 😍
sai Krishna chowdary	JAI ntr Anna 👌💪💪💪💪💪
Jyothi Chinnam	All song r super n very extraordinary lyric Recently added song also super JAI NTR
soori potla	GooSeBuMPs BGM
raju creations	Jai ntr
NagaVamsi NTR	Jai NTR Anna
lokesh kuruba	Super
A2 Music	Superb Jai NTR Annayya
nampalli himasekhar	Adhi THAMAN amtey Bgm ka king
Suhas yuga	288th like 😚😃
vijay bezawada	Repati nunchi ivi konni serial lo vadatam jaruguthundhi😝
Srinivasulu Chintala	Prsnt generation lo Bgm king THAMAN👈👈
Gk Vamsi	Bgm ki Amma mogudu SsThamnan A Imka raadu avadu🙌 jai ntr Johar Harikrishna
alex john	Thnxx fr such a lovely bgm taman Garu😍😘😘😘
Yaseen Shaik	thaman anna back in form jai NTR anna
Madhu Patel	Thaman ni lekka marindhi JaiNTR
akshith reddy	Thaman BGM ki oka like vesukondhi 👍👍👍
pavaN TR	Goosebumps for all BGMs jai NTR
Kalyankar Harsha	Jai NTR Jai NKR Jai NBK
Vishnuvardhan Akkem	Jai Ntr arvinda samitha awesome bgms thanks for uploading For movie main plus point for bgms and ntr maravelous NTR Anna Acting
Pandu Tarun	Bgm ka baap thaman in thope🔥🔥
Sateesh Vadde	Naralu Nikkarapodustunnai Oba
Shiva keshavan	Thaman Bgm ki Oka like eskondi
Muniraju V	super keka jai ntr
Venkata Jagadeesh Divi	Likes for Torch Bearer BGM
Bala Tarak	BGM lo Ninnu Minchina Thop Ledu thaman Bro
Venkatesh Reddy	Super anna goosebump Music
Vidhya Charan tinku	Osm bgm👌👌👌
Ramakrishna Kalaga	Jai NTR
POTHINI DHANUSH RAJ	Jaiiiii NTR
Abhisheak abi	First like and comment JAI NTRRR
Ramesh Ntr	First like naade thanks taman Anna super 👌 👌 bgm jai NTR 💪 ✊✊
Narendra Daya	Jai Ntr Anna I like u
sri nadh	Jai ntr anna
Nani Chowdary	Jai Jai Ntr Anna
Rajashekar K	1st like 😘😘❤️
SABAVATH KIRAN KUMAR NAIK	Blockbuster 💪 💪 💪
Bharath chowdary Nalampati	Bgm super BlockbusterAravindasametha
K. Hemanth	First liker😍😍😍😍
vinu Kumar vinu Kumar	Heart touching bgms lovely sstaman hand s off we all love u soo much 😘😘😘😘😘 👌 jaintr
Raghu Chinna	Without ntr thaman asvr nothing
Sharath Kumar	NTR Intro BGM 😍😁
Lokesh B	Jai ntr Anna
ntr nbk	😍😍😍😍
sree ram jogi	Aha aha annaya entry bgm nunchi climax unanimous scene bgm daka deni place danidhe ❤️👌🏻👌🏻 Jai ntr annaya
Ntr Narayana	Jai NTR Anna
SIVA TAROCKING	Super BGM📣🤘
Ramesh Babu	Thaman BGM ntr anna acting 💞💞💞😘😘
Hari Tarak	Fantastic and lovely song Anna superb👌👌👌🙏🙏🙏
Upendra Penumarthi	46th like
ammaldinne pappur	Thanks thaman Anna once again
kiran kiru	Jai ntr luv u tarak anna luv u so much
VStar venkatesh adapa	Ss thaman awsome music Like to thaman
REDDY NARESH	తమన్ గురించి మాట్లాడే ముందు ఒక్కసారి వినండి 😎
Attitude must	Only NTR anna die hard fan here
chitanya krishna	Jai ntr
Naughty Boy Vishnu	1 st 💗 like
sagar yuvi	Blockbuster movie aravinda sametha jai ntr
பழைய சோறு	Agnathavasi bgm pls🙏
Naga sumanth	Jai ntr
Bharath kumar	Thaman Anna nee BGM tho movie ni verey level ki teeskellav
Suresh 143	Ntr fan like her 😎😎
Deva dance special	Jai ntr Anna 💕💕💕💕💕💕
Bad Eyes	1sr like is mine
Sudheer NTR	Superb JAI NTR NTR Anna fan like here
kamepalli Nani	Thanks thaman Anna for your beautiful music and mass bgm😍
Mahesh Ntr	జై ఎన్టీఆర్ అన్న
BHARATH DAVULURI	Waiting
sure Tarak	Super super👌👌👌👌👌😍😍😍😍😍😍😍❤️❤️❤️❤️❤️
c ravi	BGM lo neekante thopu evaru leru thaman anna first like
Allanki Vamsi Kumar	1st like
pavan bittu	2cmt🤗🤗🤗
king kumar	1st comment
A1star Rams	First like
Kumar Chatla	Super
Ricky kaushal army	1st like NTR annaaaa❤️❤️❤️❤️😘❤️😘❤️😘❤️😘
Vinay kumar	1st like
