petecarollsgum	U can say it now seahawks
wilbrich30	Just get a baldy
One Jazzy Boi	Up 17 to non nnn n n nnnnnothin 😂😂
Yung Gwaup	6 32
Tracy Lorraine	Dj mor and cam Newton my favorite player
Shark Commander	Who else wish the Eagles lose a lot of game just to watch EDP have a stroke on camera
Orioles1997	You ’ d think he ’ d be somewhat satiated by a Super Bowl championship last year
Evan Phillipson	try being a falcon fan
celtics8402	2 27 LOL sound like his dad is saying Please cut it out
Derek Blackman	EDP s blood pressure is a high a the Eagles chance of blowing game lmao
Mr. Pugh	Cam Newton We listen the hate and Keep Pounding Lmao
Garreth Boland	Born in 88 been a Bears fan my whole life I feel your agony
Owen Almoney	Just root for a new team jeez man calm your as down
SAT Scott	Lmao im weak asf🤣🤣
ITRY	Lol
James	2 27 I thought I heard his dad
Rushil Balkundi	urinatingtree criticized the eagle with almost all the vitriol he had and I thought EDP would have even more vitriol for this team what we got instead wa despair it s kinda sad
Andrew Thomas	The first person I thought of after watching this miraculous come back exactly the reaction I wa hoping for I should ’ ve checked sooner Pure entertainment lmfao
Dan Dombrowski	need the eagle to suck again so edp cant make more of these lol
Mikey Kreata Flash	Pressure bus pipe for EDP I laughed and cried for 10 min 🤣🤣🤣
Jonny Lake	Just stop
Cam Newton #Superman #1Hunnit #KeepPounding #CAMVP	Jalen Mills trash as let Torrey Smith run right by him on that 4th and 10
dee fuller	Talkthemuthafucka445
Mike Mathers	Calm your tit you won the Super Bowl last year
ChouMakaimura	Pause right at 0 00 That ’ s the face you ’ d get after getting some good dick or pussy Send that feeling to space Let them cosmonaut see the fluid soar to the moon 👨‍🚀 🌚
Towqio	That person by the window lucky edp didn ’ t have his gun out
Ajay Deonarine	Beautiful
wilson imon	That sport is shit
Darius Robinson	At least ya have a super bowl championship
D&E Gaming	Eagles suck
SeahawkFan1995	Eagles blew a 17 0 lead 😂
Jon Taylor	He ’ s bout to call a chatline now and beat off
Wolfy Chipmunk	Punchdatdoor445
Daniel Mead	You need anger management
Griffin Ellison	Donnel Pumprey will have a better career than Christian McCaffrey EDP
Jon Caldwell	WaitingForTheFlag445
De'Juan Burns	Fair weather fan
Avery Reed	We need reaction vids bro they ’ d be hilarious
Skol TV	Glad we got to see him win the SB back to regular scheduled programming
Wwe Stuff	I ’ m not even excited my favorite team the panther beat the 3 4 defending super bowl champ i don ’ t even care
JeffSan	Sounds like he wa going to cry at the end
Pancake 26	Dat thumbnail tho
RagingBlackGuy	Panther Nation Stand Up
SuperLooey	this motherfucker is really selling merchandise aint nobody gon na buy shit with ur face in it
99 Pac	☹
Robert PutLastNameHere	You re a fake as man Not even gon na say fan bc it worse than that Next time you come to Philly I will gladly take an assualt charge bc I ma punch you in your fuckin mouth
Ricky Cutchin	Cammmmmmmm
JOHN WAYNE	the passion seeping out of this video ha brought tear to my eye
Benson Yazzie	it just a fucking game nigga win or lose it s a game moron uR 2 stupid 2 understand that what s uR problem uR 2 stupid understand that fuCu nigga boy
Band up Blue	🤣🤣🤣🤣SALTY BITCH KEEP PIUNDING
Kevin Duffy	Welcome to the Super Bowl Hangover club Sincerely a Broncos fan
mjmacias623	Admit it already Eagles super bowl wa a fluke
Matthew Shortle	Your team just won the Super Bowl dude Be happy you got one My Rams are 7 0 but we still have haunting memory going back to Super Bowl 36 when they lost to the Patriots to begin their dynasty
Some One	HES BACK
MaddenWrecker06 The man	didn t the eagle win the super bowl last season edp
Lil Joc	Just looking at EDPs head on the YouTube logo on his wall😂🤣🤣
tree70737	I love when the Eagles lose This is my favorite part of the day😂😂😂😂😂😂😂😂😂😂😂😂😂😂😂😂😂😂😂
Dwight 03	Y ’ all betta get Peterson
D'Angelo Jackson	EDP Dogg I love you but man you can t let sport get this much on your health I m a raider fan a hard a any other member of the nation Even though gruden doing stupid shit I m not letting it get to me team have their slump year You can t let this ruin your health man Sometimes team need to lose to finally understand and to learn what it mean to be champion again
ThatCool Guy	chopthatoff445
Patriotic Sports	BREAKING YouTuber EDP445 hired a Eagles head coach after Jim Schwartz and Eagles rant
If you heard me speak, I spoke in all facts	You need to tackle that bald spot blood 😂
dlp1212	Fire Darby and Mills Bastards are trash
Joseph Quinn	Never should ’ ve traded Torrey Smith in the 1st place
Regi Cheney	Painful
Charlie C	Try out for the Eagles my nigga
Logan Ne	You are my inner rage and conscience that I can ’ t unleash in public broski We in this together tho my dude FlyEaglesFly baby we got it mayn
lucas ryan	Fair weather fan
EAGLE___EMPIRE	BlackHomerSimpson445
tes516	We need to send luo dang the India sprite head massage guy and the foot with tool massage guy to epd445 so he can relax
Alex Casas	Me watching the bowboys
Kenneth Page	the eagle got a ring and lost there fire
Jeff Hass	2 26 I ’ m EDP and His floor is my meat
steelersfan 8417	If he get this mad about a football team losing a game just imagine him playing video game he probably threatens to kill himself whenever he dy in a shooter LMAO
Ibrahim Moizoos	I m starting to wonder how the fuck the Sheagles won the super bowl
Sy Flembeck	Guess what EDP guess who will still be in the hunt for the Super Bowl this year THE PATRIOTS Guess who will NOT be contending for it LMFAO at you
Marvin Wade	YouTube know me so well This video wa at the top of my Recommending video right they were exactly right I wa gon na look this up too 😂
Mr Meaty	Edp blew his virginity loss
Just Ice	Did anyone hear EDP s dad in the back at 2 27
David Zavala	Scored in 3 straight possession in the 4th quarter fat boy ha
PSY_Aphex	Angerissues445
Trump 2020	Lmao he s upset about blowing a lead Try being colt fan We are the king of blowing lead late in game It s horrible
iLLa SkriLLa	This year ha been brutal to watch Every game except 1 been down to the last 2 min Need to play 4 quarter of football Foot on the gas pedal
Silvio Aviles	It ’ s crazy because I actually flung my laptop across the table and towards the wall yesterday once this game wa over I didn ’ t give a shit about it because that ’ s how upset I wa at the Eagles blowing this game away harder than Abella Danger It ’ s one of the worst loss I ’ ve seen and I ’ ve been a fan since ‘ 98
Jonah Steinberg	WheresYaHairline445
Ra X Automatic	Edp blood pressure is OVER 9000
Dude Perfect Junior	How do you think falcon fan feel tho
It's Just Matt	I m geeking 😂😂
Mike Conville	my nigga is right
Meech B	“ FRIES ” in hell 🔥🍟🔥
Abraham Vasquez	See u next week
eddibetty10	Shave yo head nigga LMAO Fuck you holding on to 😂
INB	FuckHighBloodPressure445
TW0man4RMY	LOL 6 30
jabba978	I wan na punch the fucking dog shit outta this motherfucking YouTube plaque Humble brag
Griffinex	Doug still signing book bro lol
Dominic078	Lmaooo
Arturo Ramos	0 44 oh boy
Tech 1212	At least we won the superbowl lol
DRock7977	Eagles are so fucking garbage useless bum team awful damn player horrible coach ugly wife psycho kid everything is horrible with this disgusting team Not a single player is even decent throw them all in the garbage bin ship the team to another city and sell all it asset
Jsmith12292	That s why the Panthers motto is Keep Pounding
fwied wice	He wa pissed 😂
Kenneth Burgos	You know he wa thinking about pastrami fry when he made the title to this video
Travis Fuller	I m going down with the ship bruh
ChicagoDefense	As a bear fan I felt this
Coldzy	edp needa be the new eagle coach
Do Your Job Ya Fat Slob	You ’ ll be alright bro chill 😂😂
Alex Roach	I feel your pain man As a lifelong Panther fan I ’ m used to the prevent defense when we got a lead and blow it or almost blow it It suck that coordinator don ’ t wan na keep their foot on throat
Julio Abdala	Demonetized YouTube 2018
B.I. 1421	Yea my Cowboys lost but this cat is always epic 🤣😂🤣😂
Pablo Fiscal	He low key still had hope the eagle would have won
Evan Koketko	It could be worse you could be a Browns fan
reginald mcneill	He ha to go Fireable offense
JazzyPrince333	Whoever said that the best comedy come from misery is a fucking genius
kenny w	WHY CAN WE NOT GET OFF THE FIELD ON 4TH DOWN PATHETIC DEFENSIVE PERFORMANCE TERRIBLE PLAY CALLING BY JIM
Philnelius Harris	Yall got a super bowl last season I ’ m a Niners fan and super bowl XLVII still haunt me to this day I ’ m worried you ’ re gon na have a heart attack on camera
nclanos	KEEPPOUNDING
Sam Parker	Better than my dang team
Noah Lanier	Eagles are as they had the game but the coach is terrible
Anthony Mangrella	I love you edp
Derek Mayfield	EDP on the verge of cry
In CogNeegroh	7 9 or 8 8 for the Iggles
stevesmith19711	I cant not believe the Eagles blew a 17 0 lead How the fuck can a team do that Wow
Stank Nuffim	The only adjective he know is fucking
xlaostha704x	give the game away keeppounding LMAO dab on them folk
Hangmin Cho	Why is EDP445 video are age restricted
Mason Mahoney	7 10 no asscracks or shirt off
Mike Angeli	Jim Schwartz don ’ t run ur offense Wentz fumble made them lose lmao U guy suck Old man Torry Smith 4th 10 catch wa great
hazemonster	Eagles WILL give you a heart attack my dude stress le I don t want you dead over the Eagles playing poorly
IML WAY	Edp I hope this team on there way to London there fucking plane go down smh 🤦🏼‍♂️
Balamssin	Alright then why you have merch on your wall
Jeremiah Belton	As a REDSKINS FAN this is quite entertaining LMFAO
private pyle	445 200
Rod Sarv	Pastrami fry 🍟 will make you feel better 🤣🤣🤣
Black Libertarian	At least y all won a super bowl the falcon aint never gon na win one
Beastmode9000	At 2 33 I thought 4 a moment that it wa Seth Rollins Theme Song playin Lol
deku	Punchthatdoor445
David Barber	lol the Panthers buckled down and won
Josh Clausen	Energizer Easter Bunny 😂😂😂😂😂😂😂
eyanks2584	This is the high quality content we expect from EDP
RayvonFrom Virginia	Somebody peeled this nigga wig back mane
jackals1982	i smell you unc
Richard Quinn	I take it the eagle lost
Bflo23	Tell u how you really feel Don t sugarcoat it
Charles Philp	This fool is gunna die of a heart attack for youtube view lofuckinl
GBlackbeard 412	😂😂😂😂😂😂
Devon Dow	EDP Im a Panthers Fan till I die but I love your passion for the bird Im soooo subscribed to your channel
Seanbanks83	I never seen a team control a man life more than the eagle do with this man
GPUFF390	Some where in there someone still looking for is Vaseline
i2Shea	Eagles season fading faster than mine and EDPs hairline real talk
Mike K	We coming hawk 🦁🦁🦁🦁🦁
Its Ali64xX	I hope there are fry in hell
Elvis Silva	This guy overreaction is beyond hilarious 😂😂😂
David Miniel	Who shouted for him to cut it out
Collin Hart	Got ta eat that L sometimes
Dragonell Z Stop Motion	TACKLETHEMUTHAFUCKA
Julio Ventura	Good thing he ain t a Raiders fan
Pancho Pistolas	Summer Olympics Bobsled Hairline
Michael Price	I love this channel a much a I can somewhat relate to this channel a a Texan fan bc we always find a way to fck up ik at the end of the day it ’ s all only a game As much a I understand the struggle I will never get why you always act a if they will never win anything or why it ’ s the end of the world Although it may only be for YouTube for you Whoever want to base their life on a sport team getting somewhere is a waste of life there are many more thing important than that Hope one day you get that If it ’ s for YouTube it ’ s obviously worked congrats otherwise get straight
BlockHeadG	Edp s dad can ’ t fap in peace the ungrateful son
Dj Bernal	They need to have edp in the locker room when halftime come so he can do this exact shit in front of them lmao
WMACK0523	KEEPPOUNDING
Pharaoh XCIV	At least y ’ all ain ’ t Giants fan I ’ ve had to sit through shit season year after year At least the eagle are actually a good team they just have to execute on defense when it come to third down giantsfan 1 15 tankszn
MadMan 90	💀💀💀
A J	“ And The panther keep the drive alive “
ArcTrooperMaize	God fated EDP and the Eagles together to give u amazing give u content like this
Steven Kemp	EDP FOR EAGLES DEFENSIVE COORDINATOR
Young Slyme	HOLD DAT L BOYYYY
Seth Haze	Eagles making this man lose all his hair 😂😂😂
hi lo	Has a 15 year old I fell your pain
Shill Flock Ave	“ Frys ” in hell
Freeflow Lifestyle	Look at what the eagle did to EDP hairline lol
Alex Diaz	Die Eagle Die On the world to your suckiness
The Sports Fan	Your dad regret not aborting you
Shadow Zone	This nigga talking about attacking jim schwartz with a machete
Michael Escobar	Clicked off Jason Garretts bitch as to listen to some real shit
LV Joe	Take that machete and chop what s left of your hair off
Mr Mimi	Edp need to get a punching bag with jalen mill and Doug Peterson on it GetThatExercise445
SAE Erb	I think it time for you to find a new team bro Your putting way to much emotion into it You remind me of my 5 year old son when he loses Life is too short to be butt hurt every week man True fan rep and stick with their team through good and bad You should be a Patriots fan if you want a team that win They might cheat but at least they win right
joey flores	PunchDatWall445
Reginald Gonzales	ACL ACL ACL
veritas1007	good luck with trying to get a 1 2 million subscriber o also the Falcons will maul the Giants on Monday night
Cam Kuechly	Y ’ all just won a super bowl 😂 I would take 10 0 16 season for just ONE super bowl ring
tbraysfan2008	2 26 wa that his dad yelling in the background
Zoron	This is what happens when someone schmuck get so into a sport they keep watching a their blood pressure raise and despite bitching all the time about a team they keep watching them
Jamaal Miller	Chopthebitchoff445
Emmanuel Garcia	Lmaooo yall better watch yourself guy if you pas by his window u dead
D'Tywuan Davis	BlowingLeads445
Steven Exil	2 21 when gohan kill cell 😂
EnSabahNur	My nigga you need to step away for real instead of this back forth bullshit
whip tater	watch that BP BRU TAKE IT FROM AN OLD CAT FIND SOMEBODY WHO GOT SOME MEDICAL CUE UP FENCE WALK GUARANTEED IT ALL WILL GO WAY LIKE A PUFF OF SMOKE TRUST ME MATTER FACT I M GON NA YOU TUBE THAT CUT RIGHT NOW
Rucci SODMG	😂😂😂
KuljuSportsGamingHD	classic edp
NickFoles IsGoat	Bro this pissed me off
garrett king	KeepPounding
George Peezy	how can someone be such a bitch after his team winning a super bowl embarrassing
Matthew Ludwig	EDP this team is not worth getting angry over But it OK I know your the most passionate eagle fan out there I hate to admit it bud they deserved to lose but I will also give the panther credit I m plenty pissed off too but please don t hurt yourself The eagle have a lot of issue at rb o line cb safety lb Hope they can get these issue addressed soon They better get their act together against the jag
Scuz	Was it the ref fault this time edp Quit sleeping on our as mad ur team fell tf off
#1brother	I m a Panthers fan and I ve been waiting for this lol
Corey Petroskey	I wonder if the eagle player have seen edp
Pahco da Don thomas	I love the Eagles win or lose we got to fix some thing we good
Tony Wade	LOL
Dabket3araB	This is gon na be good Get your snack ready
MrBaddog7676	Lol As a Giants fan these video brighten my day 😂😂😂😂
ps4god d	When we loose I just go to the video when we beat the Steelers 😭😂
NORTH CAROLINA MUSIC	Lmao legendary
LukeTes	classic edp
kcjuggalo2001	Fuck the eagle Go Chiefs
bryan ifeanyi	You are hilarious lmaoo As a fellow die hard Eagles fan I wa so shocked but more so disappointed on not executing this win that wa rightfully ours We dominated til the 4th quarter then bad defense play calling and blown coverage mess shit up Idk we need to make serious adjustment fast This game wa a remix of the Titans game like you said It ’ s still fly eagle fly Now we ’ re on a right thread before our bye week
brandon ADAMS	I hope the eagle bring me pastrami fry in hell
Overkillz25	TackleTheMothaFucka445
Darius Powell	Man I wish he continued it so we could see him freaking out a the Eagles tried to comeback
adam7mma	It really say Eat day pussy on that YouTube plaque 💀🤣
Rock City	Blow that lead 445
XXXTENTACION LLJ For life	FreeEDP445 after he murder Jim Schwartz with his smelly as
LPS_Biggie	As a Jags fan I feel you rn We re in the same place going into London and it s gon na be a shitfest the whole game on both side I m guessing
Joshua	Say what you will EDP ha every right to be upset
Dan P	I wa so hoping the eagle would lose for this video lol
Frank DeAnda	That lead went away faster than that hairline
THicc Grimes	Oh fuck EDP got a play button
inferdus	how many time doe he say fucking
Erik Mitchell	21 17
Edward Kelly	Cheer up Jacksonville is banged up on offense so you guy should get a win next week
Buddy Barlow	H T T R but on another note man Philly just ain t a good a they were last year man it sure a hell won t be a repeat this year for you boy
Dub Snac	I honestly wonder how EDP would be if the eagle were a good team every year maybe he skinny not a virgin and ha amazing hair oh well the world may never know
Duane Akerfelds	If you dont like EDP then fuck you
Sports Highlights	Love your enemy read Matthew 5 44
PacK Winded	This video is gold NOBODYCANFUCKINTACKLE
VortexFX	Still can ’ t believe I saw this man ’ s as and second as on his stomach
Art87 Stang	We lost too man Dam Cowboys Lost
Jonathan Bunting	Worst game I ’ ve ever seen I definitely ranted harder than EDP Team is a joke
Magic BurritoTV	BurnInHell445
James Lisle	JackOffToSuperBowlHighlights445
Olutomi	The only thing to take my mind off an Eagles loss is an EDP reaction video
Dazzy Rockz	I waited all day for eagle to blow the game and watch this video
Coolgaming17	This so funny cuz I ’ m a panther fan😂😂
Quentin	When having a bad day just binge watch EDP video
Rick James	Httr we on top lol
StevenPT Martinez	Highlights 2 25 3 58 7 00
koi kid	Once again tf is up with this thumbnail
Luis Heredia	Edp should be an ESPN reporter
Nyc News Now	Lmao yo everytime the eagle lose you know it s gon na be a classic vid with this guy
Alex S	Damn edp rocking the Lebronline
rogerskolney	The Eagles held that lead about a well a your head held it hair
Stoner Phoenix	keeppounding
Robert Mormando	Damn EDP bout to get his as spanked by his Dad
Tyler Andrade	I m a Pats fan and despite winning 5 ring this is how I react when we go down 7 0 lmao Fucking football doe shit to your brain
LimewhiteTV	Hairline on 4th and forever
Robert J	Waiting for your mother to come in and tell you to keep it down
Swagmaster116	CoachThoseEagles445
Swerve J Jordan	Who else taking a big as shit watching this 😂😂😂😂😂😂😂😂
Patrick	Didn ’ t the eagle like just win the Super Bowl
M Gregston	4 05
Ninjafrogz	I wa watching the game thinking about EDP making a video like this
The Gambler	The title alone had me dying give it 2 them
Frank Moyer	Blame the new NFL tackling rule also
ThatOneGuy 123	Hahahahahahahahahaa how ‘ bout them Panthers
Mario Soriano	The eagle blew the lead again choke eagle choke
Spoopy Danny Boi	The 49ers have it worse
JewwBaccaa	This video is gon na get a copy right strike
Matt Sheiman	2 46 Look at the challenge facing the nation and say FUCK
J I	Wecanttackle445
Mr 28-3 YALL THOUGHT YALL HAD IT	Bitch as nigga thats what yo fat as get
Lakeey	a an avid carolina panther fan I enjoyed this video
Logan Swartz	I still think the Eagles can win the NFC East
Brandon Kelso	Literally downloaded this video This will cure depression
fixxxer3456	Welcome to how Falcons fan feel on a daily basis EDP
Biggie Sneeze	Don t let the Eagles losing distracted you that the fact cam newton spiked on 4th and 1 and mcm didn t get the 1st down
Jason Smith	Here come the rage
Eric Wollam	I wonder if EDP know that the majority of his fan not from Philly are just from sp and 4chan
Dante Guardi	EDP should be a guest on Barstool sport show “ pardon my take ”
Illusions	Before I even clicked on the video the title had me dying lmao
Jose Moreno	It seems like Felipe isn ’ t getting his cheek busted tonight being that the eagle lost bustthemcheeks445
Joseph Russell	Is it wrong for me to enjoy his misery 🤷🏽‍♀️
Bman 4	If Edp put an age restriction on the video there should be no reason why he got terminated
Jeremy Ross	Hilarious 😂😂😂😂😂😂⚰⚰⚰⚰
Parker D.	I stopped watching Lana Rhoades for this
Vinny Smoove	This nigga don t be that mad he know we love this shit 😂😂😂😂😂
Dennis Allen	Lol Keeppounding
bumblebee	Highlights “ heroin bird lookin “ “ 2 0 what the fuck 206 ” “ NOBODYEY CAN FUCKIN TACKLE EM break table ” “ I wan na fuckin throw up right now ” “ and you ’ re like the energizer fuckin Easter bunny and shit ” “ they better get the fuck away from my window I ’ ll light these motherfucker up ” “ I hope this team burn in fucking hell ”
Dr Pavel, Im CIA.	Wentz Cox Ertz Alshon Goedert Bennett That ’ s it Everyone else can die
-azzcheekz	This man wa really about to cry lmao still love u edp
Jacob Anderson	Bro i havent seen edp this mad in so long
Jack Azz	Xvideos Porn hub
Bad news Brothas	Kill jim schwatz445
Bryan Ho	Ripmyass445
Smallnappy	And then there wa the Cowboys game
Bashir Shah	The video start at 0 00
Jay C	You said you done with the team WHY YOU MAD 🤷‍♂️
Byakuya Kuchki	EatThatL445
Patrick Star	I left my grandma funeral to watch this
Xero-TheBig-Boss	Season is over we ain t making playoff for sure Even if by a miracle we do make playoff we lose in wildcard
Abdul Inniss	You should have traded Carson Wents to Cleveland for the number 1 pick Nick Foles should have been your starter
Paul Sexauer	And the Philadelphia eagle have blown a 17 point lead unbelievable 😂
Eddie Navejas	Thank you baby jesus for the eagle losing lmfao
The United State Of Iowa.	GoingToShootUpTheTeamBus445
Illest one	I wa waiting for this LMAO this team ain t repeating this year RAM S are taking the NFC this year
Julien Johnson	Edp hairline look lika puzzle peice
Jonathan Joseph	Heroin bird Motherfucker
COWBOYS NATION	WE FUCKIN LOST CAUSE OF A MOTHER FUCKIN FIELD GOAL COWBOYS MANAGEMENT YOUR FUCKIN STUPID WHY THE FUCK WOULD YOU GET RID OF DAN FUCKIN BAILEY
moe dog	Eagles losing is the best thing to happen on Sunday because you get this we need a 0 and 16 season to see how bad he go off 🤣🤣
plowerman78	Looks like he gon na sleep in his car again
Hulk247	🤣😂🤣😂🤣😂🤣you Channel is pure gold bruh I KNOW how you feel I ’ m in Cleveland and is a brown fan we give damn near EVERY game away smh 🤦🏽‍♂️
Kevin Wright	Funniest shit 6 32
thesaintsangels89	Edp best advice I can give ya is to take a step back nd to stop idolozing football over everything in life for ur mental nd physical overall being but then again hopefully if ur not a stubborn then no need to worry about that cat being stuck on that tree
hypeboy95	Even thou it his name im still on the fact his youtube play button really say EatDatPussy 😩😭😩😭😩😭😩😭 nigga a legend
El Poundo	Bet it wa worth it when you won super bowlast year
nah im not real	How bout them ram
RockSolidEJV420	I don ’ t care what anyone say Eric Reid made that interception
swebbmann	LOL
Chumba	Game wa so fucking horrendous to watch Lost my whole high watching that weak shit
sliehgtofhand	Hey Brian sorry but I copyrighted the phrase sit sat back a little while ago I watched a lot of your other video and you owe me about 700 000
f00zh	dude s still fat and going bald to boot
Adonai G.	Your team just won a super bowl lol
Jason Bailey	KEEPPOUNDING 4 2 on our way to the Super Bowl
Parker Anderson	GOAT GOT HIS CHANNEL BACK
Orlando Lemus	Idk wut to say idk
YDE KALI4NIA	At least you ’ re not a 49ers fan
that guy	If Trump became president EDP can become the head coach of the Eagles Lmao
Godzilla John	Hey guy forget football Here is the real reality Jesus Christ died on a cross to save people from their sin according to the bible Then Jesus rose from the dead 3 day later thus defeating death Anyone who belief this will not perish but will have eternal life
NFresh	Eagles soo traashhhhhhhh lmaoo
Ruben Leal	He gunna cry in the car
Backyard Mechanic's	cantnobodyfuckintackle445
David Camba	Who else come to EDP ’ s channel just to see his reaction after the game I know I do 😂
Black Star	Watch how he s gon na dickeat when we start winning
Sean Wallace	SmashThatTV445
Ricardo Garcia	Bro y ’ all just won the SB I ’ m a fucking cowboy fan and I would still be happy if my team won the SB even if they went 1 15 the next season but shit the Cowboys are fucking dog shit and those mf ’ s I hope those mf ’ s wife cheat on all them fuck the cowboy sorry as Fucking team
Winston Haywood	lmfaooooooo when Carson fumbled on that last play the first thing I thought of wa EDP BOUT TO GO OFF XD
George Is Straight Elite	That hairline threw a pick 6
the man	Jaguars v Eagles next week in London England get another dud take that NFL
Denis Rodriguez	Try to be a cowboy fan
James Smith	Why ’ d you take the sticker video down
Mir Carson	6 35 so we just gona ignore that lolololo
michael edwards	Lmaooo it s been alot of choke job this week
Geeked-OutTurtlesFan38	It could be worse You could be one of those toilet you clog up every day 😂😂😂
daniel maldonado	As a Cowboys fan I feel the same way about the Cowboys Garret need to go Jerry Jones need to die we will never win another super bowl a long Jerry Jones is around he ’ s the cancer for the cowboy
Benzi Musiq	show off the youtube award now why will ya LOL
Ed Carlon	Them ram finna eat that eagle as
JayyBird	That moment when you tell your favorite team to burn in hell
BOONK GANG WHOLE LOTTA GANG SHIETTT	Lmao you called it on your instagram Been waiting for this bruh
David Jackson	You look a little salty You should take a shower patriotsnation
Breezy7	This thumbnail tho 😂😂
James Voufo Safor	Who couldn t wait for EDP445 s reaction after the game
Andrew Sullivan	Just got reinstated to Youtube Now wish over 50 player and coach to burn in hell
Lex Haddon	Look on the bright side cowgirl lost
Jon Day	Fake reaction Hamming it up for the camera
Joe Kieffer	At least my Vikings won
SIR SI3GHAN	This comment section is for the mature only
Donald Trump	I stopped fucking Melania for this
Liberty Minded Solutions	Root for the patriot
stinkydroolface	DIDITFORMOMS
The AUX Cord	I m a brown and eagle fan The 20 year of my life have been pure agony
John Carter	Damn the emotion in EDP s voice at the end of this video wa so sad 😥
snowman texas	Eagles suck
Beanie	What happened to the video after this one
p i	After a 17 pt lead man
Abraham Rivera	Man I knew you would delete that video if you ripping that Eagles sticker from the back of your car 😂 🦅
bruno romero	I feel u edp 😪
Brazen X. Calibur	He s acting like they didn t just win the Super Bowl last year
Dan Albanese	What y ’ all think EDP room smell like
Paperbag1124	Energizer Bunny XD
Michael33R	When EDP445 dy he should let the Eagles D lower his coffin so they can let him down one last time
Kyle Syamken	My Cowboys and my fantasy team are losing but this video alone is what made me decide to put down the jug of bleach again
Noah Scott	I feel your pain a a bear fan
Ryan Cooper	Love reading the comment y ’ all funny a shit😂
Slack Attack	We have a QB playing at a MVP level and Zach Ertz and Alshon are balling out HOW THE FUCK DO YOU BLOW A 17 POINT LEAD IN THE 4th
THE GOAT	Being a patriot fan is worth it FOH
funkyflights	Go back to Nick Foles he s the better QB play s better under pressure
Connor Leeson	Hold this L KeepPounding
mjstory1976	The Chokles 😂😂
Everydaysporttalks	the eagle win the superbowl last year why first him one year after Yes there defense should be better but that just going overboat
Dark warrior7000	That game score wa 21 17 my team won that 38 31 NewEnglandPatriots
oJC Swaqq	not evening laughing is just frustrating being a fan of this team u never know what to expect from them that s how they are just embarrassing wow
this is quist	HighBloodPressure445
sat716	What wa the video he uploaded titled yup im a fake fan 😘😘😘 about
kc 3182x	A fat virgin cry lol
Holden Chase	Sorefist445
DA Cousin	PunchDatDoor445
D. D.	Fry Eagles Fry
Tyme	Eagles are gon na make him commit breathent
Bill bob	Football making EDP445 balding
heatchamps2011	U wan na see a worse defense The dolphin
Country Road	Dam and you know Newton got under that skin doing all his Corny 🌽 Shit
matt13r1	Eagles could win back to back Super Bowls and you still wont be happy
Shark Deepwater8	Bruh Fries in hell Can t keep away from junk food if he tried
Biggus Dickus	Newton Wentz and that ’ s fact
Some Asshole	He tearing up lol
Pedro Leco	Give me the philly special hold the L ’ s please keeppounding
bee dot a dot	The title supposed to be I hope this team brings me fry in hell
Novashock 12	Blood pressure through the roof
Sam Sackett	EDP should livestream himself watching the game
SwagTitan	I stopped having sex to watch this
bio hazard47	Defense is trash
Gimili101	I m guessing that when EDP dy 30 50 year from now it ll be of a heart attack from recording one of these fan rage video
LJG	This is why we sub people this is what we wait for
RoachClip OTG	The Eagles defense been choking all year
C OhHiOh	This wa me during the Ohio state game
u yuh	can you please fix that hairline
randomdude476	Exactly why I want Bob Sutton Chiefs fired
Zach Stacey	Hold this L
Arthas Menethil	2018 eagle 2013 Baltimore Ravens
Matt Bradley	Lmaooo I CAME HERE TO SEE THE MELTDOWN
javier ortiz	Take a chill pill ma niggah
Chris Lee	Panthers picked their teeth with Eagle bone Carolina
TheREALTittymaster	Time for you to ride off into the sunset and quit all this You ve made an as of yourself long enough and it s tired AF Sell your shit and make something of your life
Mikey	2 23 Ohio State fan last night
William Reed	That ’ s what ur garbage as team get for dancing on the field celebrating before the game is over panthers4life
Ty Pls	blood pressure 666 420
TheSpriggins28	He ’ s back
Zack	That moment when EDP s Dads deodorant get more as than EDP 😂😂😂💀
Czech The Great	WHO THE FUCK IS WATCHING HIM IN DA FLAT All bullshit aside I m hoping Bryant ha a good season and work on having a better attitude towards the eagle ✌✌✌
Bart Simpson is gangsta	EDP yall just won the super bowl why tf are you raging lmfao chill and go watch sum porn 😂😂😂
Jordan Singer	WeNeedLeveonBell445
Dino Cerquetelli III	Jalen mill is gon na be publicly executed for that coverage on 4th and 10
Leonard Taylor	If we didnt watch the nfl you would never know this team won the super bowl last season
Ethan Vance	PHILADELPHIA TAKE OUT YOUR METRO CARDS AND BOARD THE L TRAIN DUMMIES 😂😂😂 KEEPPOUNDING
Alimony Pony	My man said that heroin bird lookin nigga about Jim Schwartz ha me weaaaaak
InQuickWeTrust	Football is so gay
Stompin Thomp	As a panther fan I ’ ve never been so hyped for an EDP video
zac taylor	FuckThatTeam445
evan johnson	You think your team is a joke take a look at my team the fucking a jaguar our backup QB is better than our starting QB
MrQuestionBox	Amen
Brent Skomsky	eagle are still the best team in the nfl
Thefallen Griefer	I would love to watch him play Madden 😂😂😂
David WhoIM	Wait for it Boom
John Gotti	Jim Schwartz is sucking his mom cock
Ocho	ChopTheBitchOff445
The Real Yoda	We need to get rid of Carson Wentz
Thisaintwhatyouwant	LOOK AT THAT LOOK AT THAT SHIT LOOK A THAT SHIT LOL LOL
Ben Shapiro	Show u the TV
beastman736	Quit fucking bitching you fatass fucking fuck Jesus Christ that ’ s all you do is gripe
Cannon Cook	bruh your team just won the Super Bowl like 9 month ago
Juan Felipe	Back to the old eagle
Phil lee	I punch hole in wall with my fist you big pussy and it don t make my fist sore Imagine all the dent in your fat whale as head after I got done with you faggot
coltonphillips725	I don t understand how Carolina won that game but I m so grateful for the win
Rh2_04	MadAsFuck445
Gregory Cunningham	He wa actually about to cry 😂
steelman46	keep the faith EDP You just got ta believe Repeat Repeat
donovan Poole	Hey it ’ s okay gg tho panther put in that work but y ’ all gave u a big fight
Sicksi	DeleteThatVideo445
DOOM PhD	TALKING ALL OF THAT SHIT WHEN THEY BEAT THE WORST TEAM IN FOOTBALL LOLGIANTS
MOE money	Ima jet fan and this made my day after that performance today 😂😂🤣🤣😂🤣🤣
SpartanStahl	The way his Carson wentz poster look His right hand with the football block the “ E ” so it look like “ Fagles ”
Diagonal_Fleece	I mean EDP did say he thought they d lose
Gregory Lewis	The Giants game wa a fluke 😒😒😒
Washington Capital	Lol yall sorry mofos
Courtland Griffith	He couldn t be an Atlanta fan He d have died year ago
AshGreninja1819	I knew the rant would come
southpark 981	Damn edp look like he wan na cry
Luke Cunningham	Highbloodpressure445
ViBz Echo	Bro I wa so mad I wa shaking
julian sykes	Someone re upload this we must add it to the lost achieves
h	become a 76ers fan
Prettyneatperson	Fucking Eagles coming from a Steelers fan
thedarkestdawn1	The eagle stressed him out so bad his hairline couldn t take the pressure and got outta there 😂😂😂
Eugene	I can make them fry in hell
Nilesh Kumaraswamy	Eagles choked away 17 point lead
Gary H	Keep Pounding lmao Panthers made your team our bitch
Born again 86	Who came here after eagle lost lol 😂
BowlesMovement08	I miss these video lol Chill they got a ring tho👀😯
carbajal8283	HighBloodPressure445
xChris3297	his apple watch sent out the heart rate notification ambulance is on the way
Adam Robles	What The Hell Eagles Had This Game Won What Happen
Matthew Dworschak	This is why we subscribe
Jason Lamb	We are fucking trash You were way more calm than I wa during this EPIC COLLAPSE
mickee06	You faded the front of your hairline
Anthony Powell	Keep Pounding 🤣🤣🤣🤣
Bird Gang	Fuck this god dammn team im an eagle fan we gave the game away iy piss me off we should of blown them out of the fuckin stadium fuck jim swartz and doug pederson im tired losing game like this just fuck this team wtf is going on with them doug pederson is a scared little bitch fearless gtfo
Devon F	CryEaglesCry445
Eagles crazy	Edp love you bro parker and bell asap I m heated
Jeremy Hutchings	Did you give him back his Vaseline Brian
Lj Boyd	Edp we in this hellhole together bro hmu
Ok.Shorty	3 4 welp Seasons over
Dough Baby	This is the angriest I ’ ve ever seen him
KEVO KEVORKIAN	EDP YOUR A FUCK BOY LOL CRY EGALS CRY
Don Eladio	That Thumbnail LMAO
Michael Krasting	At least this prof how fake of a fan you are if you actually cared you d probably have something you aren t very familiar with it s called FAITH being with your team to the end you are the poster child for why everyone HATES u I m an Eagles fan though I m only 18 and have only been a fan for 15 year I take my loss with a grain of salt and move on like sticking 500 dollar merch in your crotch show immaturity
Colin Sullivan	You could be a Bills fan We are suffering this year
johnny 12	PlayDespacito445
kevin sibert	that o is trash
Abeer Khan	You re telling me I wa at that game I felt like jumping off the stadium
Dan Da	I wonder do they show his video to the team for motivation
Lucas Williams	U should live stream game
LatinoPackBuster	This guy is never happy even wen they win lol wtf
mikebing1230	I ’ ve been waiting for this
KiDD340	Reportthischannel445
Alvin Tyler	I want to see a video of him taking all his eagle stuff off the wall and trashing it If we are a joke Real eagle fan don ’ t need this trash as dude
Wrestling Otaku	feel bad for the eagle man they and the jaguar aren t the same team that they were a season ago now I have to worry about the raven playing at carolina next week
Alfredo Forte	The new Eagle fight song Spread Eagles Spreadddddd Spread those cheek out wide lather up with Vaseline so we can be comfortable when other team take take aim take aim for pen——atraation
eddie bongsworth	My sentiment exactly fucking chocked this shit away like it wa EDP S cock on a Friday night
Devin Rendon	I wa hoping to see as and titty in this video
Mr. salty gumdrop	Dis is quality content right here lmao
JR	I m lmao at 2 22 to 2 25 he punch his bedroom door the next thing his dad in the background talk about cut it out or something like that he said lol
Sammy0071993	Go panther All game are rigged btw
Shawn Ferenczy	The only good thing about the bird having a bad season so far is you
Def G	Dude is legit dying watching football
Seth Evans	Cat doesn t know football except how to swear 😂😂😂😂
EatThosePastramiFries445	BlewA17 0Lead445
Morgan Walz	World of Warcraft freakout part 2
Nancy Pena’Cortez	I hope trump fry in hell That racist sexist mysogonistic orange man make me literally shake I ’ m literally shaking rn
Nair Johnson	ChokeThatGame445
Ryan Garcia	I ’ m mad of the eagle
Kevin Durant's Other Account	Yesss Let that hate flow thru you As soon a I saw the final score I raced over to YouTube to find the rant video
OGMillyMillz Vs Anybody	It ’ s 2018 and EDP still ha the TV with the VCR already installed in it 😂🤣
Brolygarcia 92	I knew this video is gon na pop out lol
rromeo 9	blowdatlead445
sirgigglez	Repeat
Leslie Jones	I use to be this guy You have to find a different outlet to express your anger man Going about it this way is only going to lead to an early grave
Volm22	Watching this a I come back from the eagle game and I feel so much better
Zionesify	The best rant EDP video are the one where he watch the game live
Jake Depriest	U just won a super bowl Fuck it If the raider won a super bowl id be happy for 10 yr
Atomspare	KeepPounding
To Pimp A Pharcyde	Lmaooo pause at 0 34
Tommy Bright	Who wan na put money in it over under EDP suffers a heart attack by week 12 send me your bet
Johnny Z	Why so mad you already said the season wa over And Why is it on the D your offense cant do shit
Rodney Gilmore Jr	10 02 He ’ s done EDP you need your hand
Malik Wright	I just realized edp445 look like fletcher cox 😂😂😂
Inf Know	Felipe gon na have to wear shade and lie to his co worker tomorrow about accidentally running into a door Hesaklutz445
Bear 7453	Panthers are my sleeper team this season to make a run in the playoff and Seattle
Trolln Yall	I honestly love watching eagle lose just for these video 😂
Michelle Quick	These fake outraged video whatever you want to call them aren ’ t working anymore Try letting Felipe slide into your bootypipe and record it
hanratty450	Your neighbor must love you
Adams Saenz	Breaking news EDP 445 dy because of an aneurysm
Cokeless Name	That reverse psych hype up during the video backfired on him😂😂
Dalton Deisler	You guy won a super bowl last year Fuck you
Dominic DeNaro	Ur misery make me so happy Cowboys nation
lilthothunter	Blowthelead445
GOAT GUZMAN	For the first time in 10 year I agree with edp am done with the eagle
Panthers Gaming	PANTHERS WIN WE WON THE GAME CAM IS THE GOAT
Luca DeAdam	Just when EDP s hairline wa looking like it wa gon na make a recovery smh my nigga EDP is gon na be bald by the end of the season
RetroEnvy	Was waiting for this
Mute Pepe	Eagles makin my boy bald 😨
Lex Zone-Six	Y all just won a super bowl
simm442010	Doug pederson said in the post game that the pressure is off That all I need to hear to for me to throw the towel in for this season They can dance and lose out I don t care anymore Redskins will win the east
Logan N	And how giant fan feel Eagles fan will never be happy
Donovan	LETS GOOOO KEEP POUNDING
postshanna	do you even enjoy football this is supposed to be fun bro it time for a new hobby lol
Musty Chicken	Blowthegame445
Plxiii Lul	Punchmydoor445
TakeAcTN	I stopped feeding my kid to watch this
Maximilion Pegasus	At least you ’ re not a saint fan
TheMayweather	think about how proud edp wa of his eagle when they were up 17 0
Black Koshinomi	He look like a angry bear in that thumbnail
Flazko	Nice choke job 😂 How you blow a 17 point lead
BJH 2112	I stopped watching lesbian interracial midget amputee necrobeastiality porn for this video
Hay H	You coming to the UK next week edp
Bucs Fan	Eagles are complete shit it hilarious
First Name	Eagleschoked445
Andrew Black	As a Panthers fan today wa a good day lol Time for my feel EDP video
E J A Y E	We fucking suck
Seargent AR-10	😂😂😂😂😂😂
Clamp Season18	Lmao eagle are trash just like their white trash fan
Black Skip Bayless	Been waiting for this
Tooperfect87	Cut cho hair nigga
Erik Gonzales	As soon a it wa 17 14 I knew we were in for a classic EDP video
Nick Bundren	KeepPounding
james cartex	Bruh is blood pressure is going to go through the roof
J Ski	Jim got a free Check an a ring he don ’ t give a dam
los ang	did his EBT not work why is he so pissed
Q Jones	Can we get an F for the door that EDP punched
Jacob Brown	Panthers take that W
KingVerbatim	DontWatchFootball445
Luke Noonan	Keep Pounding
WWF247	Lmao all jolly last week talking that bullshit and I called it His Bitch as gunna whine like usual 😂😂😂😂 LMFAO LMFAO LMFAO
APizzle90	IceDatHand445
Yaboiwooddyyy :p	Punch that wall 445
thegorn68	How do the neighbor never complain about all the yelling in the Section 8 apartment he life in
snackers401	This is more enjoyable than Baker s face
Polar Elite	We need EDP on the sideline for the eagle
BoiSam2092CrownRoyal	I m so fucking happy edp is back
Eagle Fanatic04	Did he forget we won the super bowl last year
bill mars	Thank god i had cam newton for my fantasy qb thank you edp
Kevin D	IM NOT GON F KING WATCH FOOTBALL UNTIL THEY GET BETTER
Hugo  Villalobos	This is the type of shit I subscribed for
Much Loser	Eagles going back to their old form faster than your receding hairline
Betelgeuse	GarbageAssTeam445
Emir Mutver	eagLes
MINsportspruduction	Lol
C00kecutter	How doe a team burn in hell Lmao
Day-me-in Moody	Edp445 is the arsenal fan tv of american football
Shoot kid	take a shot every time EDP curse
Akademiksthetypeofnigga	Nobodycanfuckingtackle445
NYG Joe	Panthers on some BS this year
john hoskins	Make it 3 13 This shit is why I don t pay for cable or Netflix
Nigel Verdell	Comebackfrom17 0 445
Anthony Yousif	Just watched my Bears lose I feel it edp
g0dlen	EDP on the brink of tear
Robert Fillis	KeepPounding 😜
treven douglas	EDPVsTheDoor
Cooper Quinn	High as blood pressure 445
Andrew Martinez	I think edp need to focus on getting laid now
no anime	He mad
Always 1906	eagle blew a 17 point lead at home eh well how about that
AJ Tubridy	SorryAssFuckingFaggot445
coach	Now you know how u bear fan felt on week 1
Daniel Gallagher	You are 100 balding because of football
The_V_Man Vaman1992	Soon a they lost I thought of you 🤣🤣
Evcham 21	This is so sad edp445 rip your sticker
Jay11	I love being a panther fan and watching this😂😂
Andres Nieto	As a dolphin fan we too blew a 17 point lead
Shane Harper	at least the 76ers and flyer won yesterday lol yea this season is a wrap
Vertigo Gaming	Hopefully that ’ s not your fapping hand
whatyouknowbout272	From a Panthers fan we may have won today but your team just got you a superbowl man I would trade 10 season of shit to get that superbowl 50 back Don ’ t be so hard on your team bro they came thru for you against the most hated team in the NFL
Tony	Lmaooooooo
Xavier Mitchell	Anybody got popcorn
Astroworld ?	This is the funniest comment section I have ever seen
Roboclops	I m getting off a tough loss to the Patriots right now Being a Bears fan suck too
Jeff Fisher	Fire Schwartz
Thanos B. Jordan	No more 28 3 joke for eagle fan ha
Pattersquach	It could be worse You could be a raider fan
AJ _	You d like them fried u fat fuck
Anthony Santiago	Eatdatblown17pointlead445
Jeffrey Abbey	Hahahaha Jags next Good thing you have a QB and the Jags don t But keeping my Giants alive Yessss C mon Giants
KdJ2	The title alone kill me I wa in tear throughout this whole thing
TLE0622 IPL	Clicked off red tube for this
Joaquin Ames	Got mad at an amber alert cuz they interrupted this video
DJ Tapia	“ Idgaf who is watching me outside they better get away from my window before I light this motherfucker up ”
allen withered	r u still fucking mad about u getting shot motherfucking 7 time
Jacrispaé	Poor guy just want his team to consistently do good
Nathan	Bringoutthefireball445
BUP	Trashdemeagles445
Andy Haywood	Imagine if he wa a bengal fan
Kmart Gaming	I thought he wa done after the Vikings Game
Brendan Kearney	2 10 for the 4th and 10 conversion
Scott Lutz	I am a Raiders fan and not an Eagles fan and yes my raider suck but unlike EDP 445 I am not the one saying I hate my team just because we Suck As a real fan I can be mad and disappointed in your team but if u are a real fan don ’ t be saying u hate your team or F them
Mohamad Mahmoud	Chill bro you won last year
Bob Cobb	just tackle him LOL
Dan Lutter	I wan na see his reaction video from the actual end of the game lol
LeGoat James	Blewthatlead445
Goatbrook	Fuck Count 498
Gabe Mac	Breakthathand445
zeefly226	I think you need to accept Jesus Christ a your Lord and Savior to control your anger issue
D Man26	Lmaoooo EDP why don ’ t you go play for eagle
Swagg_ Kidd	Lmaooo
Colin Bass	this is what it like to be a brown fan except multiply it by 100 and it every week
Kenneth Mann	I feel ya EDP the eagle r a total disappointment These nigga let me down every fucking week Our defense is complete shit how tf we blow a 17 point lead that ’ s fucking pathetic
Русская кукла _	EnjoyDatBloodPressure445
Pacers Nation	Clicked off my shrek hentai for this
Tony D	i wa waiting for this
Ish0and0shake	One hundred like and EDP release his full nude
The Philadelphia Eagles	😭
Nikola Radosavljevich	Your defense wa dancing in the huddle at the beginning of the 4th up 17 0 Wtf are they thinking
Hyperball	My nigga EDP s favourite word
RaineTCG	Taking football this seriously Pretty pathetic
Darxxxide	keeppounding
Speedy Gonzalez	Madassnigga445
Sebastian Gorley	2 37 is that seth rollins theme song
Henry Randolph	I want edp a the next cowboy head coach
H R	They need to put edp on that defensive line
BigSteveTW88fan	Sees Eagles blew 17 point lead Goes directly to EDP s channel
eaglesfan 4life	If your sick and tired of them then why not sell your gear and stuff if you really hate em
Wet Dreams	This is the EDP we all know and love
Justin Yummerz	Ya know EDP you can always be a Steelers fan you just have to be a little more relaxed
Legendary Winner	Fuckthatheroinbirdnigga445
PackManJake	Release Jalen Mills
MachineGunMike	2 27 Edp ’ s dad 😂
erdoganslustknabe	DatTeamTrash445
Controversial BM	U spoke it into existence keep saying they gon win watch they win next game
The Vol General	BlowDatLead445
MustangMalone	Brian give me my motherfuckin jar of Vaseline back my nigga You got me fucked up
Alex Tomczak	EaglesRtrash445
CallMeBeggar	Lol when the autumnal mead commercial came on
Admiral Drums	YOU ARE A FAKE ASS BITCH MY NIGGA YOU LOVE THEM WHEN THEY WIN BUT HATE THE EAGLES WHEN THEY LOSE THAT S WHAT A FAKE ASS FAN IS YOU BITCH DOES YOUR MOMMY OR DADDY YELL AT YOU WHEN YOU MAKE YOUR FAKE ASS VIDEOS IN YOUR ROOM MOVE OUT OF MOMMY AND DADDY S HOUSE DUDE IT S PATHETIC
Damon Smith	Cowboynation445
NOVA NEBULA	LMAO
OPG SELLOUT	Waab
jordan cook	17 0
Blake Bandz	I came here to make myself feel better after the worst lost in eagle history
Matthew Campbell	the goat
Deion Moore	This is beautiful
Trae Day	NobodyCanFuckingTackle445
xKing_At_Birth x	I wa so mad until we got the ball back 14 17 and I knew it wa destined to be a dub keepounding
Richard Waldrup	Nobody can tackle at 2 21 then go off LMAO
tr900 -	HEARING EDP SCREAM WHILE COMMERCIALS IS PLAYING IN THE BACKGROUND
CDZ NUTZZZ	AND THE EAGLES FANS THOUGHT THEY WERE GOING TO THE SB AFTER THAT GIANTS BLOW OUT WIN LMAOO
Tyrone Rule Jr	Lmao edp crack me up
_iYogurtSlinger_	Last time I wa this early Unknown Person had Sammy GG in his mouth Lulz WorkedFaggot
Black Sloth	Fat no pussy gettin nigga
Lil Cuzi Vert	Did anybody else wait for this video after they saw the eagle blow a 17 point lead
Mark Marton	Oh for god sake EDP445 stop hating your fucking team I m sick and fucking tired of you keep saying FUCK THIS TEAM SUCKS EDP445 for the last time Calm the fuck down Oh and by the way EDP fuck you
Jake Hemmerick	Lol I saw the Eagles score I went straight to YouTube just to have weekend made
Succ	DOUBLE UPLOAD Pog
Joesph Stalin	This is epic victoryroyale
theycallme_oj	As a panther fan this is truly the greatest icing on a cake after a win
Ted Geracie	Bahahahahhahahahahaha
Amir	I thought we wa gon na lose I turned that game off
control ALT delete	Don t lie EDP your fist is sore from beating off not from punching the wall
That Egulls boy	How ha EDP not destroyed his throat yet with the yelling and deepthroating of object
IceWater714	I wa so waiting for this D D D
Fluffkinn_wit No_Hairline	EaglesWorseThanMyHairline445
The Reel Bill Seigel	I fuckin hate this team
svega24	Its the secondary mate
Paolucci Talks	Anyone else notice when edp take a step it put so much pressure on the ground it cause the camera to refocus
kcskateee crowder	I almost clicked on another video then I saw the goat
James Silver	Get a punching bag
Jordan A	Here before it get age restricted
im bored	God bless the panther
tweezerjam34	This one on Doug Pederson The 4th quarter play calling wa awful This one sting
Everybody's Uncle	10 22 EDP is a flat universer
Blindfold Gang	Yup EDP is back
Dude Feysh	Get verified on twitter already
helicopter weewee	Season s pretty much over Time to start cheering the Chiefs I think
porkytm	Lmfaoo this wa better than I expected 😂😂😂
LAZY GOD	The only thing that could top this video is EDP s dad asking for Vaseline mid video
Incognito Latino	eagle looking like atlanta out here
Russian Old Spice	HTTR
ASC Eagleman	Jim is too DAMN conservative He refuse to blitz and it s so frustrating to watch Plays too much zone and ha the the CB s line up way too far back If you wan na beat the eagle just throw over 10 yard every time they can t STOP IT
EH M	Couldn ’ t wait for this 😂😂😂😂🖕
derrick megown	Been saying that Doug get a lead and love to sit on it He start running play that stay at the line of scrimmage instead of letting Wentz do what got u the lead to put them away
Xairic	Hell not real just burn em yourself
Creeper 198	Well he predicted it they Lost 21 17 at least they blew a 17 0 Lead
Aaron Scruggs	At least it wasn t 28 3😂😂😂
StoneColdReznov	He back
War Winner	Firejimschwartz445
FitWorldExposed	I ’ m thinkin about gettin yo pop some Vaseline for Christmas
lol hey	When I wa watching this game I wa just happy to know that edp would make another video😂😂😂
Johnathon Pomerlee	Edo bout tomorrow turn to a cowboy fan in a min
Ultra17	This is what I subscribed for
toomuchsauce	EaglesFryInHell445
Carti Plugg	Imagine EDP being a Browns or Bills fan or something lmaoo
HereIsWisdom 1318	Someone tell this fatboy they just won the Superbowl If i wa an eagle fan id be happing 3 decade when they won the SB
Detroit-vs-Everybody	I ’ ve been refreshing YouTube since the game ended
danthetrainman56	im more disgusted that the deflatriots won
xXExxolasXx xXExxolasXx	Says the one looking like oldmanjenkins445
Prime.	l don t know what s better the W or this
Kai	I WAS WAITING FOR THIS LMAO
Jesus Perez	You tell them EDP I would rather have you a their coach 👌
JustJasperrr	kept pounding that eagle as bitch hahahaha Keeppounding 💙💙
JmsEdits	Least y ’ all better than the bill
Matt Williams	Brokemysuperbowlmemorabilia445
Lebron James	We had a 17 0 lead until the 4TH Quarter and somehow once again blow it 21 17 😒😒😒
Grioh	wa waiting for this😇😇😇😇
Mordecai The Awesome Bluejay #PuppetMaster	mentally ill black man throw a rage fit over a football game
Daniel Zapata	Never refreshed a page so much in my life BlowThatLead445
Yes123	Fuck this team
Ronnie Collier Collier II	Worst defending super bowl in the history of NFL
Honey Badger	I feel the same way for the Bears a they made to many mistake on special team Secondary and Mitch Tribisky who threw too many goddamn over throwed pass and these Bum as Recievers can t catch like the ball is on fire excluding Trey Burton Fucking too many mistake against the Patriots THE FUCKING PATRIOTS THIS AIN T YOUR AVERAGE JOE TEAM LIKE THE BEARS TREATED THEM THROUGHOUT THE 2ND HALF
Cristian Arteaga	I don ’ t see the Raiders making the playoff in the next 10 year with Jon Gruden
Yikes Jungkook	the thumbnail 💀💀
Derian Hurless	Blowthatlead445
The Goat	I hung up on my girl just to watch this
Sir Spookii	I saw the ending of the game and I just started waiting lol
Otaku Tester	Chokedatlead445 coming back at yal trollin no life mothafuckers with another god damn L
drunk Squidward	Thumbnail got me dead XD
CardinalSin21	Honestly I enjoy seeing the eagle lose only cause you know EDP is gon na lose it lmao
Sean Rideaux	He had Smallwood in the flat and got greedy and forced it to Jeffries on 3rd down
jack joannides	EDP become a giant fan If you did you might have to hurt yourself
RegularArc	My panther won and I get a good edp video let ’ s go
GT: EmeraldRepublic	I actually agree with him Eagles are trash this season There is no hope
SteeleWorldWide2	Malt Liquor
t1sp	FUCK JIM SCHWARTZ AND JALEN MILLS HOLY FUCK FIX THIS TEAM
RobertHall85	SmashDatTV445
Lazaro Chairez	I nominate edp445 a eagle coach
friendlynicemail	OH the SUFFERING
lucifer	LOL SO THEY WIN THE SUPER BOWl AND NOW HE IS A FAN LMFAOOOOOO
Ghost_Fazbear	I ve never been so anxious for an upload
Giants1995	This dude is on suicide watch every season
Brandon Bohn	burninhell445
georgearrivals	damn you managed to pull a giant lmfao
OrangePinaple 1736	Came on youtube this the first thing i see i couldn t stop laughing
Wakkoz	EDP prolly want to smash the TV screen a hard a he clapped Felipe s cheek 😂😂😂💀
Observed Germ	😂😂😂
Dan Saeed	I have NEVER clicked on a video so fast
MyFly 713	thats why you got ta join pat nation
The Engie That Cried Nope	This ought to be good
The Alkemist Official	He seems kinda angry
Deez Nutz On yo chin	Knewitwascoming445
Crow.	EDP about to go to flood all the toilet at Lincoln financial field for this
BonelessDean69	Eagle is trash a hell man they blow lead like a MF and I don t even watch football
Wentzipaul	I ’ m gon na be frying in hell after killing myself
The Film Freak	These are the day I live for
Jonmetal 96	EDP s hairline receding a each loss happens
ZelGoesHard	FrenchFriesinHell445
yung professional	lmao ur eagle got beat like my meat
Phantom McCoy	2019 Philadelphia Eagles Head Coach EDP445
Fernie Ortiz	lmfao I ve been waiting for this video 😂😂😂😂😂😂😂😂😂
Kendall Fire	LMAOOOOO GG Eagles blew a 17 point lead btw
IronicPlague	Pretty much me a a raider fan this season
Todd Gack	Instant classic lol
Ash Sixx	Karma is undefeated You get what you deserved you spoiled as fraud piece of shit
Stefano Dal Vecchio	DAMN
Fluffy Bunny	I feel like I can no longer make fun of Falcons fan
AyOxImCarrying x2	Thumbnail speaks 1000 word lol
Donald Sterling	Eagles blew a lead like EDP still blow Nitrofreak on the DL
OG Kusherton	I knew it wa coming any minute now
Jarvis Landry #14Hunnit #Landreezy #Juice	Jags finna clap the Eagles cheek next week like how edp clap Felipe cheek
EDP's Nephew	Never clicked fast enough to uncle bryants rant time
RCM b	I stopped beating off to Brutal Anal Pounding just so I can peep this bullshit as video
Erik the WWE & Anime fan	EDP v Dad ll
Lil TAY #YungestFlexaUfDaCentery	Even when the Eagles win they ’ re as
glph music	I m a Panthers fan and I knew you d react to this bruh I wa just sitting here like Damn I know my nigga EDP mad af
travelers light	I wanted them to lose so bad 😂
Connor	Who else ha been waiting
gustavo martinez	What happened to Area 51 did you get fired
Sodaboy1996	Your hairline is 4th and inch
Jeff DiBernardo	At least your team wasn t stopped 1 yd short on a hail mary from tying the game
Eman Plummer	Man i wa so happy the eagle choked because of the incoming edp rant
JaniSWFC	BlewDat17 0Lead445
Garpod	I ’ d slap ur as low key no homo
Winston The Gorilla	EaglesBlew17 0445
Alex M	LMAO 17 0 AND the Panthers scored 3 TD in the 4th😂😂😂
Divine_Wrath	Could be worse At least you guy won a SuperBowl I ll probably never see the Lions win one in my life
Tobias	YellingAtMillionaires445
GO AGANE	been refreshing my feed for this
Waveface killah	Cam newton the goat
Peter Dunbar	Welcome to EDP445 s best reaction video Seeing Eagles collapse and his reaction live wa better than another season of Breaking Bad
Tyler Garcia	FryingFriesAtLeos445
Martin Conta Gets Banned	😂😂😂
TheMoistMarshmallow	I wa waiting for this 💀💀💀💀💀
Dane	BreakMyShit445
Craig king	I wa waiting 😵😂😂😂😂
PHW Gamer	Evan thorntans arsehole
A random ass weeb	17 0
King baker Mayfield	Bears fan where ya at WE WERE STOPPED AT THE FUCKING 1
TakeFlight89	Uploaded 3 minute ago Already 1 5k view
C-Town Beats	At least u ain ’ t a bear fan we got stopped 1 yard short smh
Dbomb 12	Highblooddpressure445
SUPER JUICE	I WAS WAITING FOR THIS NOTIFICATION
Austin Talks	Haha KEEP POUNDING
ILikeTheCubs	Eagles lost and Patriots win Words EDP hate to hear
barcalona55	2 18 You ’ re welcome ReversePsychology445
Big Jordan	Panthers fan who wa waiting for this
Mark L	Music to our ear
Pavel Mamboleo	Ahh this is why I root against the bird 😂😂
DaMeeK32	17 0 FUCK
Joey Durning	His blood pressure is through the stratosphere
eviltwinnumber2	Everybody flock here fast af when the eagle lose lmaoooo
Sonic Mania	Why you always negative towards this time 💀
Aleks Melys	Aw sensitive much 2018 eagle suck deal with it
Stevie Jr Is a Kevin Durant guy	Philadelphia eagle are totally garbage 😄😄😄😄 Hold your L
Chad Warden	Edp bouta go on a toilet flooding rage
MemeGod	God Bless EDP
Tariq Johnson	ITS HERE OMG THE VIDEO FROM THE HEAVENS
Go Eagles	This game really really show we aren ’ t very going anywhere far this year Inexcusable collapse on defense the last 3 dry and horrible game management at the end of the game
KingToro	Eagles blew a 17 0 lead
Doge Doge	Chokeadelia
The Prince	We whooped that ass😂😂😂
lafnotfamous	😂😂😂😂😂😂
Mike Hawk	LMFAOOOO Eagles blew a 17 point lead
Devin Garcia	Was waiting for this Don t worry dude you all just won the Super Bowl last year chill 😂
Truth Army	ChopThatBitchOff445
Carter Miller	Fuck Jim Schwartz
emisoccer •	I ’ ve been waiting
Michael Peterson	Gracious the title😩
Memphis Wilson	I feel bad for Wentz lmao this team is a disgrace
rett Audorff	At least you got a ring Chill
Joe Romero	I agree they blew this game big time they let off the gas to early
darin_ the_loser	He s talking about the fake eagle team fyi
mav stevens	when the eagle choke and lose a close game and edp make a rant video from area 51 when he at his house ranting
- DLBJ-	Cam ohhh Cammmm
Jason	Sup fatboi
Darien Espiritu	Enjoy this L fat boy
jack xo	who else want edp to livestream him watching the game live
Sam Is Alive	LearnToPlay445
GrizzlyScalp950	No excuse literally gave it away like chump Four quarter in a football game eagle play all of them not three and prance about and wither away in the fourth
SilentMoist Games	eaglols
Andy Johnson	Waiting so long for this
Henry Friedman	I wa rooting for the Panthers more than my favorite team this week for this reason
Ted Nugent	This is beautiful watching his meltdown
Blurryface|-/	And the Patriots won hahaha today is a GREAT DAY
Turn Down For Watt	FryInHell445
Ziryuri	I Hope EDP don ’ t have a thicc nigga heart attack because of some dumb shit 445
drewbacca26	ThreeUnansweredTouchdowns445
MGamez2	His video title kill me
Xaviar Bruce	L haha blew a 17 0 lead
James Burke	Lmao
Pepsi Man	Refs bailed out the Eagles and Still lost
GreenGaboon	Honestly i can relate to edp a an eagle fan
Smooth J360	I agree with you about Schwartz EDP this game wa some Bullshit
Hunter WB	Did they not just win the Super Bowl
Joshua Aguilar	big as mood BROOO
Victor Moore	I clicked on that notification so fast
Ragada Blaze	Was waiting for this 😂
You Smell Me ?	I feel like I ’ m frying in hell everytime you take a meanass shit Bryant Daddy445
Sebastian Perez	Stopped watching Lisa Ann for this
Mike Rowe	I BEEEEN WAITING FOR THIIISIISSIISSIIIISSSSSSSSSS GO PANTHERS BABY WOOOOOOOOO
Boogz	bahaahahahah
RagingGamer2128	That stubborn as should shove the Vaseline up his as
Varson 188	FriesInHell445
Monkeyman32	HERE WE GO
DBZMut	These rant man Lol my team almost lost to the brown so i really couldn ’ t talk
The MAGA Way	Donald Trump the BEST President the US ha ever seen Don t me
Fuck Gatorade bottles	ahahahaha gahteeeeemm ah good time
Rhys Syhr904	EatThatPantherCock445
DillonJacksonTv	LETS GOOO
Lucas Lopez	Keep pounding lmao
Kevin Fletcher	I knew we were boutta get some EDP heat once the game ended🤣
Jalenmillsisgarbage 81	Weplaypreventcuzwethinkwe vealreadywon445
ImmaLetUFinish	Lmao take that fat panther cock
Shane Edwards	oof
A Good fella	Lmao I clicked on this shit so fast Fuck live streaming my grandma funeral Blowthat17pointlead445
Caymien Davis	Yes sir EDP sorry we had to do it to ya😈
Rey Perez	Here before EDP break his TV
Captainchita456	LMFAOOOO
Kay Kutta	Eagles can ’ t win every game lol
PhillySortsFan46	Givedatgameaway445
Connor Marston	Was waiting for this Yesssssssss
Barnaby Blackman	Being waiting for this video all day lmaoooo 😂😂😂😂 EDP bout to murder some toilet
Dario Diaz	Was waiting for this to come out
Randy Moss	Eatdatautism445
Dank Hill	ThisTeamFuckingSucks445
Michael	GoingToCommitToasterBath445
Merse	Edp blood pressure is too high rn
Caleb Williams	3rd
Atikatikata	They choked
A8_Onex	All I have to say is😂
BigGame Hunter	I ’ ve been refreshing my sub page waiting for this
UnderratedCollegePlayers	The video we ’ ve all been waiting for the second this game ended 💀
Depression Session	And then there wa the Browns game
B Lou's Lighter	DeepFriedEagles445
Jordan Todd	Oof
Cole Smith	Boy this finna be a good video the only good thing about today
The Progressive Voice	Classic reverse psychology
Buffalo Gaming	I wa so ready for this lmao
Brad Hoover	Dad
Hoodie Eric	Givethefuckinggameaway445
nathan scott	Omg edp ur soo hot please fuck my sissy as
RADATTI&SONS J	You called it smh 🤬🤬🤬
Richard Prescott	I m happy
JT Golden	Never clicked so fast 💨
K12SEA	Been waiting for this vid all day
Dylan C.	Oh fuck
jameskevinemma	This ha not been ur week
Conor McGregor	yes i have been waiting for this 😂😂
Yung Bado	Bro got his channel back
PhinsFan 72	It s time
Julian Shipp J.R.	Clicked off porn hub for this
Andrew LaFever	Lmao
Apollo	Saddd
dominick costagliola	First
Baby shark do doo do do doo	Eagles blew a 17 0 lead
User Name	Fryinhell445
Deshean Jackson	Fries
Christian Alexander the Great	Foles Wentz
I’m a roblox pleb	Hahahahahahahhahahahahahaahhaha
How bout Tree Fiddy	17 0 loleagles
Jvse	BEEN WAITING FOR THIS ALL DAY
falloutmaster233	It wouldn ’ t surprise me if EDP and Felipe did a drive by on the Eagles Team Bus
jda swisha	2nd
Riley White	Forst
The1andonly 803	😭😭😭😭😭😭
Some User	Nice
ChiefsRaysBolts	Second
Samuel Delgado	Yessss the goat is back
Bob Melvin	First
