Troy Crith ll	Thanks
Gary Krank	Shit for brains.  SAD!!!!!
Edgar Cardenas	#$soon arrest cardi b for murder  in santa barabara ca 805
KossoffFan	He should always speak with the Rolling Stones music in the background.
muzak1861	He can prevent the Caravan from coming into the US by simply holding a rally in Mexico, in a arena holding unto 10,000 people. Tell the story of invading ones own house and how an invitation is required. make a speech about how to make their own countries greater. We can provide some training in their home countries and make asylum seeking possible from their home countries instead of marching to boarders. We should allow no one to simply cross our boarder without PRIOR invitation. We should position out Military on Mexican soil and inform Mexico this is not an invasion but a preemptive precaution to deter mass migration now and in the future. Either Mexico defends their boarder or we must defend our own and not allow immigrants to cross into US Territory by staging troops in Mexico.
American Fish	Mushroom cock!!!!!
Dave Hernandez	Please send army to stop invaders with bad intentions from the south
Gentle Mountain	Six Mexican police injured and yet these people are what --- the oppressed? Give me a break.
ddknyc	What is that background music is the lefties creating  raucous so we can't hear our President?
Babies in a Playpen	Who does he pay to check his shoes for toilet paper?
cream pie	i would vote red but i do not like the satan's color 😈👿👹 blue all the way.
ammar hello victorious	We love you ❤️❤️❤️🇺🇸🇺🇸🇺🇸❤️❤️🇺🇸🇺🇸❤️🇺🇸🇺🇸❤️🇺🇸❤️
Dana Falcone	India minacce con la China 👊😈👊😈👊😈👊😈👊😈
huduman	Looks like Mexico might be assisting the invaders again. Maybe our border security should be part of the trade deal.
NanL Phillips	Instead of giving Honduras a billion dollars a year it might be wise to provide food & medical supplies/care & birth control. Thank you stopping the US from becoming the world's ATM machine.
Wectum Wecker	Wish a sniper would take this clown out.
Soviet vape King	Red wave my sweet comrades
D Me	I'd be a happy assed American to see him get to the top of the steps, trip over his teeny little feet, flip over the side, & crash-land on the tarmac, right onto his bulbous, empty, disgusting head. There wouldn't be any messy brain matter, bcuz...well, he doesn't have one. That would be really nice.
Daniel Mount	Ya! These Bad people are our Democrats in Washington DC.
Jim Beam	Finally a President with some Balls.
overtcovert	Keep the 7,000 invaders OUT!
amarjeet chimni	TO    HON'BLE     PRESIDENT    =    MAGISTRATE     BROKE  MY  BONE  AND  PUT  ME  IN  JAIL    IN  FALSE  CASE=    EXHAUSTED  ALL    REMEDIES  IN  INDIA-      PRAY  REFER  HUMAN  RIGHTS    =INDIA
ron hanish	A G E rangers hanging out in the truck ...hahahahha
Johann Greyling	nobody knows somebody knows... you gotto love him!!!!
Bk Hodges	Yeah; I have a teny tiny dick.
Sky Sinclair	PLEEEEEZZZZZZEEEEEE folks, let's vote the democrats out of office. They'll ruin our country if allowed to take the house and worse, elect a another democrat president!  OH GOD!  HELP US!!  Sky Sinclair
Mary Jusczak	I do believe killary and her crownies r behind the caravan of immegrants how r they getting g water and food
Emily Worel	So in Texas... LAREDO, Texas – The driver of the white Dodge Ram pickup truck circled the San Bernardo neighborhood, seeking his next prey.  The man pulled up next to Stephany Gonzalez, a sex worker on the strip, as she walked with her friend, Nikki Enriquez. He rolled down the window.  “How much?” he asked Gonzalez, 25.  Gonzalez had a bad feeling. Two of her good friends, also sex workers, were recently found dead with gunshot wounds to the head on rural roads outside Laredo. She was hoping for a client that night but felt uneasy by the nervous-sounding driver. She tightened her grip around a pocketknife she held under her shirt.  “I’m not working,” she lied. Her friend, Enriquez, a 28-year-old transgender woman known to many of her friends as Janelle, got into the truck instead. It was the last time Gonzalez saw her alive.  That night was the beginning of the end of a 12-day killing spree last month that claimed four women and rattled this normally quiet border city. Enriquez was the last of four women who authorities said were murdered by Juan David Ortiz, a 10-year veteran of the U.S. Border Patrol.  Law enforcement officials are still gathering all the evidence in the killings. Isidro Alaniz, district attorney for Webb and Zapata counties, said earlier this month a murder indictment for Ortiz will likely be filed in December. Ortiz, 35, who was arrested hours after his encounter with Gonzalez, allegedly confessed to the killings. He’s being held at Webb County Jail on $2.5 million bond on murder and aggravated assault charges.  Ortiz’s court-appointed attorney, Joey Tellez, released a short statement three days after his client's arrest. Tellez did not respond to several requests for comment. ..... Government is to take these sex related crimes SERIOUSLY..  It is not only just an attack on a individual but an attack on the the entire community! The message you are to give is that THERE IS NO ROOM OR PLACE IN THE COMMUNITY FOR THESE ACTS!!
Thomas Norton	You listen to the rally it's just like the one before in the one before the problem is is when you fact-check what little he gives you it's lies and then when he mocks people that's all you're getting is mocking putting the other guy down typical narcissistic Behavior he has no argument and why he's doing good so he has to make the other guy look bad you realize don't you that the economy in the unemployment are because of Barack Obama's policies Trump had nothing to do with that and you would think he would give credit to somebody not in the slightest he's taking credit for Barack Obama's policies that are taking a hold right now policies that have been set in Barack Obama's first term that's why it takes so long to get up and running so if you look at the time frame Trump had no time to do anything and he didn't but the few things he did stick his hands in he messed up like North Korea like Israel like Putin like NATO like the tariffs and now the climate Summit that's why when he started to brag about all the good he's doing the UN committee laughed because there no Hillbillies from the Midwest that don't know any better these are actual educated people who do this for a living watching the world and we all know me for one been watching them 47 years lie cheat and steal hurt people just for the simple fact that he's at because he's able to he's a piece of shit he's a man of no honor in fact he's not even a man he's never done anything a man is called on to do like have a job or serve his country he still a mollycoddled little boy who's never cross that right of passage into manhood
AUDIOHOSTEM187	Should Mr. TRUMP's Luck Run High Enough To Reach The Treasure Of A Second Term Without Impeach To Purchase More Time With A Written Speech Wrought Of Lies And Propaganda To Put The Masses At Ease? - [ IMPEACH 45 ]
GlobalistsR Traitors	So how is the Suggester In Chief going to deal with this new caravan invasion force?
david s	Im hearing judge jeanine is 1 of the women for ambassodor. I love it another tax cut
sound force	USA & POTUS TRUMP build military bases along the boarder & give them mp status to prevent illegal entries thats a solution :)
L H	☰☰ *yes build that wall* ☰☰
Viviana Lara	Lol who was blasting eye of the tiger?
No to global eternal satellite legitimization	Did the DOD set up a war powers debate on top of an existing unacknowledged military platform with this caravan?
Tim Xoque	At the beginning of the video you hear brown sugar.  Let's review the lyrics shall we?  Gold Coast slave ship bound for cotton fields. Sold in the market down in New Orleans. Scarred old slaver knows he's doin' all right. Hear him whip the women just around midnight.    Brown Sugar, how come you taste so good Brown Sugar, just like a young girl should
oath keeper	Weather is so predictable when the government controls it like every weekend clear and hot as fuck than Monday is filled with fake layers or man made cloud cover
Louie 2020	The Caravan is a plot made by Satan Generals here on earth Hillary and George Soros, same thing Soros did in Europe with Millions of Muslims from Syria . like Trump said is a Man Made Caravan to make Trump look bad, is Not going Too work.
Raz Ram	America is just buying time before the collapse
Wayne Brinker	Fat cunt
Jason Bourne	The Eye of the Tiger, Baby.
Mcg Doc	Schmacky Schumer and Commie Possoly will be responsible for this attack on our border! They are the causes of current chaos and leaders of the socialist mob!
Zelda London Oghigian	I am waiting for a specialized Donald Trump version of the American flag: one that is a gold glitter version. I think it should represent Jesus' glory that is gold/amber like in the Book of Ezekiel. And to also represent His sacrifice in Isaiah Chapter 53, through the stripes on our flag, that it represents His back being lashed with stripes, that through the stripes of blood on His back, we are healed.
JoeAceJR	Law and order Guns for everyone except criminals Beer won't go into my mouth Trump 2020 Qotus is Melania Trump I am a conservative vegan All illegal immigrants should be deported Pence 2024 and 2028 Kanye West is fucking awesome
darkside da hanged clown	a statement at a statement huh? cool beans
Johnny Wooten	No one Stan's a chance against this man Trump 2020!!!
Rick Martin	Lies daily to the American citizen.
domtron88	Im 30 and I've been apolitical all my life and I've never voted.  If Mr. President decides to run for a 2nd term, you better believe I'm going to vote for him in 2020. #MAGA
Angela Cobb	Home u stop this home invasion on our back door
bodyworks20102014	Trump totally overwhelmingly trumps the MSM. Where the most complex and important issues are concerned, Trump simplifies it down to the simplest, clearest, most concise, possible terms, but no simpler, and leaves the MSM shell shocked and mumbling, with no verbal recourse.
Credence Clementine	MAGA!!!!
Bill Dewahl	WWG1WGA
Kira de La Rochefoucauld	STOP THE MIGRANT INVASION!!!
W TF?	Trump is fighting for all American people!
Love Roscoe	“Alerted” is very different than “done,” Sir. No wonder both “sides” like early voting. Feeling betrayed.
NorthShoreMoana	Mr. President, shut down our border. No Illegal alien getting in. Mexico complicit. They opened the gate to let them in and giving them safe passage through mexico.  As rude, demanding and destructive as they are why would we want them here? Do not even let the women/ kids in. They are third world hardcore people.  Take the Aid that would be wasted on all those countries and build our wall with it. The US taxpayers should not be forced to prop up other countries economies.  It's time to cut off welfare/jobs to all illegals and start mass deportations.  No illegal deserves to be in the country when millions of others have done it the right way and waited their turn.
Stan M	He is such a humble man no one listens to him anymore...
Jack Jack	TRUMP...DO NOT LET UP ON CALIFORNIA FOR THE FIRES AND POLLUTION..I am in IDAHO..when you come here as you fly over just look at how bad our air is...300 days per year we have BAD Air..the morons reporting air quality do not report the truth..just look with your own eyes and you will see...our mnt ranges cannot be seen on most days of the year...its like hong kong here...most of it is from California
Douglas Steele	trumps statements aren't worth listening to. he lies and slanders 98% of the time and then pats himself on the back. how can you believe somebody that lied 4,229 times his first year in office? answer-you can't. lets get this lying low down ass wipe of a president impeached and MAPA-Make America Proud Again!!!
Pamela Gater	Mexico and the UN have bused in 8 buses Saturday 1am headed to Yuma AZ we seen them.
MrFurling	Russia will nuke, bomb and kill, the corrupt U.S government and it terrorists elites!
Dino Pulizzi	10-21-18  Northern Ohio  4:09   (Dan Williams)       God Bless you President Trump !
Tom Korte	Khashoggi wasn't really a journalist, he was a bad actor aligned with Turkey and Iran.  The Left is using the fact that he wrote a few columns in the Washington Post to call him a journalist so that they can use the issue to drive a wedge between Saudi Arabia and the US.  MBS is pushing reforms in Saudi Arabia and the hard liners don't like it at all so they want to damage him.
A Lopez	There he is everyone, our moron and Chief. A man baby with a hooker wife. He even calls his wife a horse face. And she doesn't even care, do you? Shut the eff up little mushroom head.
David M	GOD BLESS TRUMP!!!!!!!!!!!!!!!!!
Chris Conavay	God, I love that man
brian stuart	don't worry about the journalist make the deal make the money and piss on him he shouldn't have been there in the first place
Global Watcher	It would be great if President Trump Delivers A Statement on Gmo Engineering ie: Chemtrails stopped period & 5G as they are destroying the planet & Ozone layer with there weather weapons, have these governments no respect for humanity at all now while they on their power trips?#. to many actors?
Tim McClymont	Thank you Mr. President for continuing to elude to George Soros as the source of our migrant troubles.
bw1988	Increasingly the Democrats look crazy
88Gibson LesPaul	Where's he off to....golfing or a rally? Just whatever or wherever, as long as he doesn't have to work for a living. He never has. Why start now?
JSG1138	*TRUMP IF YOU DON'T DO SOMETHING ABOUT THE CARAVAN, THEN YOU ARE USELESS TO US! TIME TO PUT UP OR SHUT UP! DROP LEAFLETS! USE FORCE!  IF YOU CANNOT OR WILL NOT DEFEND US FROM INVASION THEN WE DONT NEED a GOVERNMENT OR MILITARY! IS OUR BLOOD AND TREASURE ONLY FOR OTHER COUNTRIES?!*
luomio	Repeal the 17th amendment to bring power back to the states!
Tim Coombs	It's fun to watch him lie in real time. "The new tax cut is for middle income people. The last one was for middle income people too, but this one is really for middle income people."
organicsuperman	the first real American president since JFK !
G W	AP reported a man from California with the group, People Without Borders, was with the caravan and arrested by Mexican police.
MOODY V.	I love this president and first lady thank you Sir for bringing back are country
google sucks	About time we bring our own, best of the best military in the world to defend our own territories. for once. Get them over there ASAP
Ken Chung	Over the past many years, US and South Korea stood together strongly as established a strong blood-alliance. Under this strong established alliance and foundation, our 2 countries together were able to improve security, trade, and exchange of human goodwill. But north Korea's  dictator Kim and current leftist Moon's followers continuously disturb and provoke. Moon's regime is creating fake news and has been feeding people propaganda that promotes anti-America sentiment. Moon and his regime's key members are very dangerous and are anti-American.
Ricardo Muniz	EYE OF THE TIGER 🐯
3S4EVR	We need you alive MR. PRESIDENT PLEASE TAKE A REST AND A FAST TO REJUVENATE!
capital punishment	Trump you let them in.next term you won't win.show us some hope.stop illegal imigration.
Dan C.	President Trump just said "we're looking at a MAJOR tax cut for middle income people" !! ... love this man , and he loves us , oh yeah he is a great president for our country and for all of us !!!
Steven L	The caravan is M13 and Democrate reinforcements and new recruirts.....  .They are coming soon to pay visit  to Joy of The View Beto ;Maxis; Kimala; Pelosi etc and camp in Demcrates houses ...and  knock on the OFFICES OF  MNBC and CNN
Mary Mccarson	if you're the most powerful man in the world you should have been able to stop them already.....maybe you don't really want to.....and if you are going to just let them in hell we may as well not even vote.....
Imperator Victix.	The socialists and communists of the left have become completely unhinged, Trump Derangement Sydrome is seriously disturbing they dont even listen to facts, theyre completely psychotic.
Joe Blow	Mr president WHAT are you going to do at the boarder?
Joanne Mercader	Thank you so much for this directly from the President Donald Trump.
Michelle Pannell	Trump is a no-nonsense kind of President.
Kibby Tzlil	Peace be unto you Peace be multiplied unto you שלום ושלום  The Lord answered and said to his people Behold I am sending to you grain wine and oil and you will be satisfied and I will no more make you a reproach among the nations  Be glad O children of Zion and rejoice in the Lord your God for he has given the early rain for your vindication he has poured down for you abundant rain the early and the latter rain as before  The threshing floors shall be full of grain the vats shall overflow with wine and oil  You water its furrows abundantly settling its ridges softening it with showers and blessing its growth You crown the year with your bounty your wagon tracks overflow with abundance  Love and faithfulness meet together righteousness and peace kiss each other Faithfulness springs forth from the earth and righteousness looks down from heaven The Lord will indeed give what is good and our land will yield its harvest Righteousness goes before him and prepares the way for his steps  The Lord bless thee and keep thee The Lord make his face shine upon thee and be gracious unto thee The Lord lift up his countenance upon thee and give thee peace  America The Great The Bold The Beautiful my beloved my sweet Uncle Donald John Trump and my sweet First Lady Melania Trump:):) The LORD God bless you America The Great The Bold The Beautiful my beloved my sweet Uncle Michael Richard Pence and my sweet Lady Sister Karen Sue Pence:):) The LORD God bless you America The Great The Bold The Beautiful my beloved my sweet Uncle Michael Richard Pompeo:):) The LORD God bless you America The Great The Bold The Beautiful my beloved my sweet Uncle John Robert Bolton:):) The LORD God bless you America The Great The Bold The Beautiful my beloved my sweet Uncle Dean Arthur Heller:):) The LORD God bless you America The Great The Bold The Beautiful my beloved my sweet Uncle Adam:):) The LORD God bless you America The Great The Bold The Beautiful my beloved my sweet Uncle John:):) The LORD God bless you America The Great The Bold The Beautiful my beloved my sweet Uncle Senate:):) The LORD God bless you America The Great The Bold The Beautiful my beloved my sweet Uncle Brett Michael Kavanaugh:):) The LORD God bless you America The Great The Bold The Beautiful my beloved my sweet Uncle Charles Ellis Chuck Schumer:):) The LORD God bless you America The Great The Bold The Beautiful my beloved my sweet Uncle ABC:):) The LORD God bless you America The Great The Bold The Beautiful my beloved my sweet Sister Madam Nancy Patricia D'Alesandro Pelosi:):) The LORD God bless you America The Great The Bold The Beautiful my beloved my sweet Sister Madam Elizabeth Ann Warren:):) The LORD God bless you America The Great The Bold The Beautiful my beloved my sweet Uncle Kevin Patrick Brady:):) The LORD God bless you America The Great The Bold The Beautiful my beloved my sweet Uncle Paul Davis Ryan Jr.:):) The LORD God bless you America The Great The Bold The Beautiful my beloved my sweet Uncle Senate:):) The LORD God bless you America The Great The Bold The Beautiful my beloved my sweet Uncle Brett Michael Kavanaugh:):) The LORD God bless you America The Great The Bold The Beautiful my beloved my sweet Uncle Barack Hussein Obama:):) The LORD God bless you America The Great The Bold The Beautiful my beloved my sweet Uncle Joseph Robinette Biden Jr:):) The LORD God bless you America The Great The Bold The Beautiful my beloved my sweet Sister Miss Garden:):) The LORD God bless you America The Great The Bold The Beautiful my beloved my sweet friend grande impresora the press in America and England:):) The LORD God bless you My beloved United Nations my beloved my sweet Uncle António Manuel de Oliveira Guterres and the princes and all the captains and all the rulers and all people nations and languages that dwell in all the earth:):) The LORD God bless you My beloved and beautiful The Hashemite Kingdom of Jordan my beloved my sweet Brother His Majesty King Abdullah II bin Al Hussein عبدالله الثاني بن الحسين and Queen Rania Al Abdullah رانيا العبد الله‎:):) Allah bless and protects you :)..
Jones Smith	🤗🤗🤗👍👍👤👤👤👤love this President, we put the right man in😀😄
Nail Wall	I need money too fix and save thee world. Email alwaysamazing167@gmail.com.
Wandering Will Burson	Eye of the Tiger perfect soundtrack for discussion.
Halal Burger	Eye of the Tiger in the background hahah
Sir Bomber Harris	Trump employees more Central Americans at his hotels and Mar A Lago than are in this caravan.  It all bullsh*t to keep his mouth breathing base screaming and not thinking. Easy sheep that they are.
Raffi Boghosian	Mr. President, God bless you for taking care of the boarder. Isis is with them, trying to invade us. We don't want that shit in this country! Thank you president Trump!
Ben C	What are you guy's doing about Honduras?
Brexit is Good for You	We need to chuck "Chequers". It is not the Brexit we voted for. We want a real Brexit !  Nigel Village, England, UK
bosh bigcat	so nice background music!!!
Panda One Productions	We are behind you all the way Mr. President
2 scoops With Sprinkles	Please SEND THE MILITARY TO THE Southern BORDERS soooooonnnnnn!!!!!!!!!!  🇺🇸🇺🇸🇺🇸🇺🇸🇺🇸🇺🇸🇺🇸🇺🇸🇺🇸🇺🇸🇺🇸🇺🇸🇺🇸🇺🇸Finish THE WALL BEFORE 2020 SIR! I don’t think u want to run on same BORDER WALL SIR IN 2020!!!!!!!!!!🇺🇸🇺🇸🇺🇸🇺🇸🇺🇸🇺🇸🇺🇸🇺🇸🇺🇸🇺🇸🇺🇸🇺🇸🇺🇸🇺🇸🇺🇸  Thank You!!!!!!!! Your Excellency, SIR! Mr.President , PRAYING FOR YOU AND OUR COUNTRY, SIR!
chris barbera	Place the caravan on FEMA BARGES!!!
Il Scalia	HELL YA!!!   ANOTHER TAX CUT!!!   MO MONEY!!!  MO MONEY!!  MO MONEY!!! When Democrats look at their checks and see more money....do they get angry???  Just wondering...are they that  backwards???
TheReady500	MEXICO ISN'T STOPPING IT. FACT. BETTER GET THE MILITARY READY PRESIDENT TRUMP! THEY ARE PREDICTING 50,000 BY THE TIME THEY GET HERE ELECTION WEEK. STOP THE INVASION OF OUR SOVEREIGN BORDER PRESIDENT TRUMP.
PATTON LAUGHED	Time to cull the sh*t for brains white trash mass slow suicide that is the reality today. Obese whites from the Bible Belt and elsewhere in Red states are a massive drain on US taxpayers. Their poor life choices are the greatest burden on all tax payers. I suggest forced labor camps for anyone with Type 2 Diabetes due to gluttony or vice. Same for smokers and drunks. F the sad sack Alt Right identity politics of protecting the soft white degenerate belly of fat ass America. Enough is enough.
Reggie714	Love the soundtrack in the background
Community Guidelines	Thank god for President Trump; I never thought I'd see a respectable President in my lifetime.  Bush Sr, Clinton, Bush Jr, and Obama were all war-mongering, Deep State globalist scum, who each sold out the country and should be punished for treason.  FINALLY, we have an actual patriot in the White House who fights for America's benefit every day.  Bring our troops back from the middle east, station them on our border,  and pull out of the UN entirely and evict them from US soil.
Jonas Baleia	Very, Very good positivo oficiais THE mister TRUMP
STEPHEN CHRISTIAN	u bet your ass mexico better help big, nieto liddle nieto learned very quickly we r the USA there is no 1 like us & never will be ANOTHER TO MATCH USA! if they want they're $$ ((WE STILL GIVE AID TO MEXICO) THEY BETTER RESPECT USA NO MORE BETO MALE oHAMA NOW WE HAVE AN ALPHA ((THANK GOD))!!
I'm just Who I am	What a lying heartless piece of shit.
iNSANEcOOkieMONstEr	I use to admire John Wayne as a kid. He was a "Man's Man". There really hasn't been anyone much like him... Until now.  Donald J. Trump truly is today's Man's Man. A real hero! I can honestly say... he is one true stud!
conny wilmering	durch die Hinrichtung von Adolf Eichmann machen sich dieses scheiß Juden doch auch nur zur Mörder und sind so nicht besseres auf dieser Welt . mfg eure conny
Mark Chase	Please, click on the Thumbs Up icon to Like this video, on the SUBSCRIBE button and the Bell to get notified of new videos.  The Arrow is there, if you wish to Share.
Wally Shorebet	71yo Man working working working...........for all Americans #Trump2020
Carloman M	When we have Africa for the Africans, Asia for the Asians, but White countries for everyone, what is the result? The result, over time, is fewer and fewer White children. Is this some accident? Under international law, imposing conditions on a race leading to its destruction over time is genocide. Forcing us to share our living space with more and more non-Whites is doing just that. They say they are anti-racist, but what they are is anti-White. Anti-racist is a codeword for anti-White.
Emanuel	Ooorah TRUMP
Dadutta	Nice thumbnail, white house.
Dennis Rivenburg	FUCK TRUMP
Flaky 96	Press conference every day
Bobby Belle	Stop the blue wave of illegal voters heading here!
Class A Living	It's the eye of the tiger MAGA
Petra Hermans	While the video asks 10:05 seconds of my precious time, I listened to noise of beautiful music, by 2:20 seconds. Petra Hermans
Robert Knudson	#WhoIsAmberRoad?  Is the opposite of John Galt.
Mmmm Zzzz	@realdonaldtrump  Time to close the borders, time to stop funding  and kick UN out of US!
Frank Lloyd Wright	We have never seen or heard a more available President in our lifetimes.
WildwoodCastle	My President...
TonyPrime1	President Trump an doing  an outstanding job thank you Mr President
Rob Chillem	Russia says America violated the INF, two sides to the story, then there's the truth.
fairylaurie66	Please. Mr president... send our military to the border!! We are trusting you to protect us. May God protect you and the beautiful first lady.
RSS	naturally Trump is sucking his own D*** again
Osmon Frances	MAJOR TAX CUTS FOR THE MIDDLE CLASS PEOPLE.. VOTE TRUMP2020
Stefan	THERE...ARE...ONLY...TWO...GENDERS
sigi valenzuela	Jail awaits for you. Putin has order you to break the arms deal so they can start producing more nuclear warheads. That orange tone you love so much will be with you for the rest of your live, because you are a Russian asset. The world laughs at the BIG BABY you are...and since you are so obiously obedient to Vladimir Putin, you anounse the are pulling out of that deal, the TAX CUT just blew in your face because you know nothing about money like you claim, but we know all about your dady and others bailing you out... like Saudi Arabia. Man you are a mess
angelbabe dawg	DEPARTURE..???!!??   ..ahh, shit..
Jibri Usher	Will Mexico pay for the wall??? Oh just wondering if it was real or just more hot air.
ShWeJaPa	1:59, ...on behalf of the American public that we appreciate what Mexico is doing, they really stepped up and it will not be forgotten.
Mr Towers	Mr President arrest soros and his family! These people are the ones funding the illegal immigrants caravan from Honduras! #Trump2020  #MAGA
OrbitalHUB	This era of the United States has an epic, classic feel to it. And President Trump is the perfect leader for the United States.
tamimerkaz	1% Joe will be the easiest candidate for President Trump to beat. The man is so old and ill of dementia he can barely speak.
ernie green	LIST A VIDEO WITH A LIST OFTRUMP'S MANY ACCOMPLISHMENTS SINCE HE TOOK OFFICE , BEFORE NOV 6 WOULD BE GOOD  !
eTheReal Deal	I’ve never loved a public figure more than President Trump. He proves Day follows night, good triumphs / trumps evil
Leonard Wong	Could Dems be accepting "anonymous donations" from illegals or foreigners? Isn't that foreign interference in local politics. Do craft new laws to curb this. Money makes possibilities.......both good and EVIL.
Ken Lee	Soooo, NPC's are slow ~ On Nov 7th We Will Know All
Who's That	Whay spend so much time on one reporter when there are hundreds to Americans killed by Illegal Aliens
Summer Raines	Love PRESIDENT TRUMP 🇺🇸❤💙
heckler73	Is he giving a statement on his departure statement? That doesn't sound too conceited. Having _Eye of the Tiger_ playing in the background really makes it.
Lorenzo G	*Boldest, greatest president ever! Trump 2020 all the way baby!*
Jaron McDaniel	That's kinda funny that "eye of the tiger" is playing in the back ground.
Stephen Gould	Please help Samuel A Girod, an Amish man in federal prison, persecuted by the FDA for following his religion and making traditional herbal salves.  He is from Kentucky.  Such an inequity!  We spend thousands, perhaps millions of dollars to rescue poor pastor Brunson, while we persecute and imprison our own citizens for exercising their religious liberties without batting an eye; and who will help them?
Virginia Campodonico	Kashoggi lived by the Sword DIED by the Sword DEMOCRATS making a big deal about Kashoggi,  but they don't CONDEMNED THE HONDURAN MOB trying to come OVER and STEAL OUR TREASURY
NE	This man is breath of fresh air to America. I stand 100% behind him.
Vengeful One	You notice the only thing the MSM is  focusing on? Saudi Arabia.  Reason- they (DEEPSTATE LIBS) Hate Saudi Arabia and wants Trump to cave to them (MSM) .
John Duncan	Best president of my lifetime.  Don't let the INVADERS come in President Trump.  A country without borders is no country.
Carl Mannerhiem	God bless you Sir
philorg1	Pray for our President as Hillary, Eric Holder, Corey SPARTACUS Booker and the Deep State are being triggered.  https://www.youtube.com/watch?v=2vBrqeXBazs
Marina Capri	What’s with the theme from “ROCKY” 🐅 playing in the background? Freaky
Tillie Mae Kirk	At last a real President. Thank God for President Trump.
Big E	"And the light shineth in darkness, and the darkness comprehended it not" Thank you Mr. President!
Lady Jillian	❤️❤️❤️🚂🇺🇸🇺🇸President Trump
Heart of Dixie	TRUMP 2020 - KAG !
Fightosaurus	BEST. PRESIDENT. EVER. God bless America and President Trump: keeping us safe, keeping us strong, keeping us GREAT.
Virginia Bradley	I love these statements on departure, it let's be apart of what's going on! God bless President Trump!
Ramon Capinpin	Why is it that the CIA and the FBI were not INVESTIGATING the very FAKE NEWS Washington Post for employing and paying a Saudi Arabian reporter who is a well known associate and active supporter of the most notorious terrorists of the millennium OSAMA BIN LADEN??? Why oh why indeed??? Because the case of the murdered Saudi Arabian reporter concerns NATIONAL SECURITY. Considering the FACT that the OWNER of the Washington Post is also the owner of the AMAZON business empire that delivers PACKAGES everyday to millions of HOMES around the world. The AMERICAN PEOPLE had the right to know what is the extent of the relationship between the OWNER of Washington Post and JAMAL KHASHOGGI who is the BEST FRIEND of the murdering bastard OSAMA BIN LADEN. Simply because...if a FOREIGNER who had TIES with the TERRORIST like BIN LADEN were able to penetrate and infiltrate a very influential newspaper the Washington Post...it is also POSSIBLE that other FOREIGNERS with TIES to other TERRORIST that were the remnants of OSAMA BIN LADEN gang...may have penetrated and infiltrated the AMAZON BUSINESS EMPIRE because it had the same OWNER who is said to be the RICHEST MAN in the world today. If that is the case...then nobody is SAFE in this planet anymore. Simply because...TERRORISM can be delivered in your HOME in a PACKAGE from AMAZON.Com. Therefore...it is not only necessary...but a MUST for the FBI and the CIA to investigate the OWNER of the Washington Post. If the FBI and the CIA were AFRAID to investigate Washington Post because they might be EXPOSED by the FAKE NEWS MEDIA for LEAKING CLASSIFIED DOCUMENTS...then...it is IMPERATIVE that an impartial CONGRESSIONAL HEARING must be convened to investigate the involvement of the owner of Amazon and Washington Post to JAMAL KHASHOGGI who is a well known associate and best friend of the dreaded killer OSAMA BIN LADEN who ordered the attack on the World Trade Center and the PENTAGON that killed thousands of innocent Americans. The duly elected REPRESENTATIVES of the United States Congress owes it to the American PEOPLE specially to the relatives of the VICTIMS who perished in the gruesome 9/11 attack on the United States. They must investigate RIGHT AWAY because the FAKE NEWS MEDIA APPARATUS owned by the GLOBALIST BILLIONAIRES who made their fortunes from the COMPUTER and INTERNET technology BONANZA were already COVERING UP the ASSOCIATION of JAMAL KHASHOGGI with the infamous OSAMA BIN LADEN.
BumbleBeeC	The BEST President for America!  MAGA!
Gerard	I said YEAH!YEAH!YEAH! WOOOOOO!! love how CNN or someone in media was complaining how the music was too loud.
André  Victor	IVANKA and NIKKI 2020
TheMaskedEmolga 587	Eye of the tiger
The Sons Of Liberty Boston	Investigate the death of American  journalist Michael Hastings who was murdered on American soil right before he was going to release a big story regarding Benghazi. He was probably another victim of the Hillary/Obama mafia!
Eddie Oi	Dickhead clown...
The Dark Web.	Sweet Mr. President. Just fantastic. We The people love you Mr. President Trump.
Pewdiepie Travelling Man	The straightforward talker and Chief. Keep up the good work Mr.President!
leos rule	The immigrants are hurting the Mexican soldiers.  Can you imagine what they would do to ordinary USA citizens.?? I pray Trump DOES bring in the military to stop this madness.!!!
The Dumb Dog	What type of fucking title and thumbnail is this what the fuck White House official YouTube page fuck
Sue Rosser	God Bless you President Trump. Our prayers for you!! Thank you for taking on this awesome responsibility!
Michelle My Belle	STOP THIS CARAVAN. IT MUST BE STOPPED! ENOUGH IS ENOUGH! NO MORE! SEND ARMED MILITARY TO THE BORDER AND TELL THEM TO FIRE UPON ANYONE WHO CROSSES THE BORDER ILLEGALLY.  WE MUST PUT A STOP TO THIS MADNESS!  THEY ARE BRINGING DISEASES, TAKING AWAY OUR CULTURE AND KILLING/RAPING OUR CITIZENS!!! ENOUGH!!! ENOUGH!!! ENOUGH!!! ENOUGH!!!  STOP IT AND STOP IT NOW. NO EXCEPTIONS. PUT YOUR MONEY WHERE YOUR MOUTH IS AND SHOW EVERYONE YOU MEAN WHAT YOU SAY. OVER HALF OF AMERICA DO NOT MIND IF YOU FIRE ON THEM AND KILL THEM!! STOP IT!!!!!!!!!!  Senator Gaetz has already published a video on Twitter literally showing people being paid by armed men. Enough damn it!
Richard733	Free Alex Jones
e081194eng	BEST PRESIDENT EVER...TRUMP 2020 !!!
CCR TV	LoveLife <>Did you Know American People, In Venezuela, Local Street Markets Sell Dead HUMAN MEAT, THAT is RIGHT , THEY ARE ROBBING THE MORGUES AND SELLING THE BUTCHERED HUMAN BODY PARTS FOR HUMAN CONSUMPTION, ON THE TABLES~~~HELLO 🔥🤓🔥🙀🔥💥🔥<>GETTING THIS<>There is Film And Reporting from. Venezuela <><>🔥🇺🇸🔥
WSario	Go America....Go America...Strong....
Rogue Merc	1:46...jab at the leakers, big right hand to follow shortly. God Bless Trump.  #QArmy
Truther Revolution	His hair isn’t looking good he needs a redken camo color.
Mrs.	Thank you Mr.President and  please i beg of you on behalf of the People please Stop the criminally orchestrated caravan at all costs! MAGA
JimmyRicky	Please Lord protect this President from all enemies foreign and DOMESTIC, in Jesus name. Amen.
Andrew Rivera	President Trump! Just awesome!
Jose Que no nos pare nadie	USMCA
proud2beajcan	He is just so badass and I love it! #MAGA #TRUMP2020
Ma Ni	This man really care about us in America,he got a lot of energy compare to that lazy Obama.Republicans 2018 all the ways and let us all go out and vote,this is the only power we have.
nina e	I love my President ❤️❤️❤️❤️❤️❤️❤️❤️❤️
barbara whittall	Great to hear all cheering for our Great President!!!
Prime LorenM	Can we send all our corporate media to Saudi Arabia and leave them there!!!
Ben Klassen	I'm not from Nevada but I know how to pronounce "Nevada".
Natalie Nakamura	President Trump really is the People’s voice. God bless President Trump.
Americans First	That’s right President Trump. Put the military on our border and seal it up!
bahman asadi	Mr president, you are doing all right, keep going, GOD is on your side, those who understand what you are doing they always pray for you and your family and your administration and your fellow and the great USA, i wish you luck
Chronic Independent News	TRUMP 2020! RED WAVE BABY!
Sockfoot	God Bless you Mr. President! You're doing am AWESOME job and we could use that tax cut! 🇺🇸🇺🇸🇺🇸
Harry Ghosh	What moron made the title of this video
Cee Tee	He's just such a boss Alpha male. We've been missing that quality in men in some time in general. When men were men in his day, we were the greatest country, producing most of the world's goods...
Thomas Pickering	When POTUS speaks I fall into a Religious frenzy of praise and worship that God has given America a Republican Zionist Capitalist as our glorious leader so we can go bomb the Hell out of Iran and Syria whenever we like. What a glorious country we live in!
ray konga	Deploy the troops in the border. MAGA 👍🇺🇸
gargargargary	FUQ t RUMP
Linda Sargent	Your an Awesome President !  Stay safe and God be with you.
Stokjockey	Arizona needs the Military at the border Mr. President, that is how You Stop and Invading Force is with Force.........We Can do This !
Meechie X	I like to hear Casino music for Trump. Nevada, music is cool
Eddie Dallas	How does a liberal hear this and think "so what if Russia is making nukes, I hate Trump"!. It's bizzare
Silence Dogood	First Dislike!
deltadawn(putyourclothesbackon)	Democrats suck, pass it along, hehehehehe!!!
spidey677	Eye Of The Tiger PERFECT song for DONNY
Julia76087	Thank you President Trump for protecting the American people!
Jon P	We are in a part of history   it’s gonna get better can’t wait so exciting
mrbutt	We love this Man.  America's finest President.
RevBiker Big D	November 6 th vote red!
blisstickmystic	OK Amen militarize the boarder if needed.
sharon shoop	If the reporter was mislim there is no body, because they have to bury withion 24 hours according to their religious rights!!!!!!!
Bridge	Turn Washington, Moscow, and Beijing into radioactive craters and the world will be better off.
Dr Leonard Gustav Anderson	This is real news....every time TRUMP talks...and he takes any questions from the media.....he informs all who listen exactly what he is doing or will soon do.....those who hate Trump may twist his words, but what he said and says is FACT......
Pablo Jimenez	...wow...the American President Donald J Trump...is a hard working/fighting...MACHINE...!
S D	President Trump is the real Iron Man😎 Maga WWG1WGA
hecke1959	When you have a 16 year old say no job's in Honduras you know he with ms13 or being trafficked, why would a kid be travelling alone. To cause  injury to Mexico police they should have just shot and asked questions later.
QRS11 CLIPPER CHIP JOE	i don't know why president obama's sperm donor  , didn't pull out....
Username [Redacted]	1) This treaty is very old. Soviet Era, 1940's and should be renegotiated. 2) Russia has a weapon that potentially violates the treaty and the US hasn't been allowed to inspect. 3) Abruptly pulling out of bad agreements is a negotiation tactic, and is symbolic, not an affront or act of aggression.  Trump knows that Russia (and China) can't afford an arms race without oppressing or harming it's people, and is using this weakness as leverage to renegotiate. It's a brilliant move, but wtf is with the timing here? Right before midterms? I think Trump is misunderstanding the left's fake Russia outrage, this won't get any swing voters.
L Paine	I’m just an  “average American “ and I don’t care what happened to some so-called “reporter “ who has been killed...I care about my Christian Values, my country, my family, my prosperity and my Very Great President Trump! I stand with Trump!
Victoria Love	I love our President
Emilio Sosa	WE DO NOT WANT ILLEGALS IN THE US , NOT AT THE ENTRANCE OF THOSE WHO BELIEVE THAT THEY CAN ENTER TO USA BY FORCE..!!
jnazorn0t	truly an amazing leader, the leader of the FREE world!
JmcD7	I don't think the democrates and their bosses the elitists, realise that this caravan, which they thought may hurt the republican election will actually help their election
Reverend Christine	Love my Trump.
ullgeologist	We’re going to win MORE! MMMMMMOORRRRRRRRRRREEEE!  We’re going to KEEP ON WINNING!  #MAGA🇺🇸
Born In Shithole Country	Like a Boss!
Susie Que	I learn more from listening to him for 10 minutes than in 10 weeks of CNN. The Donald Broadcasting Company...your #1 source for real news.
Maya Mae	Not a single negative comment here!  What a joke!
Remetski2401	I love our POTUS. We are soooooo blessed!
Soulaesthete	Donald Trump wasn't born to be a real estate developer or an entertainment personality, he was born to be President of the United States. And he's the greatest president I've ever seen.
Dr Chunky Biscuit	Let us not start a war JUST because 1 man has been killed!
Pork money	...the muz brothahood terrorist is gone Demrat pukes-   move on to your next crisis losers
Steven Lissner	God bless the greatest people's President in American history, Donald J Trump.
John Solberg	Trump  will  slam dunk Obama's midterms 2010 in November's 2018.
Free Freddy	Politics is all a big show run by Freemasons and Jews
M	MAGA :))
AnEclecticSoul	Love you Mr. President.  Thank you for being such a good man who actually cares about American and her people.
Chocobo Chip	USA!!!
k g	NPC news crew is there
Think	"PLUGS" Biden is a Moron and a fool.  His best role would be as a TV televangelist screaming at crowds and waving his hands like the idiot that he is. Biden LOL What a joke.
Delightful Douschebaggery	I'm George Washington,  and I approve this message.
Arnold Strong Numero Uno	He talks to the press a lot.
HEADBANGRR	Another day of TRUTH from President Trump!
Mitchell Albrecht	MAGA, you sob's!🇺🇸⚡🗣
Manho Drake	Brilliant statesman, America's first non-hypocrite president in 3 decades.
L.A. Quast	Please Please Please Pres.Mr.Trump boycott name change of SuperAmerica to Speedy. Thank U in His Name.
William R Hall	Face it. Trump is no match for Speedy Gonzales!
Destination Paradise	You mean while your trolls go crazy, suppress OUR VOTES....STICK YOUR HEAD UP SAUDIS AND PUTINS ASS, HAVE KKK RALLYS, YOU BLAME GAME YOU. PUSSY. REPUBES ARE FINISHED.
M.L. DeMedal	Thank you POTUS!! Best POTUS ever!!  MSM have no idea how complicated the SA issue  is and the useful idiots want an instant solution!  Build the wall before anymore criminals get in to our country. There are a ton of ISIS members in this batch. Just do it, most of us would donate and also come to help build the wall.  Prayers for you and your brilliant team everyday. 🇺🇸🇺🇸🇺🇸🙏🙏🙏
Chuck Longino	OUT GREAT PRESIDENT DONALD J TRUMP😇 IS THE GREATEST PRESIDENT EVER!
* Firefox *	Khashoggi knew Bin Laden and supported him. Khashoggi made lot,s of enemies around the world with his reports. Why he chose to travel back into a region where he was not welcome is beyond anyones guess.
Digital Hedge	trump is world class..... dam im lucky im alive... what are the odds that im alive... even crazier  i hot the jack pot being alive and a American... love this guy
kd5dvm Kat Daddie	Need to do away with the loud music in the background. History is being made unlike ever before in the USA and Blue Oyster Cult is a has been...
JORGE OS DESENHOS DI GOORKS.	Ótimo senhor presidente. Os desenhos DII GOORKS  concorda.
MGTOW RULES	2020 will be Glorious! The best President  in the last 50 years  by the people and FOR the people!          WWG 1 WGA
c431inf 11b	Best statement on departure statement 😂 President trump is boss🇺🇸👊
Ravindra Mehta	You are our true reporter. Mr president .
Ibebebe babe	Thank you Mr President.  I’m excited about the middle income group getting a tax cut surprise just in time for the holidays.  😉👍
Johnny The Dog	survior
Edward Saucedo	He's transparent as he's on the move. He tells you how it is.
shining whitelight	#VOTERED
David Knesovich Sr	AMERICA has a REAL PRESIDENT thank God for PRESIDENT TRUMP, hope is alive again.
Annette Lofton	Well said Mr President, well said.👍😃
Eve Haslam	HOW does he keep going so strong? Amazing.
JustmeJoy7	The music should be turned off when the interview is going on, or it should happen in another location. Hopefully, that would be followed next time. I had to strain to hear the questions.
Michael Richards	America is a big enough country not to be pushed around. President Trump is ensuring America stands up for itself.
23rdJune	From the UK: Trump is one hell of a tough dude!
T2H Instructionals	Mr. President, I just signed in to google and I get a message that popped up asking me has someone else recently signed into my account and made comments on youtube without my knowledge? I was thinking there is no way for someone to do that, I have a two signature security sign in activated. They text me a code to sign in with on top of my password. I looked over my comments to see if this were the case and no, there were not any comments that I have made recently that were not mine. A few months ago my channel did indeed get hacked by some fella with an Australia accent that produced a video on shooting zombies in a video game, the zombies he termed stupid Trump supporters as he talked about shooting Trump supporters. I figured what he probably was able to do was hack into my computer and make comments while I was online, as well he no doubt was using my system as I would just keep it signed in so I would not have to get the sign in code on top of my password every time I signed in.  So I figure the hacker, would sign in through my system while I was on line but not on youtube. I now no longer will allow the system to stay signed in to eliminate that possibility. My comments recently have been strong support for you and your accomplishments. I am now wondering if they are considering or have already shadow banned me. I now suspect that their algorithms now allow for the appearance that   everyone can see our posts. The interesting aspect about that is that before when I would respond to your detractors I used to get a rebuttal from them a response to my response. Now I get no responses back, so I am suspecting they are blocking the oppositions ability to read my responses.  It is no doubt do to all your hard work and as well those of us who support you in responding to their lies and shaming, that when we respond with logic and we respond with truth that many of the Democrats are now coming over to your side sir. And it is taking place due to your hard work and our unwavering support for you.  So I am now wondering if google is indeed shadow banning us to a degree now that on all accounts at face value it appears we are not being censured.  For many of us who support you now may be finding ourselves comparing ourselves among ourselves.  Apparently there is a new government that superceeds the US government and our freedom of speech.  Its called big business.  So is google, facebook, twitter using their clout to influence elections? Wasn't Russia just hammered under those accusations?  I am thinking these guys are looking more and more like a Utility everyday. Hopefully sir they are not bold enough to shadow ban us so that you are not able to read our messages.  It would be nice to hear a comforting word from you that this is not taking place, that they are not hiding our comments and support from you.  Love you sir, General Gorge Washington and our founding fathers all counted the cost to make a future for us and our children for all those who wish to nestle under the branches of the tree of liberty.  And certainly you like our founding fathers have done the same and counted the cost of preserving liberty. Praying for you and yours.
UNDER THE COIL	I'll say it again, When you spray for bugs, do you only aim for the adult males ? ... exactly .... Shoot them all.
Wutaii1 Nostalgia	AMAZING !!!!
Cherokee44 Oklahoma	It's none of our business , the Saudi prince wanted to take out a scumbag period. You want to ask about dead people try our people in Benghazi.
Damin Mance	Mr.president keep making America great again!
Miriam Jewett	God Bless President Trump
jayne lehmer	LOVE my president ❤️🇺🇸❤️
WERE ALL MAD HERE ¿	I stand behind in front on the side where I’m needed Mr. President! #Maga #sealtheborders
Bitter Clinger	1:39 lol wicked burn!  MAGA!
Birdie CR	Thank you Mr President!  I love how we get news from you first hand instead of depending on fake news. Your short reviews & tweets keep us informed! We love you & pray for you & your teams. 🙏🏻❤️🇺🇸
Buddy Bell	#EndTheUn will #EndTheInvasion !!!
Cody Perry	Totally incompetent. No faith in his leadership.
Robert Hudson	ROY COHN'S BUTT BOY IS GETTING BALDER.
Mayra Scherrer	Hi. President Trump: I am voting for you Guys again. God Bless you.
Earl Gray	* * *  My comment pertains to the FOX (faux news) report via YouTube on 8/27/18 Tiger Wood Loves Donald  J. Trump.  Faux is the French definition for fake. I explained it for "the base"  as they are unfamiliar with Webster's.                                                                            > It behooves Tiger Woods & Donny J. T. to emalgamate (members of the "base," fetch your dictionaries) as they are of the kindred spirit because they belong to the minority group of  VILE, DESPICABLE, CHEATING PHILANDERERING HUSBANDS. If a man dishonors his wife and has a total disregard for his wedding vows and very basic human decency, he is by far a subjacent human being, devoid of a real soul. This catagoirization definitely includes former President William Cllnton, therefore my comment cannot be misconstrued as politically motivated. If any man will lie to and deceive his own wife there is absolutely no way that he can be trusted, PERIOD. All three of the "horn dogs" mentioned above certainly  ignored the example set by the preceiding men of honor George W. Bush and  Barack Obama, men who remained forever loyal to their spouses & our nation. Respectable , dignified, and loyal men that our country desperately needs now (especially as the antidote for Trumpism ) are definitely elusive. Trump has true, loving, husbands such as myself wondering how any voter with an IQ above 50 can support such dreadfully vile, cheating, schmendricks.  Ladies, please  believe me sincere, true, honorable, men, loathe these dreadful specimens of the male gender. They are simply "smegma" in the eyes of good men.          OiVey !
ckaz007	President Trump is a winner. He has my vote again in 2020.
Rebel Lemming	Rockstar Trump!
b a	#likeelisabeth #fuckyoukkk
Tristan Kuhn	when i hear trump saying 'billion' i get remembered of this -> https://www.youtube.com/watch?v=u_aLESDql1U&t= :P
Everest Zak	"It will hurt us more than it will hurt them." Don't be mistaken, this is not a statement of weakness by Trump. Trump is a master tactician. This is classic good cop/bad cop tactic that the media's eating up. He's saying to Saudi Arabia, "Hey, don't worry, you can tell us what happened, we'll still be friends." He's coaxing the story out of the Saudis slowly but surely, while maintaining maximum leverage.
desmmart	I love the POTUS. only sad that there is no wall yet. Please build that wall!
Prometheus Unbound	Mexican police ride around in the back of pickup trucks holding uzzies. How could they not have fire arms at The boarder? Sounds rigged
Mary Hernandez	MSM only cares about this journalist because he's a Muslim and a journalist. If he would have been a christian or even a conservative they wouldn't care.
sirreal6	#DECLASSIFY
Patty Cakes	POTUS is Non-stop working for the people around the clock.  When does he sleep?!  God Bless our President!  WE LOVE YOU!
Betsy Ross	I’m grateful for President Trump. I admire his work ethic.
Asa Coe	DRUMPFS America is a Fascist Corporate KAKISTOCRACY!! Impeach and imprison this treasonous coward.  MAGA, Maggots Are Groping Again.  We  the true freedom-loving Americans want our country back from this fascist coward, Drumpf! Enough of this corporate Plutocracy dick- traitor.
Rusty Tin Man	EYE OF THE TIGER ...TRUMPS UFC WALK OUT SONG
PaulRevere Rider	God Bless President Trump!
Jonny Deth	The fake news said Trump threatened a mob invasion heading towards the USA and every presenter seemed like they wanted to say "He has no right to do this." *Meanwhile a mob member said Trump deserved to die and they used it as a sound bite to trigger our home grown stupids; Trump has EVERY right to do this and if he doesn't it's dereliction of duty.* There's too many spineless Republicans that don't go after these Democrats and so-and-sos in the courts for just that, dereliction of duty. *Your district gets worse every year? Bye bye Maxine Swampwaters! Bye bye Cory Booger!*
#MAGALAM FOREVER	Mexico is not doing anything to stop this invasion. Check your sources, Sir! IT'S TIME TO SHUT DOWN THE BORDER!
nmcondon	GOD BLESS & PROTECT PRESIDENT TRUMP
Sideshow Bob	Ban Soros meddling!!!!
acorn sucks	Great time! Truth and justice.
Robert W	He did get sunburned a bit
Dogfather of Hull	The people love you Boss. 🇱🇷
Gawanipony 3	How does President Trump have SO much energy?! I don’t have 1/2 what he does and I’m 40!!
Laura W	He's a Mudblood!
Hurvey Lykems	Why can't we just get the hell out of the middle east  it makes no sense for us to keep spending money And lives
Wes Anderson	Middle Class Tax Cut💪🇺🇸💪
ABOXofMONSTERS	I don’t think it would be hard to get to who’s responsible  for that caravan.    And we know now why Russia has been building Serious armament while BO turned his head.  Same reason why 14 military planes crashed recently  follow Q you would know what’s really happened and happening.  IF it were not for Trump we would right now be in concentration camps  there was serious crippling done to our military  and now you know why there was such a push by democrats ( and China ) to remove the Armalite rifle from civilians.  But that tells you how stupid these people are.   Sadly most have no clue what was happening.
corneliusva	Biden can't draw a crowd. Vicious and delightful. Bless President Trump.
RightWingKing	Trump's been harder on Russia than Obama ever was. Trump armed the people of Ukraine with deadly weaponry that obama would not do, 200 Russian soldiers were killed in syria by American soldiers and now he'll be pulling out of that deal. With tax cuts he neeeeeeedddsss to lower government spendings or we may have another recession. Keep makeling America great sir! 🇺🇸 🗽
Marlena Maizar	This man is the BOSS!
Double Rainbow	I like him 👍
JoshBroChill78	Why do they keep asking about some terrorists reporter and nothing about Seth Rich?
LucianAHawke	Greatest President ever...at least he's certainly on his way. Very grateful for the sacrifice he and his family are making for all of us.
Salvatore Parascandolo - G-mail	MY OFFER TO TAKE A BULLET FOR PRESIDENT TRUMP STILL STANDS... FROM WHEN HE WAS CANDIDATE TRUMP. ANYTIME, ANYWHERE. I WOULD CONSIDER IT A PRIVILEGE.
germinvermin	Statement upon departure statement? Is that like department of redundancy department?
Chaz Nonya	Love this President, btw, lock her up. We still want that.
TEE-nuh	Taking care of business! Love our POTUS! ❤️🇺🇸💙 God bless USA ✨🙏🏼
N Ex	Can't spell "Triumph" without "Trump!"
Scott.	Nevada, Tom F Steyer is running vs. Dean Heller. One thing; a bit of water cooler gossip for people who have read the Wikileaks papers, first Steyer came up in the Panama Papers scandal, easy to see how that could happen, after all his job was to buy buissness and fire everyoe so the buissness could be sold to or picked up in China; second, and a lot of people are not ready for this part and will deny it as even humanly possible- it is said Steyer is addicted to Adrenochrome. If you are not alarmed at this possibility, then roll back over, go back to sleep. For the rest, just type that word into your YouTube browser if you are not sure what that means. He became addicted from his exposure to it rubbing elbows with John “skippy” Podesta.
Kathy	LOL. The Rolling Stones playing in the background. His rallies look like a lot of fun.
Martin Gahan	Have a great flight.
soultryfeathers	You are fantastic President Trump, 😊
C. 12451	#bestpresidentever Please SHUT DOWN THE BORDERS. Have NO former gov. employees with security clearance. Remove all security detail--they can PAY for their own security IF they think they need it. NOT on our $$.
rachel bordeaux	Genius man and handsome
Star Dust	Bet the Democrats , Globalists , Elites and Soros...  They are funding these law breakers looking for freebies like welfare checks, but they are going to be disappointed
xltrt	It's better that Trump speaks directly to the media rather than going through the TV press briefings with Sarah Sanders. The reporters have turned it into a grandstanding bashing session trying to embarrass her and the administration.
golf-n-guns	Great news!  *Tax cut for middle income!*
Elifas Levi	God Bless you Mr. President, along with the men and women of our elite military. Seal our border; build the wall. https://www.real.video/5851397884001
Robert G Horne	President Trump sir. Your on it. These people need to answer for there stuff they have been getting away with. 🇺🇸1 always .thanks for your hard work and strong beliefs.
Miracle0716 GodGift	Hey President Trump
Don Soulliere	You're doing a great job Mr President! Given a text brake to families with children would go a long way. Infrastructure one of the biggest problems in our country. Recidivism it's so high once your felon you're always a felon. Yep. Damaged goods! And no one will hire you. Nonviolent felons give them a out return to society don't bend or break a law and in five years it will be expunged from their record. Taxpayers I believe our paying what $67,000 a year to house one inmate for petty crimes?
Kim S	President Trump, put God first in your life, and He will always stand with you. 🇺🇸🇺🇸🇺🇸🇺🇸🇺🇸🇺🇸🇺🇸🇺🇸🇺🇸🇺🇸
remnant warrior	Mr. President, Its time for you to ask Jesus Christ as your Lord and Savior. Everyone must work out their own salvation, with fear and trembling. Call upon His name, receive His righteousness, ours is as filthy rags. We can NEVER do enough to be counted righteous, we must believe CHRIST died and was God manifest in the flesh, who suffered indescribably for ALL OUR sins, and was raised from the dead. He conquered sin and death, believe this, have faith in His righteousness, and You shall be SAVED. Blessings will come upon you and your house, and this nation will see a revival. I pray for you Donald. We all pray.
Deena K	Trump 2020
Anlil Walker	"We're not going to be the only ones to adhere to it." -Donald Trump  #MAGA 🇺🇸👍
Golf Foxtrot Yankee	Lying asshat Donny is in trouble after the mid terms...
Caius Postumius Turrinus	We need to reinstate project castle ,and Ivy. Those will be the ultimate deterrents in the face of the world and our enemies.
Brenda Cochran	Call these people what they are, thugs, invaders, criminals. Get rid of all illegal immigrants including DACA. Watching the videos of their bullying, we don't need these kind of people here.
sathish sharma	DONALD MY FRIEND , SO MANY TIMES I WROTE ABOUT CHINA , MY DEAR FRIEND , CHINA IS SLOWLY PENETRATING  INTO EUROPE , I THINK THEY ARE PLANNING TO BREAK RELATIONS WITH USA AND EUROPE [ NATO ] . WATCH OUT FRIEND , GOD BLESS . [ sathishsharma3003@gmail.com ]
Alex Gilson	Booo November is not gunna be kind to this guy!
Luann Schrenk	The missing journalist is NOT an American citizen!!! Not our problem!!!
Marc_US	#MAGA
Oildale Joe	5x5
SuperPhester	Thank you PDJT!!!
ChriBa 66	GOD be with you, sir👍
GoodDogNigel	President Trump is the most transparent president I can remember.  He makes himself available to the press a lot.  Obama hid from them.
TheTruth 808	Eye of the tiger?  THAT'S MY PRESIDENT!!!!
Marn SSJ	The Chinese president of Interpol Meng Hongwei is missing and presumed dead and all these fake news journalists care about is their WaPo contributor friend and Muslim Brotherhood booster Khashoggi.
SOPMOD 556 MM	Kavanaugh Seated! RED Wave in November! Trump 2020! MAGA!
Trucker jurnal	MAGA bitch!
paul mason ranck	Stay well Mr. President #DonaldJohnTrump sir, safe, #God bless, and #GodBlessAmerica. #Godspeed for #TheRepublic. #ForWhichItStands. One nation under #God. Indivisible with #liberty and #justice for all. #TheJointStaff #USAGov #TheWhiteHouse  Sincerely And Respectfully, Paul Mason Ranck us
Valentinez Kaiser III	Who else noticed the redundant title redundancy?
Gene In TN	Just how do we replace the Demo party with another party????? Thru the voting booths?  Or with guns in our streets???  I am looking for info only!!!!!!!
JT Smith	Scrapping the INF b/c Obama failed to do anything. Brilliant!
So Vu	PRESIDENT DONALD J TRUMP, The man of the world Today.
Eagle#1	What a great man...what a great President Trump 2020...MAGA!!!.......
reinfree	🇺🇸WE ARE THE PLAN🇺🇸VOTE 🔴
Marilyn Boling	Why can't I share this to my twitter page? There is no option to share to twitter
Dancing Filly	The most AWESOME PRESIDENT in history!!  Get rid of that stupid music in the background!!!!!!
Daily M6	WOW doesn't get much more presidential than that. What a legend getting on the plane! Thank you Mr. President!
Jason Michael	President Iron Balls
Geezermann	Bless you sir.  I look forward to the Rally in Houston!!!  And yes President Trump - thank you Mexico for doing the right thing.
wil brander	It's a Democrats' caravan. Easy. Send em back!
Andrea J.	Please close are boarder, send the military. We love and support you. God bless president Trump
iLink Graal	9:35 The way people start cheering as he walks up the stairs. That must be an awesome feeling.
harolyn allison	May God be with you Mr. president, keep God close to your heart. thank you for your efforts, we pray for you daily
devo8466	GOD bless President Donald J. Trump, his Family, and his Administration. #MAGA #KAG #TeamTrump #TRUMP2020 #RedWave
Jonathan Montgomery	Statement released by the Department of Redundancy Department
Geert Matthys	Not just a Statement but a Statement upon departure Statement, that's twice as bigly!
Guess	God bless Trump.
∵§ain†♣∀₦₲ξℜ∴	Interesting, it's strange a caravan appears like an invasion, I know that region had the volcano in June but it would make sense that we help over there and not have them come here in an invasive way
OsakaRose	*STOP THAT DAMNED CARAVAN!  THERE ARE NOW 5,000 IN IT!  THEY OVERWHELMED MEXICO AND ARE HEADING STRAIGHT FOR US!  SEND OUR MILITARY THERE & SHOOT ANY MAN THAT ATTEMPTS TO CROSS!  ISIS IS KNOWN TO BE WITHIN THE GROUP!*
ASARULUDU BANMASKIM	BIULD THE WALL
Coco H	I love this man! I just knew from the first time I heard his interview on Oprah years ago he’d be a very successful man and when he confirmed his running for president I knew he’d win! I’ve never doubted him! He’s very smart. Knows what he speaks. He may get his words mixed up. But any common sense American knows what he meant!
Katalina S	1 view 20 likes 5 comments lol
Reed Stroupe	Eye of the tiger!!!
joseph D	Awesome responses, Mr President, keep up the good work.
Lord Razoun	Im so happy with Trump...he got my vote in 2020 best POUTS EVER!
John Petrov	SHARPEN YOUR VOTING PENCILS
OMAR ABDULLAH ABDO OMAR	#MAGA🇺🇸🇺🇸🇺🇸💗🇺🇸🇺🇸🇺🇸
AKfishkayaker	Unfit for duty!! 25th Amendment!!! WTF are they talking about? This guy takes questions on EVERY topic EVERY day. Never needs a script for these open question sessions. The most transparent leader EVER!
Black Stone	God bless America. I am and I will remain standing with America!
madammim	Please God protect our POTUS
Iam Ditto	Good Job!👍🏼💞🇺🇸
Randy TenBrink	He's the boss
Austin lol	Fix the fucking title. Jesus Christ.
Robert S	LOL   He wanted to say...  Mexican Police .. injured by these ''ANIMALS'... but.. held back and said.. People..   Mr President... those that are causing harm... are  Animals..!!    MAGA  2020
Cottage Farm Bear	Eye of the tiger - Rising Up To The Challenge Of Our Rival 🇺🇸🇺🇸💪💪 Mr. President xoxo 😘
Kerry Weston	Best president ever!  EIGHT years of winning. Please finish the wall and get rid of the illegal immigrant problem.  Impeach all the Democrats.
Frederick Martinez	Thank you President Donald Trump
anastunya	In control of MSM! Calls out lying ABC!
Lucy Lou	Thank you, Mr President. Stay safe and know we are praying for you. ❤️
ZIG ZAG Ground ZERO	President TRUMP Tweets : All levels of government and Law Enforcement are watching carefully for VOTER FRAUD, including during EARLY VOTING. Cheat at your own peril. Violators will be subject to maximum penalties, both civil and criminal! UNITED WE STAND & VOTE REPUBLICAN
Brandon Bennetzen	It's Mueller Time!!
Nathan King	The Great Wall of America
Николай Носов	Great man!
Thant Zin	#THNANK YOU...DAILY NEVER FORGET...PROMISE MY PRESIDENT...APPLOGISE..
Q Patriot Robertson	ELKO RALLY was GREAT!  I held my Q shirt up for him.  We love you Sir. #WWG1WGA
Jake Pursch	God bless you Donald Trump
Caboco Carlos	I am dying of cancer I do wish I could be here in 2020
George Alvarez	Amazing... 1 view and 25 thumbs up.
pablo9364	God bless president trump.   From the U.K. the people are with you
Crazy Reaper	Love our president...hope I can see him Monday in Houston
Rajeshree RP	2nd View. 10th like. May God continue to use President Trump.
Jeff Tidwell	MSNPC
The Frugal Gamer	Thank you Mr. President!! Build the wall!!
A Diaz	#MAGA
