Datchayani MOUNIEN	Excellent work Every Sk brother sister proud to own him I m one among them SK follower showering love with wonderful art poem helping for social activity Always pleasure to watch all We admire him for his great value self discipled life simplicity core hardworker positive mind good hearted nature No hurddles can stop him May the hater ego jealous people raise against him but his growth can t be avoided or stopped His hater are not matured willing to accept his success Endrum Sk namadhu manadhil SEEMA RAJA dhan Intha patathai yarum etuka mudiyathu Muyarchi Munnertrum Mudhulitam 👍👍👍
Hafizah Thajudeen	Wow soooooooooo cute
sk hearts productions	Endha app le edit panninge bro supera irukku
Thalapathy Vijay fans	Masss
Harrish Chandra	supeeerrrrr sk
Muruges Waran	Brother unmailayeee sema super
Dennison Samuel	super na
Madhu Kishore	Semma ji video En uyir sivakarthikeyan 😍❤
PADMA SHREE	A perfect👍edit to Sk anna sema mass🔥Hardwork is a success of Sk anna i proud☝to say Sk anna fan he is inspiration for me
EMMANUEL JOHN	👌
Dubsmash world TAMIL	Masss edit anna super
logesh logesh	Semma mass 😘 sk
SK Pooja	A perfect edit👏👏👏simply awesome👌👌proud skian💪
Mersal Siva	Vera level ❤❤😍😍
vp 1999	Selva bro Arumai
JoY FilM FactorY	Super
Girish manikandan	Super bro semma edit sk Anna my inspiration
JAHIR HUSSAIN	Awesome
praveen _pk _prince	Mass edit wow
Js Creation	Goosebumps Thalaivar hard work pakumpothu
PrinceSk Online SkFc	Thalaivan❤❤
siva s	Super bro
Vinothcandy Vinothcandy	Sk Anna great 👌👌👌
Gunasekaran Sivakarthikeyan Blood	Thalaivar video va paakum pothu mattum than Odambu Silurkuthu bcoz of his hardwork😘 Thalaivaaaa U r Teacher of u 😘😘
R.Harish kumar	semma video mass panugaa troll star team keep rocking all d best gu
senthamizh selvan	Semma
Sai Krish	Fanstastic edit bro🔥😎 From 1 30 goosebump emotionally
Mg Vicky	Yeah Engaya pudichinga intha video Creator ra Semaya pandringa ya ellarum All The Very Best To Your Each And Everyone In TrollStarz Team😊❤😍🙏🔥
Harish Loveable	Superb Selva Goosebumps 👌👌😍
TIRUPUR SKIANS	Super Bro
RANDOM VIDEOS	01 33 02 06 💗❤️ Only few have gut to say this I am not an extraordinary actor Thalaiva nee vaa ounaku nanga errukom 😎
Shakti Nattar	Verithanam overloaded🔥✌️
muthu kailash	Entire samaniya makkal pride💪👏👌Siva Anna
Arun Siva77	Verithanam 😍❤️
Thani oruvan hari	🙏 🙏ᴛʜᴀʟᴀɪᴠᴀ
