Chogakusei Official	照明が眩しいんですねこれ。
ハニーベア	骨格と首とほくろたまらねぇ。声心地ええのう ‘ ́⌣ ’ ̀
正凜太郎	このイケボ君がまさか1歳年下だったとは
壱遊	笑った時に地味に仮面が上に上がるの笑った
さくらもち	あら！絶対イケメン！
あみ	らぶてんさんのところからきました✨ イケボですね！
12 Kuraha	最初が可愛すぎるんだが… 萌え ᐥᐜᐥ ♡ᐝ
まゆひろ	あの、気にしてたらごめんなさい。 喉仏ないからいろんな音域が出てるのでしょうか？まじで気にしてたらごめんなさい。
月猫アリス	心の大樹ﾎﾞｿｯ
海鈴 深	さてはおめぇ 私のいっこ上だな
柊梛	かっこよ！！！！ヾ ●´∇｀● ﾉ
さら	最初のごめんなさいwが何気に好きww
くま96	カッコイイ
けぼたん	いっぱいちゅき ´꒳
ぴくるす。	あのさ……最初の「さてはオメー、アンチだな」が 「さてはオメー、アンジャナフ」って聞こえたの俺だけ？ ；´・ω・
た か こ*	いっぱいちゅき💕
砂浜	最初からかわええ
。 JIN	同い年とは思えなほどのイケメンボイスですね！！！クラスにこんな人いませんw
ぴゅむ。	だめだ…もういっぱいちゅきだけじゃ表せねぇよ… すき
ジューストマト	何回聞いてもかっこいい
AOKI 。	かっこよすぎるんだが
西園寺*	控えめに言って最高
蒼空	癖が強い歌い方っすね 褒め言葉
窓際	ﾊﾗﾏｽｺｰｲ
キナ__ソラル	久しぶりに見たらめっちゃかっこよくなってる󾭠
m shiro	めっちゃカッコイイ。大人っぽい。歌も上手い。 この先もっと伸びる。 確信
赤いりんご	待って…イケボすぎる…！！！チャンネル登録しました！！ あと、 いっぱいちゅき♡
まるむ【歌ってみた】	同級生ってことに感動ﾟ ﾟ ω´ ﾟ ﾟ
龍之介 ナギ環	超くんカッコイイ💕やばい！\ ♡ ♡
来夢音〜ramune〜	超絶かっこよい。
Noise 75%	いやいや超くんに監視されてたらありがたやだわ 0 37 超くん高2かあ〜大きくなったね…、お母さん嬉しいです、😢
れぶる	大音量イヤホン推奨
とぅるーな。	いっぱいちゅき。
/ニアNia	歌詞です 見慣れた景色に潜むイデア いつだって君は監視されてる クルクル 野花結び合わせて まわる青色のカレイドスコープ 無意識バイアス 誰も知らない存在理由 繰り返し 思い描くスピログラフ 破壊と創造の幾何学模様 打ち切りの先でまた会えるよ パラレルワールド旅して 散りばめる願いに気付いて 世界をリメイク 隙間もない狭苦しいお庭 粉々にして取り替えよ♪ 無から生まれ無に帰れ 全部 何度でもディストピアを越えて またお別れね 次の世界で待ってるから 戻れない 変幻のマンダラ 思い出も崩れてしまえ 意味がない 君も忘れるだけ 何度も手を振る私は 懲りもせず光当てるんだ 世界をリメイク
Elly (エリー)	THIS IS SO COOL I love this soso much
ゆう	仮面しててもイケメン臭がすごい漂ってる……
あめいろみかん	うぽつです！ 歌い方がほんとに好きです！
祐希望	さてはおめーあん…
いちごサン	最初にやられたああああ す、すすすすっ 好きです 小声
Ranhi	かわええ
ホワイトアスパラガス	最初なんて言おうとしてるんです？
まるたろうかれん	すき
ただの・まぐろ	おめぇ さては超学生だな
螺夢てふてふ	いっぱいちゅきいいいいいいいいいい！！！！！！
sky*arrow	さてはおめえ かっこいいな
なよ し	うぽつです、遅くなりました！ かっこいいのにかわいいとかずるいです。最初で無事死亡しました。いっぱいちゅき♡
Mami	すき最高すぎますっっ！
りあみこ	さりげない歌声が私を傷つけた…… 心がいてぇ…可愛いやらかっこいいやら…キュってする…
すらいむかすみん	いっぱいちゅき わろた
すずはま	面白いコラボやし私得すぎて剥げそうなコラボやし…！好きな声優さんが歌ってるものを好きな歌い手が歌ってるとか、好きなアニメの主題かを好きな歌い手が歌ってるとかーー！ヤバイィィィィ！ 伝われェw
даё сисё-	高評価1回じゃ足りないので10回押しておきました ´ ω∂
さんけま	クソアニメの神opを神歌い手が歌う神動画
まっちゃ。	普通にかっこよすぎて… 目と耳が幸せです！！！！
きりさきゆゆ	本当にかっこいい、、、♡
Ma go	とっても良きです☆ かっこよき ´ー｀
。竜胆	ポプテピのアニメ化決まったって聞いた時絶対OPとかめっちゃかっこよくするだろうなぁと思ったらあたってた
今から言うことは全部嘘なんだけど、	うわああああ誕生日にこれ見れて良かった･･･最高のプレゼント･･････
DREAM TOMATO	最高すぎw 格好いい！
カラス烏	いっぱいちゅきコメント多すぎww いっぱいちゅき♡
松島美代子	すっごくカッコイイですね！声も綺麗で、イケボだし 最高です ❀╹▿╹
あっとはくあ	いっぱいちゅき♡
かみ	さてはおめえーダンボッチで撮ってるな？
太郎もゅ	っ ヮ c わぁい めっちゃ嬉しい！！！！！！
リア	同い年とは思えない
N A	さては神だなオメー いっぱいちゅき♡
一ノ瀬しらす	最初ので「うっ」ってくる。
ルキ	しょっぱなからめっちゃ可愛い ´ω｀ いっぱいちゅき♡
恆狼	好帥啊啊啊 倒下
来音ルキ	かっ…かっこいい 実写神 神！ o ﾟ∀ﾟ o
はるかぜ。	めちゃくちゃカッコイイじゃないですか。お疲れさまでした❁
A	ポプテピピックのOP歌う人多いなw 原曲スキップしてたからちゃんと聞いてからまた聞こう
蜜sugar#歌う中学生	うわああああ✨ かっこよすぎて何も言えない 語彙力
ゆあ	いっぱいちゅきです😢😢😢😢💕💕💕
まる まる	自己顕示欲〜 エイサーイハラm 殴
わし子	横顔イケメン
Bloodyroth	うぽつです！超学生さん、いっぱいちゅき❤
みう	カッコよすぎです 大好き ु ›ω‹ ु♡
ふう	ええわ〜
ひじり	投稿お疲れ様！まさかの！ポプテピピック！ 精一杯かっこつけながら歌ってるの本当に愛しい ´ཫ いっぱいちゅきやわ
レイン	いっぱいちゅき
ノズ	最初から神。そしてかっこよい、さすが超学生様 ´•ω•
夏瀬	見る前から高評価押す。なんで１回しか高評価押せないの… ´›ω‹｀
みたらし団子	超学生さん……。 いっぱいちゅき💕
なかち萌え袖	いっぱいちゅき♡♡照明が最高にパリピってる あの、超くんがちょくちょく壁の方ぷいって向くの大好きですなかちですどうも ✐自分用に✐ 今回のおすすめは0 00 3 13かな〜！ 0 02 最初から最高、、 0 08 う、上からくるぞ！嘘です右ですね 0 35 おててかわいい 1 06 しゅき 2 15 ぎゅって感じの音質 語彙力無 しゅき 2 50 おててかわいい 3 01 おててかわいい 3 08 最初に書いてた壁ぷいまさにこれ。しゅき 3 09
ゆうま	イケボだ… ´ ω ｳﾗﾔﾏ～
LOVETEN PROJECT【official】	いっぱいちゅき
莉緒	何これ… いっぱいちゅき♥
Lv.0 ch	いっぱいちゅき♡ が1番合う
ねぎ	いっぱいちゅきだぁぁぁぁぁ
えのき	うぽつです！出だしから和みました ∩ˊᵕˋ∩ 今回も照明など凝っててとても素敵でした！！
#みる	実写とかもう、、 いっぱいちゅき すぎて
まーくん。	いっぱいちゅき♡♡♡ポプテピピックのOPもいいし、超くんもいいわぁ ͡° ͜ʖ ͡°
ねじゅ	いっぱいちゅき♥
はるかけるさん	うぽつ〜！歌も編集もかっこいい〜！光がポプテピ感ある〜！ 世界をリメイクのとこの手が個人的にちゅき♡
Su mi	うぽつｗ
百瀬はるた	最初の笑っちゃったのめっちゃ可愛いw実写めっちゃ嬉しいですありがとうございます、、これで白米3杯は食べれます🍚🍚🍚
莉瀬良くん。	さ、最高です ｻﾞﾜｻﾞﾜ…
納豆さんは女の子です	まさかのポプテピピック！！ｗ かっこいいしゅきぴ
さお	素晴らしく素晴らしい！！ 最初ヤバいｗｗ
みみみ	初っ端から笑ってるww
となりの小麦	実写映像きたぁぁぁぁぁ！ やばい やばい！
