Mariz Mansueto	😍😍😍😍
Marie Rose Dalo	Galing mo bb nandito Lang kami support sayo 😍😍
Kring Falogme	😍😍
kanalen balaguer	go mama meh ang galing mo tlaga
Rhose Docot	Ang ganda ng lyric tugma sa ngyayari sa amin ng bf q Madaming question but alam namin susugal kami sa pagmamahalan nmin Gaanu man kadaming humadlang Ang hirap nakakatakot yung feeling n baka ma failed ka sa laban Pero ma masakit kc ung susuko kna agad ung wala kang ginawa ung iiwan mu siya sa ire Para sayo Mahal Susugal aq Dahil Mahal na Mahal kita😍💪🙏
M	Hahahahahahahahahahaha
Baile Antony Escabillas	parang anime ost silent voice ba yun ewan
ghel villareiz	Mamameh slayed it😍
Charles Agudo	I hope makaka place ang kantang ito Maganda siya at very catchy Lalo na ang MV
ajieching u choo	Im mayward fan But i love mari Naka LSs ung mga kanta niya Keep it up girl More blessing
Some 1	
Lhetskie Magbanua Oquiño	💙💙💙 sweeet
charlz Miralles	mgnda to gawing sayaw ang knta ni mari ma bet q y0ng Mas Mabuti pa ni Janine
Sally Soriano	Hi mari a silent fan here goodluck and God Bless
wisdom fontanilla	mari
jemimah Grace galera	No need for auto tune Hindi fan pero wala lang ewan ko ang appeal nung kaba nya eh bagay sa song Parang isang dalaga na kinakabahan sa pagkanta kasi nasa harap nya yung crush nya Hahaha Super bagay ha galingan mo Maris I like you more na more na
Mae Depilo	Congrats mar 💕😍😘
Cathlyn Benal	mari congrats
Michelle Pabiles	Galing mo Maris ❤️ isa Dalawa Tatlo susugal ako ❤️❤️
maricel lucero	New Gen OPM Acoustic princess Mabuhay ang OPM
Glazie Agustin	😍😍😍ganda ganda Maris
Brich Maglangit	maganda bos niya
PJ Arca	Mahirap ako paiyakin pero bakit napaiyak ako sa song nato 😭😭😭
Aj Nillasca	RELATE MISS SONG WRITER I SALUTE YOU SO PRETTY VOICE MARIS FIT IN TOO MUCH PERFECT SONG
charyl guiawan	Ganda mari Galing sa puso ang pag awit
Drew Vlogs	Maris💜
Rakista Ako	Ika 10 kong binabalik balik pero may tama talaga ang kanta para sa kin Sana itong song ni Bebe Maris ang manalo
Angeles Velasco	Sugarol by mari racal
Mon Hannah	😍😍😍
ayen delacerna	ang GANDA galing mo mamamehh
You Tube	Panalo na to
Mhonou Rocco	congrats mari ang ganda ng song
Maymay28	Don t forget po to vote si Maris last year nanalo si Inigo papanalunin din natin si Maris ngayong taon Let s vo l te in For the love for Maris the half of Marnigo 💙💙💙
Edna Carlos	Congrats mari lab ko un song mo
Janen Talon	Maris❣
Junivel Wenceslao	Halatang kabado
Goblin's Bride	So lambing ng bos ang sarap matulog pag pinapakinggan to 💗
Rizalyn Cantal	Big girl kana talaga bata 😭 proud kaau me nmu dzai congrats 🎉
laura canto	ang galaing mo naman mama meh proud nof you
imelda inogacio	Goosebumps bata Susugal din kami para sayo Maris Love you bata
Levin Galceran	nakakahilo ung camera man
Joy Ceno	She deserve to get a million view
im wawa	my super duper fave this year himig handog ❤️
Mylene Famulagan	hala halatng kabado di hit ibang note pero ok lng yan more prcticr at singing lesson para pak na pak anyways buti kasali ka na sa himig handog matagal na tlga naming inaabangn to for you God bless
Analyn Medrano	bagay yung voice nya sa kanta
Syra Colipano	Talagang Susugal na ako 🔥
lheenzkie A.S	Sarap naman sa tainga Boses mo mari panalo kana LAHAT NG MMAHAL SUSUGAL talgaa Kaya sugal kuna talgaa kanta mo panalo sa himig handog
jazz dleon	Kinakabahan siya or wala sa tono
Sharry Socao	Paano ang pag boto Ask ko lang thank you
Taiba Salani	Galing mo Maris ganda ng voice galing din ng pgkainterpret so proud of you
Fil Jasper Calizar	she look like selina gomez here
marco romero	sakto lang naman pero ma magiging maganda sana kung si moira nag interpret nitong kanta parang ma bagay sa kanya
YOWYoona	I m not sure ah pero parang ung song is made for a guy s voice pero Maris really did a great job interpreting this ❤ not perfect but I m loving it It suit her 💕 I m not really a fan but I listen to her current song 😉
Grace D.	love you MARIS
Joven Dr Ausen	Ganda ni mariz
pretty dumb	i thought it wa an ugly performance since some of the comment said so but after watching the video I realized that it wa the bashers who were finding the flaw
Elene Ogahayon	Shaky voice
Russel Pereyra	parang titibo tibo♡♡♡♡
C C	Parang sintunado
Itsme Sofie	yoko na mag tell hahahahahahaha
Candie Libradilla	Ang pangit ng mga kanta ngaun D tulad dati
Catherine Cruz	kayo na po ang panalo
Jerome M.S.	PROUD NA PROUD AKO AS A FAN MARIS ACTUALLY INISIP OO NOON NA SANA MAKASALI KA SA HIMIG HANDOG NAPANAGINIPAN KO PA YUN EH TAS NUNG PINAKITA SA TV YUNG MGA INTERPRETERS ND NANDUN GRABE DEJA VU FEELING YUN SAKIN 😊😘
Shy Etabaz	goosebump
Emily Salise	Good luck MAMAMEH 😇❤
Simsimi Amore	Susugal sya Iñigo Susugal kadin ba Haha chosss😂 Love you Marñigo💙😊😘
Blessie Galapon	CONGRATS MARISSS NGAYON PALANG SUPER PROUD NA KAMI SAYO 😍
goldwin818	Realtalk lang tayo ah Bakit pinakanta sa kanya to Ang shaky nitong live Tsaka hindi swak yung emotion Even the recorded version wa not that good The song ha potential pa naman
66587409 iglesias	Good luck Maris ganda ng mensahe ng kanta lamig ng bos
Rahma Rossana	Love u Maris ang sarap sa tainga lalo nat naka pikit ang iyong mata try nyo
Mary Grace Nueva	Ang ganda mo Maris Mas magaling kayo God gift to you and more blessing to you always 😊😇😍〽🎵🎶🎤
rasty columno	Galingg ❤️
Benjamina Victorioso	go Maris for the win ganda ng lyric at napakalamig ng bos mo love love l
LOISAANDALIO RONNIEALONTE	Ang ganda ng bos ni maris😍❤miss ko na LoiRis
Mansing Berro Amen	Congrats mari racal galing ng voice mo
David Ornedo	God is always with you You interpret that song with angelic voice Hindi man siya birit Pero ang sarap pakinggan tagos sa puso ang mala anghel na tinig mo Itong kantang ito ay pang masa puede sa kantang pang bayan pang ofw isang hakbang patungo kahit di sigurado isa dalawa tatlo susugal ako sasagot salahat ng tanong maghihintay ako I love it Superb word for hope and encouragement
Deminesh 88	Ang ganda ng meaning ng song And to Maris nabigyan mo tlga ng hinihingi ng song na emotion Galing mo maliban lang sa ramdam yung pagka shakey ng voice mo Sana baby girl sa final be confident na tanggalin mo ang kaba mo SUGAROL
Jonalyn Panalon	Go Mamameh ❤
Olive Millares	20× ko nang pinanuod ang ganda ng song at ang soft sweet ng voice ni maris😍😍😍 Loveyou mari Go for the win👍👍☝️👏👏
Valerie Joyce Prado	Ang galing ni mamamehh👏👏👏
Yman Paguntalan	Kung may dala syang guitar on stage maybe her nervousness ay mawawala
Joan Del	😍😍😍😍😍
Aila Kathleen Maco	Go bebeh ❤️ Bagay na bagay sa bos mo yung song
evelyn marcellana	Ang ganda ng bos n mari sobrang proud me pray ko manalo
Lilibelle Gonzales	Gustong gusto ko yung kanta mo mari halo lahat ng kanta mo ang sarap sa tenga pag pinapa kinggan
Reiji —	Kng meron mang sasalo isa dalawa tatlo susugal ako loveyou panggamaris
EJ EVAN Medina	Baliw na ako sa kantang to si mari pa kumanta 😊😍😍😍 galing galing 🙌🏻🙌🏻🙌🏻
thefirst one	my sweetest mari
Mk Abellana	go Maris and next finale huwag ng kakabahan ha😊 good luck and God bless
aileen jornales	Maris😍😘 Bagay na bagay sa bos nya Di kailangan bumirit pero perfect yung voice nya sa song 👏👏👏😍😘 Laban mamameh😍😘💞💕
Jj David	Trying not to be so emotional This song is my HH fave this year ANTHEM SONG PARA SA LAHAT NG GUSTO MAGMAHAL ULIT😭
bhong green	I suggest sa music video nito If lang naman She is wearing beautiful white dress while walking in d forest tapos sa bwat daang natatahak may mga memory ahead Basta ganun Hehehehhe
Ruel Ferer	Maris bat ganun napakalamig ng bos napakaganda ng song nato huhuhu 😭😍
ELLEN TUAZON	Please let s help to make her win She deserves it
itchy normz	sinong ma sikat mari o loisa wla lang natanong ko lang naman pero pareho ko silang gusto since pbb pa pero ma nangingibabaw si mari sa puso ko waaah may ganun
Cubao Farmer	I like how Maris interpreted the song The arrangement is superb Pwede ko pakinggan to maghapon magdamag ng mga dalawang buwan Alternate ko yung Wakasan ng Agsunta Solb na buhay ko 😇
Charmaine Lopez	Itataya at isusugal ko ang kantang ito Maris Ganda ng pagkainterpret ng song 😍😍😍🎤🎧
Cremia Quimbo	Go Maris😍
thisisme 08	sugarol for the win
Yhang Minguito	Am proud of you my stella
Ramelyn Vigonte	Ang ganda
OSCAR EDIG	Sasamahan natin si Maris susugal din tayo sa kanya panalo God bless everyone
Rosalia Rellon	Sarap ang bos mo sa tinga mari bata ❤👏👏👏👏
Ann 43	for a first timer to join a contest like this bravo to you mariskie alam kong kinabhan ka sana sa final mwala n lhat ng kba mo just enjoy the moment win or loss pnalo ka pa rin sa amin ❤️
Sandab Asliya	Galing mo mamameh
chess addiktos	galing Maris for the win 🏆👏👏👏
Jang Kyungsoo	I watched the four remaining himig handog contender yesterday and sobrang gagaling nila Goodluck MARIS
Jesel Cañete	magaling pa c loisa
Jean Empinado	Galing mo mari panalo kana
Edwin Rosite	Khit nman kinabahan xa na interpret pa rin nia ng maayos Ung kanta nia lng ung kakaiba chill lng very catchy at madaling makarelate sarap pakinggan
Sky medina	Lol Bat ang layo sa live shaky eh Opinion lng naman 😉
Kenneth Ajero	Ang galing mo ganda talaga ng bos mo maris❤️❤️❤️
Ann Ibasan	Ang galing 😍
We We	Msrp pkingn sa tenga ung kanta ni mameme congrats
Roberto Tubilan	parang kinakabhan c mari ung bos nya iba pero maganda parin👏👏👏👏
merieniza hisola	Yes Go bebeh Maris🙏🙏🙏 For the Win🤩🤩
Rose Pantoja	No matter what Maris we will support you Ang galing mo grabe 😘😘😘
Ernie Edar	😍😍😍 I m speechless kasi ang Ganda talaga ng bos mo Maris
Marjelyn Mabanding	Galing mo Maris Congrats
loi munar	No doubt basta c mamameh lahat kmi MS LT MN VFs Bisdarock khit ano png grupo magkakaisa pra s NAGIISA NAMING TALA MARIS RACAL wala ng iba
Raziv Maito	👏👏👏
Cherry Rose Inguillo	love the song and the singer LSS
BlackTwice Fan Forever	sana maging millenials choice to go ate Maris
Stellar	👏🏻👏🏻👏🏻👏🏻👏🏻👏🏻👏🏻
Mae Disu	Lamig ng bos nya
chandria olivia gemillan	Ang ganda ng quality ng voice niya
Earl Gomez	first time ni mari sumali ng ganitong contest good job mari 👏🏻
Jonaida Pedazo	laban kong laban Sugal kong Sugal ganda na ang nag fan s nya susugal kami ParA sa kanya
Dont Me	eto lang talaga yung inaantay ko sana manalo ka mamameh sugarol marisracal
MCM O	This song ha the same vibe a your L I E Very catchy It get stuck in your head very dreamy wistful like what everybody else is saying you just need to shake off the nerve and you ll be good to go
Jeremy Arellano	Ang galing 👏
Chella Bete	mari u did it i like ur song so pretty soft pakinggan
raquel onez	i want to vote this song how to vote please help how to vote no ending of LOVING this is the reason na patuloy pa rin tayong lumalaban para mabuhay
Andrew Gonzaga	She deserves to win ❤
WATCHTODAY NOW	Kasi c mari pagkakanta yung tipong galing sa loob so sa mga listener s ma feel no talaga lalot yung kanta ang ganda ng mensahe
Gladys Guiao	Better pa rin kahit kinabahan
jennilyn dalubajan	kinabahan c mari ok lang yan galingan mo nlng sa final but i love her voice
Jhanine Borromeo	Bakit kaya ako naiyak😭😭😭go BHEM
Miracle Fuentes	Lodi 😘
Gogel Meal	ang ganda ng kanta bakit marami ang nag dislike gising yata ang mga bashers ni mari
Mariel De Guzman	Kaba ngiti proud Yan nararamdaman ko while watching her nakakaproud tong batang to
rhia marasigan	The best talaga
Dom Pascual	Wow Stella ginalingan mo masyado love you always my RockStar Keep shining Tala were here always to support you and Papapeh❤❤❤
gina gavinp	Very supportive tlg c inigo ung nerbyos n mari add flavor sa renditon nya ng kanta manalo sana
Jeff Ballera	Titibo 2017 Sugarol 2018 💁🏻‍♂️
genalyn valenzuela	Congrats mari
Nheng Casingal	Inulit ulit ulit ko😍👏👏👏
MarNigo Lang Sapat Na	Congrats Mamameh Sobrang galing mo 😭👏 Goodluck sa final 🙏
Rojan Dale	Definitely one of the best song and interpreter this year Sure win na to susugal ako
jerah pinca	nice song Beautiful interpretation
Vaneza Dalumangcad	Maris 👏👏👏👏
Babylyn Manalo	Wow mama meh lodi na talaga kita kahit kabado ka ganda pa rin ng bos mo proud kmi mga fan mo 💙💙💙💙💙💙👏👏👏👏👏👏👏 SUGAROL 4 THE WIN
Zelle Quin	Sa lahat ng entry ng himig handog ito yung nakakaLSS
Maricris Macariola	Matanggal lang ung kaba niya ok na ok ito pero may final pa naman pwedeng pwede ka pa bumawi
Tess Fortaliza	ang galing galing mo Maris
rod Dela Cruz	Halatang kinakabahan sya pero ok naman performance nya Maganda ang melody ng kanta
Sheina lyka Dalumpines	Ang galing netong si Maris
Vivian Porras	Congrats mamameh
sebab Reyes	Not just in love pero yung lyric applicable sa buong pagkatao Bagay sa tunog ng pag awit ni Maris Go Pinays sugal sa hamon ng buhay Gogogo Maris galing Support ako dito HH2018
Premier Boys	I m a BoybandPH fan but I have to commend Maris for her interpretation of this song This wa meant for her Di naman talaga kailangang bumirit to make a song great Mabuhay ang OPM Mabuhay ang Pinoy Pop
Marjorie dizon	Di naman kailangan bumirit para manalo kay moira song last year swabe lang din pero nanalo Magdadala pa rin message ng kanta and how deliver na song para sakin panalo toh
Noriel Albia	I heard this girl sang before and i loved it But i got ta say this is the weakest live performance for himig handog entry so far
Ros Sacluti	Huhuhu kaproud ka Maris
ginia alejandre	grabe ung lyric sinabayan pa ng bos ni mamameh kasakit sa heart oy hahaha
Bella Fritz	Go Maris
Lamalan Saguira	gandan ng song mo baby girl ilove you lagi baby mari
Lorrie Buncaras	Congrats Mamameh So proud of you 💙😊💙
random account	Kilig ako sa comment ni Inigo 😂 this song is my least favorite tho kung di si Maris kumanta wont even listen to it 😅 Just want to commend Maris kahit shaky siya maganda pa din ☺️
Matet Lim	Habang pinapanuod q 2 ako y kinakabahan hahaha kc ang galing galing mo Mars 😘😘proud of u
Jo Cancy	I like the song and Maris is the perfect choice to sing the song Hindi kailangan ng birit sa kanta bagay na bagay yung bos ni Maris sa song She ha a beautiful relaxing voice soothing to the ear Sure winner ang kanta
Sarah Pasia	One of the best Himig Handog Song Entry for 2018 and Interpretation husay mo Maris lalo na live singing Suenatics will continue to Suepport you 🙌🏼💛 God bless sa kantang ito 😄 SueRis 🙏🏼
Mitch Khomaya	Galing ni bata ui proud of u
Cristina Madriaga	mananalo ka mari susugal ako
marie MarLex	mejo kabado si bata ah hehe pero ang ganda tlga netong kanta eto bet ko manalo
Jonah Calijan	Mamameh graveeeh parang ang hapdi NG puso ko Go go go mamameh C papapeh number one fun talaga
Leslie Anne Pernites	Ang galing I love her Ilove the song a well
Jhazel joy suarez	Wow ang gling ni mamameh idol ko cya since pbb di nkkaswa bos niya proud fan here
Ailen Acero	👏👏👏❤️❤️❤️
eugene Libres	She look so beautiful while singing
dyna alit	bat naiiyak ako evrytime kumakanta si mari but this time iba feel na feel ko ang kanta love you na mari ❤
Raymond Mananghaya	Sam mangubat fan here Pero tingin ko ito ang mananalo 😍 nakakaAdik yung song
Vanessa Gayle	Laban dzai ♡
Vymber Dwayne Cadutdut	I ve been watching all s0ng ntries i like more on Mas mabuti by Janine berdin Goodluck singer
Amulan Aisha	Gnda
Lily Rose	The song is a runaway winner
Josephine Cruz	Lamig ng boses😍
Jhoana Marie Tiu	Congrats si Maris sugarol forthewin
Mark Yason	Maganda xa pero sana wag ng pilitin pakantahin Sa quality kc ng voice kitang kita nman na hindi singer
jhonham	Inabangan ko talaga to sa tv kanina mamameh pati ako kinabahan diin sau pero naitawid naman Congrats mamameh 👏👏👏👏👏 ang galing galing mo 👍👍👍👍👍 susugalako mananalo to
cazie rack	Goosebumps Grabe yung voice mo Maris Racal ang ganda talaga And this song Sugarol is really catchy First choice ko talaga ito Kudos sa composer Ms Jan Sabili Panalo ito Claiming it😍😍😍
ria jam	Kabado bebe Maris Pero proud of you Praying manalo ka
Adaquis pugoy	75 na nag dislike yan yung isa sa mga bobong fan ni loisa
Grace Carcallas	SoProudMamamehSilentFanHere 😍😍😍
yehyeh yow	Ganda daming relate😍
Jhade Nolida	ganda congrats Maris racal
marieta villanueva	Congrats Maris ang ganda ng song👍👍👍👏👏👏
Jl Lause	ay ka nindot man pagka deliver ng song ni mamameh nindot paminawon sarap pakinggan ang ganda din nung lyric ng song ❤️
Charmaine Robles	Good luck s final bebe Maris lagi mong tatandaan whatever happens we love you at lagi kaming resbak mo God bless u just give ur very best God will do the rest proudfan proudmariestellers
Marilyn Valenzuela	Maris sa Grand final Sana wag ka kabahan Gustong gusto kita manalo Medyo kinabahan ka kanina
Connie Tuazon	Ang ganda ng song Isa sa mga bet kong manalo Go Maris
Waren Paul	Ganda ng lyric Gusto ko rn yung sytle ng song kaso ung pagkakanta lng hirap kc pag live hehe Gusto ko marinig ung song sa recording ganda siguro nto 😄😅😊 gud luck mari
C leane Ni	kagwapa nimo dzai Congrats in advance
Myra Garrido	Sobrang ramdam ko yong song galing ng emotion ni Maris nakakaiyak
Jonalyn R	gandaaaa talaga ng bos mo 😍❤
wred	SAYANG YUNG KANTA MAY SINGER DI PINAPAKANTA KASI
Yholz Reyes	galing talaga ni mamameh ❤️😍
Lolita Goodpaster	A little pitchy but I still like it Good luck Maris i support you no matter what you are number one in my eye
MJ C.	Ito yong kanta na dimo kilangan magbirit para sabihin na maganda at magaling ka kumanta Ang importante kinanta mo ng maayos at galing sa puso mo Congrats bata ang sarap lang pakinggan napakalambing ng bos mo
Joanne Poloyapoy	Sobrang ganda Maris 😍😍 Next time huwag na kabahan ah Napakagandang ng bos mo Sarap namnamin Susugal aq sa kantang to 😁 May laban to
aljehan gampong	So proud Mars 😭💞
Ruby Ann Laude	Napakagaling m tlga LODI❤❤❤❤❤❤❤
Czar Cajayon	Congrats MMM 😘😘😘💕💕💕💕
Bernard Borja	Ang ganda rin neto 😍 Parang yung kanta may pagkasimilar sa Mga pagsubok lamang yan wag mong itigil ang laban parang ganun lang sya
Jesyl Bornea	ang galing sobra ganda ng boses👏👏💙
Jeshlie Didulo	Wow
Maecompracion Chavez	Susugal kami para sayo Laban Lang Bisdak
Lezajane Casawitan	GOD BLESS YOU Maris you really did a great well done Maris 👏👏👏
Anna Quiambao	Sobrang ang lamig ng bos mo Maris bumagay sa song susugal ako for the win😀😁💙👏🌟
Zel Elbanbuena	💙💙💙
krizza cairel	my love
isay bejamin	matalo manalo ikaw parin ang panalo sa puso namen mga tagahanga mo ang ganda ng song bagay dn sa pagkatao mo gud luck sau sa Himig Handog grand final 2018
Zayn Style	love the way she delivered lyric it wa comforting my head when I m bored and down sleepytyped 😘MARIS
Liezel Ubas	ang galing mo mari pero ramdam ko talaga yong kaba mo kinakabahan din ako pati nextym wag mo isipin wa na contest yan super proud ako sau grabi ganda ng song tagos sa puso yong pgkakanta mo
Mervin Navejas	Naunahan nanaman ako ni Iñigo mag comment Hahahahahah Proud of you mamameh Keep shining ✨🤙🏻
Karen Labra	Goose bump GALING 👏👏👏
Carmina Samboang	Go gnda
jinky luna	Oh my God ito na pinakahihintay ko galing mo talaga mari ganda pa din pagkakanta mo kht felling ko kinakabahan ka super ganda talaga bos mo ikaw na mari for the win😍
FinalFantasy24 Trigger Blade 2018	Sayang un kanta ok nmn s knya i lov Maris kaso lng ma bagay yan kay mora or juris
mama mo	1 dalawang pag ibig niya 2 sugarol 3 ma mabuti pa 4 kababata ito yung order ng nag shine kanina for me diko inexpect na ma ha hype ako ng mga bata kanina hahaha tapos si mari naman parang si yeng yung timbre kaya dama mo talaga si janine grabeee din si angeline naman tapos yung nag rap napaka puso ng kanta naiyak ako pero diko nagustuhan yung arrangement parang nagsasapawan sila ni angeline tapos nasobrahan sa emosiyon pero superb parin no 1 yung dalawang pag ibig niya for me kasi sila lang yung up beat yung song tapos sabay sabay yung sayaw kaya na hype talaga akooo maybe kasi this fast few week puro pang broken yung kanta tapos napaka lungkot kaya ganun hahahaha superb ganda ng himig handog ngayonnb
Kath Sand	Galing Maris I love it your interpretation to this 😘😘😘😘😘😘😘😘😘😘
Maricel31 Bagan	ganda talaga bos mo mari good luck saiyo pray naten manalo c mari
Angel Garcia	Susugal talaga ako sa kantang ito Wow ang lamig ng bos ni Maris Ganda ng emotion nya at ang ganda ng face ni Maris Goodluck and God bless 😘
Iris Guiral	Congrats baby mari Napakagaling mo at napakaganda ng song Sarap lng pakinggan I m sure mananalo ka I ll pray for it
Stefanie de Villia	Sobrang galing mo Maris susugal kmi para sau we love u
Rose Villegas	Normal lang na kabahan pero sana next time kontrolin mo mari Wag mo ipahalata na kinakabahan ka kasi nagiging shaky yung voice mo Sing your heart out a if no one s watching Wag mo masyado isipin na contest yan wag mo masyado isipin na magagaling yung ibang interpreter Focus on the emotion of the song kasi malaki ang panlaban ng kanta mo Do your best next time aryt Just enjoy the show
Michelle Galvez	Sobrang ganda ng voice at tagos sa puso
Funny Fanny	ganda 😘 ang panget ng kanta ang plaplastic ng mga tao dito 😂
vaLLOYDor	❤
MR mv	❤❤
Cesarina Ayon	Ganda mamameh👏👏👏👏
Jaypee Pedro	Wow galing mari ang ganda nag lyric
NicNic Gabinete	😭😊
Iris Cardoza	Naiiyak ako😭😭😭😭😭
geraldine buquil	galing
Erwin Dizon	😍❤️❤️❤️❤️
lyn tian	OMGGG GALING TOLOGO TALENTED 💖
Ricmar Bullos	kinakabahan sya sayang
Indaira Usman	Majestic mellinial Maris Racal wew sarap pakingan Go for win godbless u mamameh
Ginalyn Cainto	Yieee congrats Maris ❤❤❤
Hector Jr Kapa	ang lamig ng bos mo mariskie congratz in advance
eisz P	ang galing
Mylene Morga	Good job bem 👍👍👍
Mia Kelly	😍😍😍
Shane Samilliano	OMG ang galing galing mo mamameh im so very proud of u 😘😘😘
Baileta Love LQ	Maris Racal Parang Yeng2 kase ang galimg nila mag composed ng kanta Galing2x mo Maris Lodi FTW 😊😉
Victoria Casisirano	Very well sang Mars 👏👏❤️😘
Elma Rugas	Naiyak ako sa kanta MO Baby Girl Love you mari
Mherz Aposacas	Wow sugarol is a beautiful song The best Maris
Kerwin Llena	My fave for Himig Handog 2018
Ola Chu-chu	Go mamameh💙💎
saeilme tae	Ang ganda
Rey Balan	Feel ko yong kaba ni mamameh dito Pati tuloy ako kinabahan habang tumingi ako sa kanya nag perform Peru ang ganda parin nang bos niya Sarap sa tenga ang bos bos ni mari Congrats my baby girl Marami kaming susugal para sayo So proud of you
Mj Abella	Ang galing galing mo mari
Milagros Clemente	Lambing lang ng bos sarap ulit ulitin Go for the win mama meh 😚
Mhae Ang	😭😭😭maris❤️❤️❤️❤️❤️❤️napakasarp sa tainga Ang bos mo ♥️♥️trully u deserve this opportunity 😗💋god bless u always
sakina said	Sobrang sarap sa tenga 💕
Faith Karen Festejo	Ang galing mo mamameh Proud na proud kami sayo lalong lalo na si papapeh
onbi my	Sintunado
Firlyn Elcanto	Bet ko tong song na ito ang ganda at ang lambing ng bos n Maris congrats mari
Francine Sevilla	Sana manalo si mamameh 🙏🙏🙏😍😍 Sarap sa tenga😍😇
Sale Shareenmay	Halata yung kaba ni mamameh Shakey ehh pero juskooo parang nahinto paghinga ko sa kaba Your amazing Bebe girl Ilalaban ko to kahit tahimik Relax lang Sa final Inhale exhale Ok Luv u
Joan Sagun	👏👏👍❤❤
Regina Cahanding gina	Loveu susugal ako sayo bby Maris proud na proud ako sayo GOODJOB GODBLESS U MORE MORE 😘😘😘😘😘
Rea Noveno	ang galing ni mamameh 😍😍
Nancy Visaya	Super supportive
Binibining Chin	Grabe tooo
Chelsie Mendez	Sugarol
Kristyl Joy Jamillaren	Ang galing mo talaga Maris😗
PamelaRossan Calimlim	Proud ako sau mamameh👏👏👏👏👏
Rialyn Belando	Congrats mamameh sobrang galing po ninyo 😊
Mac Wrecker	Isa dalawa tatlumpong be ko na inulit 💕
Lhen Oronan Sigua	Grabe sarap sa tenga congrats MamaMeh ganda Ng song panalo to for sure 😘😘
Aa Aa	Galing grabe
Rosemarie Sarancial	Ya Helwa Habibti👏👏👏 😘😘😘
Leonila Castro	wa nu inigo mahal mu tlaga c mama me no sana ingit aku walang iwanan 0
Ylrehs Dominguez	Congrats MARIS 😍😍😍
Edmon Laureles	Whoooooh Sarap sa tenga Congrats Stella 💚
Its Yana M.	Congratssss Advance ako magisip
Rica Nucum	We felt the nerve haha But it s a job well done God bless you Maris Your voice wa too sweet
EMDcabrera	kinakabahan c mari OK lang yan mari Alan nmin first time mo
Jadenna.polvorosa Tatapogi14344	👏👏👏 mari 😘😘😘
Mesbah Uddin Ahmed	Great
Realtalk Casual Viewer with Honest Opinion	My 2nd fave song in himig handog😍😘
Rosal Advincula	Goodluck mama meh congrats
Mena Purino	Beautiful interpretation by Maris ang soft ng voice
Fan Girly	💙🎶😍
Rho Mar	😍😍
xiannn	Medyo kabado pero naitawid naman Hoping sa final ma confident kana malaki chance na mananalo ka
Dafny Earl T. Poblete	Galingggg mo Mariestella ❤👏👏
Mabel Rodriguez	Winner to 👏👏👏👏👏👏
emely milano	galing ni Maris go for the win
carmie aki	galing mo pretty Maris Sugarol
Chie Sendin	Sing from the heart malaki ang pag asa natin Congrats you did it💙
Mai Tan	Partida po kinakabahan pa yan ta first time to join a singing contest natural born performer talaga itong si Maris teamtalent noautotune we will support you tala all the way 💙🌟
Mere Ch'lle	sarap pakinggan ng bos mo Maris
Nena Cuevas	Marissss lng galing
Juliete Gacita	Kaya mo yan mar lamig ng bos mo susugal talaga aq dhil sau 100 😍😍😍
Che Burce	Congrats Mama Meh 3 SusugalAko MarisRacal HimigHandog2018
arci constantino	go go go baby girl💙💙💙 mari
pia bonillo	😍😍👏👏
Shylla Jaron	Ang ganda ng voice mo Maris kahit kinakabahan ka nang konti Sana sa final hindi kana kabahan Mamameh kasi ang galing mo Para sa akin ikaw na ang panalo Good luck sa final Mamameh
niel john	She ’ s getting prettier 0
katzzz 728	D nman ganito kanina sa asap napanood ko clear sya bakit ngaun inupload may ibang sound na naririnig
EXO-L forever	Galing 👏👏👏👏👏👏
charlot ilagan	lamig ng bos galing
rahc eniam	Habang kumakanta sya knina ako yong kinakabahn eh Bat ganun Hehehe Love you mamameh galing mo👏👏
Draye	May kissing scene sila ng microphone 😂
Janeen Pauline Rose Estuesta	Ang galing ni ate mari kahit kinakabahan
Genevive Sosas	Panalo to susugal Ako Maris 😍
Te Amo RJ	That angelic voice of urs😍😍ahhhhhhh Feel na feel ko ung kanta nkka LSS 😃😃
Jenifer Granado	Susugal ako that this song deserves an award super relatable and l Yung lyric good luck Maris 🎶❤
Danyal Danyal	daming mong time para magpractice at sana mag voice lesson ka para pagdating sa stage di ka kabahan
mayeth guintibano	Omg Mariskie ikaw na proud of u 👏👏❤
09107048199 Beng	Maris wow grabe npaka soft voice mo pra kang dinuduyan lng nka relax 👏👏👏
Marie Naim	👏👏👏👏👏👍👍👍👍👍👍
Nerissa Bamiano	Ang galing mo mari ok lng yn khit medyo kabado kc nga first time nya sa singing contest my final p mamameh sna mwala n yng kaba mo dto lng kme panalo kn samin
Ma Shirley Comesario	good job mamameh kahit na first time to lang sumaling contest
Lan F.	Pangit di ko alam kung ung kanta ung pangit o deliveru ni mari bilang interpreter
marilou mapinogos	Marnigo fan here but aaminin ntin kinabahan si mari sana sa final hwag ng kabahan at galingan pa nya lalo
Marefel Permejo	Ilaban mo hanggang final wag kang kabahan kaya mo yan tiwala lang gud luck sa final
ImInigoPascual	youre destined for greatness
Nimfa Olino	Pls vote Sugarol for Himig Handog 2018 by Maris Racal
Leizl Dialino	Parang grabe yung effect ng music Ano nga tawag dun Yung parang sa ex b
G Tala	Congrats my stella You did great Galingan mo sa susunod na round Loveyou 😘💙
Annie Soriano	GOOD luck mari praying for you
rosalie cadamao	Congrats mamameh 😍 💙😍
RJ Real	Nothing special
Josephine Nifas	ang lamig sobra Ng Bose s Ni maris👏👏maganda ang pagkanta para Kang dinuduyan SUGAROL ating suportahan
Dave Pagalan	Isang hakbang patungo sayo kahit di sigurado kung mayron mang sasalo susugal ako 🎶🎶 ang ganda ng lyric sure ako mananalo to
Kumiko Nakashima	Gusto ko yung kanta mismo❤
jhenznievaatanacio06@gmail.com 050686	Ginalingan din naman 😊😊 Goodjob mari racal best of luck 😘😘
Nasriya27 Kambang	Medyo kinabahan ang mamameh namin dahil first time nia sumanli sa singing contest pero nakanta parin nia ng maayos good job baby girl proud of you
Johanna Johansson	Congrats mari ang galing mo Yun ngang matagal na singer kinakabahan pa si mari pa kaya na first time sumali sa ganitong contest Mas bet ko yung ganitong music kaysa mga birit
Clarisa Solis	Galing mo mamameh
Veve Veev	mari for d win susugal dn kmi mamameh
Sayren Coberos	Gaing talaga ni mari graveh
Ivan M.	💙💚💛💜
Himig Judge	Base saaking sariling rate bawat kanta ng himig handog 2018 pinakingan ko This is my rating all over 10 Jona 9 10 Mnl 10 10 Sam 6 10 Maris 5 10 Agsunta 9 10 JM 9 10 Boyband 7 10 Janine 10 10 Angeline 7 10 Eumee 8 10 Yan ay base lang naman sa unang pag kakarinig ko ng song baka next week magbago kaya hintay hintay ❤
Yen Bermudez	Isa dalawa tatlo susugal ako hala nakakalss mananalo ang kantang to
Lyn Carcueva	CONGRTAS MARIS PROUD KAMI SAU ALWAYS
Kim Edward Ilagan	The vocal hmm there s a minor pitch problem and a bit shaky But I have to commend Maris courage to actually sing live on that stage 👏 Breathe and just sing it from your heart gurl
Nathan Quiait	Deserve nito manalo ang ganda ng lyric ng kanta at pagkaka arrange nong song
Nena Arceno	Dahil sa lodi kita kung kinabahan ka man ma lalo akong kinaban Just keep it and relax for the final You can make it Ang kaba mawala lang yan kasi nandito kaming mga sumugal sa iyo Huwag mong ipaklaeong kinabahan ka GOD BLESS
Princess May Maddela Manzano	First Time yan grabe sobrang galing agad 😍pero kahit shaky yung bos bagay naman 😘loveyou mamameh your the best susugal kami para sayo proud to be a fan 😘
Rose Ann Creencia	First time pero hand up gling bravo
Rj Lipat	So proud of you mari
Analiza Lindo	Congrats Maris galing galing mo talaga Goodluck sayo sa final round God bless
mylyne biniahan	ang galing 👏 👏 👏
Rocaya Tago	Ang galing namaaaan ni Maris 3
Loislane Arizala	Ang galing ni mari kumanta and ang ganda song
Jiorell	Maris best performance ❤️
Lucy Bacani - Tita Lu	Heartfelt rendition of the song Bravo Maris Sugarol for the win
Bryan Cabrera	Kung itong babae namn ang susugalan ko aba susugal ako kahit magkano pa
agnes panlilio	first time sumali ng singing contest pero wow ang galing 👏👏👏
Monira Daraba	Andito lng kmi mamameh💙💙💙 manalo matalo panalo ka sa amen😍😍😍
Lyn Maulana	👏👏👏💙
Midelyn Adier	Congratulations Mamameh Keep on fighting
Criselda Baawa	Congrats baby girl ❤❤😍😊☺
Norhaiya Lamalan	Congrats Mamameh
Irene Cunanan	Nkklss lamig ng bos mu mari Godbless ♥️♥️♥️
Fevy Mae Carandang	Congratulations Maris🤘
maylen tablo	I DONT KNOW WHY PRO NAIIYAK AKO DI KO ALAM KUNG SA KANTA OR SA KUMANTA NA SOBRANG PROUD NA PROUD AKO SILENT FAN HERE MARIS DI MAN AKO ACTIVE SA MGA GANAP MO PRO ISA AKO SA UNANG SUMUSUBAYBAY SA LAHAT NANG NANGYAYARI AT NAKAKAMIT MO LAB YOOOOOO
Mich Neri	Ang ganda ng song ang sweet ng bos nong kumanta Isa dalawa tatlo maghihitay ako ang sarap pakinggan sa line na yan
Rhodora Alcala	Kinabahan aq para kay mari love you mamameh congrats
Cherry Mae Yutuc	Good job Maris Fighting
[ Jailleunamme ]	SOBRANG LAMBING NAMAN NETO😊 MARIS WHAT A GREAT SMOOTH VOICE😊
Jay Jops	Kaiyak naman tong kanta
Paulette B	Im fan of mari pero to be honest may mga part na parang wala sa tono Anyways still okay
jamaica staine	nakaka proud na maging fan mo mag guitara mag piano kumanta sumayaw putekkkk yung na sayu na lahat ng talent
Riana Castro	Actually para sakin ma nakadagdag pa ng emotion yung pagiging shaky ng voice niya sa nilalaman ng kanta ❤
RoseChaeyoung Blackpink	Maganda yung kanta pero medyo nanginig si ateng
Judith Delmo	ang galing nman😍😍😍
Allia Cruz	We love you our Stellar You did great
gee elaine	iba talaga ang live performance marining mo qng ano kaibahan sa studio at sa live 😆😆👊🏻
Cres Shy	Galing
#Jocelyn Verdida125	Grabeee sa starting palang kinabahan na ako tumayo ang balahibo ko juskooo matgal akong nka move on klaro ang voice ni mari pero ang lamig OMG Kinibahan cya pero saglit lang basta tumayo jud akong balahibo we proud of you mari and we love you
Honeylyn Mondejar	From Riyadh I like the song
jimmy niegas	Love your curve and all your edge mari 😙😙😙🤣 goodluck😘
Lilybeth Jalbona	Galing mamameh🤗🤗😍😘😘
Grace Polestico	We love you mari super galing mo we will just support you in inigo allways stay happy to each other 💙💙💙
Yasmin Binolirao	Ang sarap pakinggan ng Kanta mo Maris sana Manalo god bless you
Sherelle Carpentero	Subrang sarap talaga pakingan bos mo Maris galing
Haize ceniza	👏🏽👏🏽👏🏽bravo galing
Sallymar Abdurahim	For the win sugarol by mari racal
Pam Novilla	Lahat na lang ng kanta ni Maris nakaka LSS 😍 Congrats Mamameh Naitawid mo Yaaas 🎉💙
Marc Maliglig	TARA TARA ILABAN NATIN TO HANGGANG DULO 😍❤️
tina soriano	shake those nerve next time baby but you did good sana sa final wala na yang kaba mo ha Ganda ng bos mo eh just be more confident Malakas laban ng song mo Susugal ako👌
Vanessa Ybanez	OMG gling mo mmm dmi ng ngcover nito at my ngmv nito sa ibng bnsa praying n mnlo to 🙏🙏🙏
zhai TvMix	panalo to para sa akin 😊
Tess De Leon	Slow clap fast clap lahat ng klaseng clap galeng eh
Dianne Prudencio	Gudluck nd congrats Maris ang sarap pakinggan Tung song mo galing mo bebe gogogo kalang GOD bless you
Joh Igloso	Congrats mama meh 😊😘
Charry Tayobong	Congratz mamameh ☺
Kiel Seriozo	Di ako hater basher ni Maris pero honestly ma maganda pa yung Performance ng dalawang bata kanina compare sa kanya Siguro kinakabahan lang kasi first time niya Pero maganda naman yung song bumagay sa bos niya at sabi nga nila there s always a room for improvement ❤️
Hannah Stephanie	Isa dalawa tatlo susugal ako ito ang panalo ❤
Jonalyn Dolendo	Ganda naman congrats mari
chitoge nisekoi	I feel u girl 👏👏👏👏👏👏👏👏 ganda ganda ang galing mo 🙂🙂🙂🙂 ahh hindi ko alam paano e parating sau basta ang galing mo 🤗🤗🤗
Chris Legaspi	Go Maris Be POSITIVE ❤️💙❤️
Shane Ella	you did great Maris congrats 😍😍😍
Minda Mitucua44	Super galing ni mari
Gemm16_ Bella17	Congrats Maris 👏👏👏Galing mo po 😊Goodluck Sana ikaw manalo Good song 😊
Mylien Favorito	Ganda sa tainga Umaasa pa rin Kaw manalo mari
Gellan Genaro	Galing
Tonio Lover	I think it s a well written song but unfortunately di nabigyan ng great interpretation ni Maris Masyado weak voice niya too shaky ng performance I thought it wa because this wa live but when I listened to the studio version parang ma bagay tong entry na to for Moira she would ve nailed this song Opinion ko lang po
charlyn serenio	makalss tong kantang to susugal ako
Maris Racal Videoz	Sobrang proud ako sayo Maris Goodluck sa final God bless ❤️🙏
Renmar Jumbas	For the win nato😍 galing mo mamameh😍💕
Yelene Sagge	galing bebe girl👏👏👏
Mrk Dane Tinio	Ganda ng kanta ganda pa ng kumanta ❤️💕
Michelle Bantayan	goodjob mamameh 👏
smartchic cutie	I love it Congrats Maris
Roel Samson	Galing mo mari racal im very proud of you
Renz Kieron Villero Mateo	ISA DALAWA TATLO SUSUGAL TAYO PARA KAY MARIS 💖
Vince FANBOY	First time ni Maris sumali ng ganitong contest grabe ang galing agad sobrang lambing ng bos at isa siya sa may pinaka malakas na fanbase sa Himig Handog interpreter asahan nating panalong panalo ang kantang ito ang daming nagagandahan sa lyric at nagagandahan sa pagkakanta ❤️
Shine Tiamzon	Sarap sa tenga
Mia Baunga	Bet for himig handog 😍
Kimberly Damiar	Awwww mari proud of u
Gemma Ormido	Ang ganda ng song parang angel lng uma awit
Dine ausrin25	Sugarol ang galing Maris 😍👏👏👏👏
truth sets you free	Angelic voice 😍😍😍💕
tiny cute	Good job baby girl
I swear I'm a soft stan	mukhang kinakabahan ang bata ok lng yan Maris you still gave your best
Vanessa Lim	Woaahhh galinggg
arlyn mendiola	for the win sugarol by jan sabili
Alvin Castillano	pakyo sa dalawang nag dislike
BabyGlenn TV	Yung emotion 😍💞💞
Medyo Maldita	Congratz bataaaa
Ma philana Aripal	Ang Dami nang nagdaan Madami ding nang iwan Nangako ng kaligayahan Hindi naman pinaglaban Sawang sawa nang mabigyan ng maling pag asa Kelan ba makahahanap nang hindi paasa Sakit sa heart 😭😢
Jeana Branzuela	Kung merong mang sasalo isa dalawa tatlo susugal Ako
Nancy Pascual	ganda talaga ei congrats in advance claiming it
Ruby Angelica Taroma	Congratulations Maris 😍
Philine Cercado	Galing
Pat Siwon	Kinakabahan ako at na excited ako kapag kumakanta si mari Sobrang galing grabe 💙💙💙
Lhonzkie Ang	Maris and Jan for the win Laban tayo for this MS MN LT and other ship Lets vote for this song Napaka realistic ng song ang ganda ng meaning Susugal ako for this Maris love you Sugarol
Ellen Khayie	Congrats Maris 💕 Galing ng baby namin
lucien VIP/frverBLJCKS kaneki	First time Ni Maris s singing contest medyo shaky pero mgnda p din Yung song at nbigyan niya tlga Ng emotion 😭👌👏👏♥️💙
Nona Hawani	Proud of you mari sobrang galing mo
Marilyn Amaro	Congrats baby mari We love you💋😍❤
Mark Cruz	Well done baby girl we love you💙🙏🏻
RICHELLINE BENITO	Congrats my talented baby
Joshua Ramos	CONGRATS IN ADVANCE MAMAMEH PANALO NA TO
Angelica A.	Nakaabang din ang basher Dislike agad Hahaha 😅
24 kaszylou	congrats babe 😍
JACQUELYN BATHAN	Grabe ang galing mo Mamameh
MJ M	😊
evalyn cacal	Congrats mamameh😍😍😍
Irene Matudan	ganda tagos sa puso
Jay Dee	Maris❤️
charisse shin	Ang galing mo sobra mamameh😍😘
Alsxamarjo C	Ang galing galing talaga
Nitrodjen Vlogs	labyu mari laban
ehliey yeileh	loveu mari galing mo kilan po start ng botohan tanong lng po
Jovelyn Leuterio	Panalo na to Galing mo mari 😉🤗😍
Vannessa Custodio	isa dalawa tatlo susugal ako
Laiza Ciriaco	Congrats mamameh
Hannah Lastimado	Galing love youuu
