سوما الحربي	💜 💜 💜 💜 💜 💜 💜 💜 💜 💜 💜 💜 💜 💜
Jin Jin	Like father like son
한도로테아	Jin💜
Keyza Simmer Simmer	Salanghaeyo BTS!!!!
Jessa De Jose	I seoul u💜 Jin💜💜
Alice	Jiiiiiiiiiiiin😍😭💝💝
Tae 1jimin	김석진 💜
Percy Jackson	I really want to study Korean history and try all of this, but I'm afraid people are gonna call me a koreaboo😂😤😭
Rouse Ramos	fantastic ♥♥♥♥ i love you kim seokjin!!!💕💜💜
Cecil Lim	Good one.
mimi dore	Worldwide Handsome Jin ♥
ljoivne nijkoes	my Jin's VOICE king seok jin💖 I Seoul u love😍😍😍
jsrjvjj b	💜 World Wide Handsome💜 Jin 💜
sunny j	My lovely world wide handsome Jin💜
치명치명한검	석진이 진짜 잘생겼다. 한복이랑 찰떡임💜
Hanny Merciani	Jin you smart i love you
지유정	Everyday  Saranghaeyo💜 석진 💞💞💞
ここぴよぴよ	Jin is so beautiful
yooshin kim	Seokjin👍👍👍👍👍
Only Jin	김석진 김석진 😍
YS L	I love jin~♡
Betta Ds	that's Kim Seokjin!
ѕмol вeαɴ	AS A JIN STAN AND A HISTORY MAJOR WITH A MINOR IN ART HISTORY IM QUAKING
ggcd	Jin is so beautiful. If Seoul is as beautiful and amazing as Jin is I want to visit it TODAY
Simone Kao	Jin is soo beautiful
Jarukan Rassiri	Which museum is that? I wanna visit seoul and live seoul again after watching this video!
이미옥	7 member 중에서 발성이 가장 좋은 사람이 jin과 rm입니다.  ‘historic Seoul’이란 주제와 jin은 그야말로 ‘찰떡’입니다.  jin하면 “Eat Jin"인데 영상 주제와 멤버의 매칭이 잘못되었다고 아쉬움을 토로한 글을 보았습니다.  그러한 전략은 기존의 특정 이미지를 고착화시킬 위험이 있습니다. 예를 들어, 진의 경우 “이 친구는 먹는 것 밖에 모르네!”가 되어버린다는 거죠.  멤버마다 아직 덜 보여준 잠재된 재능들이 많기도 하지만 가능하면 다양한 모습들을 보여주는 것이 바람직하다고 봅니다.   jin은 노래를 부를 때의 발성도 발성이지만, 나레이션 발성 능력도 매우 탁월합니다. 이미 뮤직비디오 속 ‘석진’의 나레이션을 통해 능력의 일단을 보여주었죠. 하지만 지금 그의 발성은 지난날에 비할 바가 아니게 발전했어요.  또한 진의 음색은 향수나  어떤 그리움의 정서 같은 것을 자극하는 아주 독특한 매력을 지니고 있습니다.    많은 이들이 그의 목소리를 사랑하지만,  그 목소리가 가진 재능은 그의 뛰어난 비주얼로 인해 오히려  충분히 조명 받지 못하고 있다는 생각을 해요.   jin은 미디어 시대에 훌륭한 storyteller가 될 수 있는 좋은 목소리를 가졌습니다.  언제고 작품성 있는 Documentary에서 narration으로 참여하는 그의 목소리를 만날 수 있기를 희망합니다.
Lilboy Me	I Seoul u too
a mom of 7 babies	Our worldwide handsome💜
sejun P	I love jin💕
sarang Jin hae	I  Seoul  U 💜💜💜Jin is gorgeous
BANGTAN TUBE	HIS VOICE IS SO CUTE
Veronica	얼굴 목소리 너무 완벽하네요^^ 진 최고
rania kn	석진이는  외모만큼이나 목소리도 넘 좋은듯 진짜 간만에 서울 가고싶어지네😍🤩
플루토	도련님 진~ 한복도 참 잘 어울려요
Michelle Ng	Historic Seoul def suits him most!!! What a sweetheart!!! 🙈😍
yoongs_oppar_bts	yes jin represent seoul
Rosmery Navarro	SEOUL 💜💜
day love	멋지다. 고풍스럽고 아름다운 분위기가 진이랑 잘 어울리네.😍💜
유다니	The intro reminds me of RJ calmly sipping his tea amidst the chaos around him 😂
Khaleeza Khalid	Wow.. that's art right there
BTS	💜💜💜😍
Saranghoe_	YES I WANNA LISTEN TO YOUR SOUL JIN
xxjinn	My seokjinieeee❤️❤️❤️
Nurul Anggreini	Kiyoooo😍
uyen nguyen	♥️♥️♥️♥️ It's so great
Jenni Zhao	jin jin jin
Shilaxem _	So handsome
Scarlet ARMY	my jin
fofo kookie	Arab army love you jin 😭😍😍😍💜
옥탄이	고마워 서울을 홍보해줘서..
jin jin	Jin😍😍😍😍😍
chimo	Ahhhhh......Jin 🌸👑💜
Jinnie&Epiphany	Me encantaría tener la posibilidad de poder conocer algun dia SEOUL y parte de su historia...  SeokJin tendría que haber  aparecido más... el se ve increíblemente sofisticado y hermoso pero necesita más escenas porfavor
Stella Jo	진짜 너네 너무 멋있다 ㅠ
young jin	Jin 💕💕seoul
김은형	이번 홍보 영상 잘 찍은듯.  한국 문화에 자부심이 느껴진다.
nixkorea	wow~~
bahanu	검술 멋있다.
쑤기 쑤기	역쉬나~  우리 진이는 조신한 양반님이었어~ㅋㅋ💜
월와핸사랑해	Jin😘😘😘
Sunday Rose	Jinnie 😍😍😍😍😍😍😍💜💜💜💜💜💜💜
JJin RJ	Jin..love you ❤❤❤
fatt Mohsen	💜💜💜💜💜💜
ul lul	목소리도 넘 이쁘지 석찌니
kim yuri	근데 이 멤버 서울에서 일식집하고 있는데 되려 외국인들한테 일식 홍보하고 있음. 이런 홍보물 찍어서 더 이상해.
Just another ARMY	This is still trending in korea😭
yunmi Kim	이미지랑 찰떡이네요^^ 금발이진 멋이징💜💜💜
SeHaryu	Just like RJ, he drinks tea with such calm beauty and grace.....
Min Dada	I seoul u !! Been captured by your culture for years now and i love it so much.
asdfgh jimin	this is mf trending in my country YAS KIM SEOKJIN
Angel Plora	Wish I could see Jin in any historical drama soon jaeba...🙏🙏🙏🙏
ARMY ka	Imagining Jin in a Historical drama... atleast it came true this way :D hope to see you in  a drama soon Jin! <3
OZMM.	#37 at Korean Trends✌👏
ss t	Jin voice & face is the best💕
Bananananana	honestly one of my favorites (if not my top one) of the seoul commercials
아재개그안하던시절	너됴 해보교 싶찌!?
siyke kid	I love korea💜
Music Cubscout	history and food def got me to want to visit soon aside fr BTS ofc.
Meherin Afrin Pihu	King of Seoul 🤴
jeon seokjin	😻😻😻😻
Kim Seokjin	❤❤❤❤
laurent levia	Kim Seokjin😘😊😙❤
olivia kim	Jin~~❤💖💗💟💞💝💜💛
문블루	오!!! BT21  RJ 차마시는 짤있는데 똑같다!!!
succ jin	OUTVISUALED EVERYONE
....sh	석찌니 졸귀 알제이랑 존똑
Bunny J	I want to experience living in one of their historical houses 😢
Jimin Park	00:02 miren eso, no está para un drama histórico? dios, necesito a Jin debutando como actor tanto como respirar
kimkhue90	Proud up you, angel 🍀🍀🍀
Jenny Lee	나처럼 할때 너무 귀여워 지니지니지니 ㅠㅠ
음파하는아기새	경기도 과천사람 ㅋㅋ
Euphoria iminsuga	This reminds me of RJ.
Jn P	Jin♥ 넘잘어울리고 이쁘당 목소리 굿굿♥♥
ALLADIN Khan	my lovely jin worldwide handsome 😍😍😍😍😍😍😍😍😍😍😍😍😍😍😍😍😍😍
jin Jin	Jin  잘생쁘에 귀엽고  꿀보이스...  최고다 진짜👍
jin멋	그래 진아~ 진이처럼 해보고 싶어~♡♡
석찐과함께라면	JIN❤️
용킹	jin😊😊😊😊😊
BTS회전문	자꾸 알제이RJ가 온돌방에서 차 한전 호록하고 있던 BT21 애니가 연상되서 웃게 되네요 ㅎㅎ
Yanina Gimenez	Yes yes yes
Ciao 1130	Love 💜
자연인	당장 서울 go go~ 진 사랑해요❤
래미	나도 해보고 싶어 진아❣목소리 넘 좋아😭
Alice Flowers	*cries* i wanna go to seoul....
Surfer and Snowboarder Jin	Jinnie in a historical drama pleathe
Arwa BTS	I am happy to tell you a thousand times less sweet❤️❤️💕
juno L	Worldwide handsome jin💕💕💕
Jessica Deias	Kim Seokjinnie💜
Nabila Dwi P	Kim RichJin!!
ari jin	Jin😍😍
gwjin k	jin~~~😃
hy P	응 응~~ 나도 해보고시포~♡
아라보라	목소리 너무 좋은거 아닌가요🐹💜💕
우주와일드핸섬진	광고보고 바로 서울 가고 싶은 충동이 ㅎㅎㅎ 와우 어디서나 빛나는 진이😍😍
Jane Choi	Beautiful Jin & beautiful Seoul💖
iqbal Wafiy	Jin,,aaash 💖💖💖😍
Gigi Lee	Seokjin cute! !
endless love	its trending on south korea youtube, wbk nations son in law, vocal king, official visual, actor visual, worldwide handsome, manner dol 😍😍
You Nice, Keep Going	0:26 My heartue 💜💜💜 Seokjin😍😍
Francys Saldaña	Jinnnnn te amooo
Moon Light	💙💚😘💜💚💙💜💙💚💚💙😘💜💙💚💜😘😘😘😘😘😘😘😘
Haaru :v	Why in the end when they say I Seoul you ... It sounds like they are saying I sold you :vvvv
Alicia L	I Seoul You, Jin❤️
Lilibeth Brendy Hidalgo Zambrano	jin esta demasiado lindo en este video , ya me enraron ganas de ir a SEUL  , pero mis monedas no alcanzan aun -.-
imen brkani	mr world wide handsome 💜💜💜
임love	Jinnnnn😍😍😍
Jiaxuan Zhao	Jin's voice at the beginning T.T
jin youarethebestofme	목소리에 꿀 발랐나 봐..저 잘생김은 또 무엇...석진이 얼굴만 봐도 세상에서 젤로 재밌음💜😍😘
Crisber Medina Castillo	Quiero ir a Seúl 😍😍🖤
정소리	방탄이 글로벌 스타긴 스타인가부네 댓글이 죄다 영어네.. 이쁘게 잘생긴 멤버네..
reshma vargheese	yesss jin
Crystalsnow	As an aspiring historian, I wish I had history lectures at my uni like Kim Seokjin! 🙌🏼
Sheida Mk	omgggg proud of our Jin 😭😭❤️❤️❤️lovely Jinnnnn😭❤️❤️❤️❤️i love him so muuuuch😭❤️❤️❤️kind cute handsome. the best😭proud of  BTS😍😎❤️👏
Mysterygirl7777	I want to experience this Seoul, Kim Seokjin you sold me😍😊
Liliana A	Jin que  bueno la historia de seoul es muy interesante me gustan las historias antiguas ♥♥♥
Erze Holmes	Awww algun dia iré... Jin se ve perfecto y sofisticado 😍💜
Zeren Uykun	BTS😍😍😍
Karen Calisaya	Me voy a coreaa ya
young miah	석진이 목소리 좋네. 방탄 보라해
Sophia K	Worldwide handsome Jin 😍
Jy	my jin~♡
Amy	NICE
부농석찌	너도 해보고 십찌?!<<<<개귀씹귀
60cmSeokjin	I love you baby Jin! Seoul is beautiful, just like you. 💜
태태보라해	방탄 보라해 💜
Demios Zhirvalian Althemphires	Worldwide Handsome Kim Seokjin!!
gardenia chang	I have been Seoul last month，but my baby jin not in Seoul that time. sad
December Jinter	How the korean history looks so interesting 👍🏼 and jin is so handsome 😍
Sophie xx	❤️❤️❤️ Jin
Kim Shin	Jin💓
Hye_jin	Jin♡
Sophie	💜💜💜💜💜
mistayrious cupcake	nation's son
Sajani Hirushika	Wow this is trending in South Korea❤️
진인사대천명	오잉? 진하면 잇진인데... 음식으로 나갔으면 더 잘어울리지 않았을까 싶으네요.. 물론 이것도 잘 어울립니다. 진 이즈 뭔들..^^ 💜
Hope Wesley	Go bts
Thanh Mai Thị Nguyễn	SeokJin so sweet ❤
Daerin Kim	Suddenly my mind traveling back to RJ drinking his tea ._.
taejin child	This video just made me want to leave my own house and abandon all of my responsibilities in this damn house. I'm on my way to seoul, seokjin.
Carla Lauber	I can't wait to back to Seoul next year!! It is so beautiful!!! Already learning Hangul! Jin be my tourist guide lol!!
Aakruti Ruia	Jin is amazing! So handsome and love it! 💜
jing Angle	jin！！！
Diana Huiza	JIN 💜💜💜💜💜💜💜
Humaaa	I love you with all my heart
Ugne Dvar	Jin, thank you for this, now I feel very interested in Korean history! ❤️ Jin, you are so handsome and I love you so much!!!! ❤️❤️❤️💖💖💖💋💋💋💋💗💗💗💗😍😍😘😘😘💓💓💝💝💝
Y SuMin	RJ?
juno3548 lee	세상 단아하고 이쁘다💜💜💜
Army 4ëνëя	*عااااااا ودووني كورياا* 😭💜
juhee won	우리 석진이 얼굴도 목소리도 세계 탑이다.
bts lovelyjin	My Jinnie😍😍
Maryam Ahmad	OMG handsome king.. Jin is my man.... I love this lil chaotic baby soo much ooh lemme protect u!!
Sanju Gurung	Jinie  💜
zaynxjaan	Lo amo.
krish jagiya	jinjinjaaaa
아리슥	JIN💕💕목소리 너무좋아
재미있는 카톡	1등
simran chawla	There's my jin and then there's history my most favorite things about life..😍😍😍😍
l'amour dessert	King Seokjin ~ I seoul(love) u I really miss hanbok Jin💜💜💜
jinnies lamp	Jin♡♡♡♡♡
Sailaja Srivani	#ISEOULU
Yuui Nguyễn	Like father like son :(((( Jin with his son RJ OMGGGGGGGGGG
jimin sssi	jin drinking that cup of tea is so :(
JIN EPIPHANY	My love jin 😍😍😍
Lirio Akarui	💖💖💖💖💖💖💖💖💖💖💖💖💖💖💖💖💖💖💖💖💖💖💖💖💖💖💖💖💖💖
hyun jung	Jin...
jj ll	Jinnn❤❤❤
Aminah Amar	I SEOUL YOU TOO 😘😭😭😭
AYAT HASSAN	😍😍😍😍😍😍
Vanessa	:0 este es el que más me ha impresionado
Nora Virydiana Velasco Vazquez	me antojaste el te..... i love you....
sinta pramida	Beautiful💜
syer syahirah	Seoul historic place...will be on my listing for visiting Seoul...
Carmen Cruz	Nuestro mundialmente guapo jin asiendo cerámica así si voy
kkoms	아 얼굴 진짜 뽕찬다ㅋㅋㅋㅋㅋ
Kim king	KING SEOKJIN♥3♥
HPAI Bandung	JIN and RJ enjoy the tea
Captain	0:11 damn what a man if he's not taken by seokjin then i'll take him
Kartika Maryadinata	Yash i wanna live with you Kim Seokjin Oppa 😍😍😍😍😍😍😙😙😙😙😚😚😚😚😚😚 labyu to the moon and back the sunshine of my life 🌻
xxJust_Catxx	All of these videos are beautiful ; uwu 💜
한크리스탈	사랑해🙊🙊
abu minhloc	Jin oppa ♥️♥️♥️♥️♥️♥️♥️♥️♥️♥️
헤스티아지나	하아 요즘 애국하는걸로는 탄이들 따라올 자가 없다
Min gloss	Omg
Hifa Bulut	I purple you 💜👑
Priya Negi	💙💙💙💙💙
كيبوبيه للموت suga	اجي لسيول  بس ابشرط    تاخذني جوله  😁😍
are you smarter than kimseokjin	*KING SEOKJIN*
Orange Chess	Te amooooo Jin 💜💜💜💜
Viviana Muñoz	I love Jin ❤❤❤❤
Meryy Flowers	Jin 😍
Purple means Trust and Love for a very long time	Historic is amazing and cool
Kim Altra	جعل ما حد يعلن غيرك
阿米们的世界弹	Worldwide Handsone
Emilia Br	Seria um sonho ir a seoul? Claro que sim😍
유나이	💜BTS💜
王 王	Baby so cutie
i love tae with kookie	Why didn't I bron in Seoul 😭😭😭😭
E M	History, arts, sword-fights, and Mr. World-wide Handsome, himself? I wish I could give this more likes! ☆♡☆
janeth janeth	seokjin i love you so much
alice christi	JIN love U
Anandita Tiara Kusmayadi	jinnn😍😍
Wings And TEARS	Of course... I will come to visit Seoul and it's historic sites, I don't watch historic kdrama and listen to kpop for nothing.
kpop lover	Look how far we've made it 😭😭❤
lana taylor	these ads are so short tho
wonder jjk	This really suits jin
Noel	오~ 영상 죽인다~
Natalie Zardiashvili	I 💜 U
Hobi SunshineOwO	Handsome boy
Davine VX	King seok jin fits historical Seoul
Viv Angel	this is prince seokjin fight me
ruth olfi	Jin's voice is so soft to me I love it.
Lu Mar	You made the best choice!!! Indeed BTS are the best ambassadors. There are many people from other countries that want to travel to your beautiful country due BTS.
서은희	Jin😍🤩
hye J	지금 서울에 있어만서도 서울에 가보고 싶어지는 영상이네요!!ㅎㅎㅎ귀여운 진이
IDOL-OVE MYSELF	OOF I WILL LISTEN TO YOU ALL DAY LONG
이현정	탄이들 데려다 아주 뽕을 뽑는구나. 뽑아. ㅋㅋ
Sesie Mari	I SEOUL YOU KIM SEOK JIN!!!!❤❤❤
Glleyce Brazilian ARMY	Príncipe 👑  BR
52에일리언	진처럼 해보고 싶어 ㅎ
Neha Partha	0:25 I feel attacked
aariayoo ™	SEOUL IS REALLY BEAUTIFUL AND AMAZING
‘규셸	Gosh Jin really IS worldwide handsome
LY: Answer August 24th	ما كنت بعرف انه في هيك اماكن في كوريا !! حلو كتير 👀 شكراً  BTS 💜
켈니	오 이번 영상 정말 좋네요ㅋㅋ
janes blair	JIN LOOKS REFRESHING AS ALWAYS
kazi Muimmah	If only I wasn't broke af !!😢😢😢😭😭😭😭 don't worry one day......one day...... I will surely visit there!! Thank you BTS for introducing me to a beautiful city!! 💜❤💙💜
shiiruj bangtan	I love historical places in Seoul😊
annmiracleable	JIN 😍 worldwide handsome 😍 BTS ❤
Taetae wifeu BTS A.R.M.Y	😍😍😍I want to learn martial arts so much..and that mud art reminded me of RUN BTS 😂😍😘love you WORLDWIDE HANDSOME OPPA..Seoul is really beautiful👌💜😍
Afza Mukaddam	Of course Jin had to get the 'travel back in time' advertisement. Theories creeping in...
Jeon Cooky	Take a trip down memory lane and experience Seoul’s colourful and majestic past and how it so magically and collides with the present-day Seoul. Go historical in Seoul with Jin 💜
제이 제이	진 목소리 넘 좋다..으헣헣헣헣.... 광고에서 대사 많이 해주세요.. 넘 좋은거..흐미 좋은거
Zweet Mansa	Give me my money right now..!!!😈🙏
Honey Jane Acuesta	World. Wide. Handsome..
the_girl_next_door	he looks so good 😍😍😍😍😍
ARMYS always BLINK ONCE when they see me REDVELUV	Me: *where my money at?*
oriana mendoza	Seokjin logra que miles de ARMYs quieran aprender de  la historia de Corea. Es tan hermoso ver cómo todos ellos aman tanto a su país ❤
blue butterfly	So beautiful
IRENE SALUMU	My prince, the crown prince.
Büşra k	best historic man ever Kim Seokjin
Tuğba Y.	I Seul You Jin
Nabam Odang	Okay, now all the visuals are getting it one by one!!
SFHBTS, كانقتان	جايتكم قريباً 😋🤩
sasuke's side chick	I always loved korean cultures
Hggfhhvf Errgcfgf	I Love you JiN 💜
Phương Anh	Yêu thật
Wish lists Three words	Yes!! I want to try just like you, Jin
Lily Cosmos	Jin ❤❤❤❤❤❤❤❤❤
Kristina Reliefia official	Kim seok jin  BTS I Seoul you
amor xJin	😍😍😍
hyowhani 78	석진이는 저 밝은 머리보다 지금 머리가 훨 더 이쁜 거 같다 석진아 잘했어 투어가자마자 검은머리로 염색한 거는 탁월한 선택이야! 검은 머리로 계속 있어줘 그 존잘미모가 검은 머리일 때 훨 더 빛나^^
Emily G	Worldwide handsome Jin.. historical face 💜💜💜
Xenia P.	Historic Seoul perfect for Seok Jin💜
Aika Mikaelson	Наш мировой красавчик 😍🇰🇷😍🇰🇷🇰🇷❤️❤️❤️❤️🙏🙏🙏
A N N	This suits really well with seokjin:))))
H JS	so cute JIN♥
Iphit Hyda	I just realize v's i seoul u is used for all bts ad video 😂
Mimay Yoongi	I Seoul U Seokjin💜
hui li	Jin hyung❤(ӦｖӦ｡)
EN Chen	JIN😎
Nandaa chh	JIN💜
Prudence Mignonette	Our gorgeous Jin😍❤❤❤
Roro M	Jin 💜💜💜💜💜💜💜
아이스크림복숭아맛	아니 알제이랑 판박이다ㅜ슥진이최고
Aurore Kiniali	thanks jin for Everything!
eunz_ 34	MR.WORLDWIDE HANDSOME I DARE YOU TO STOP WRECKING ME!!!!😤💜
Jungsik park	방탄소년단 진이 들려주는 서울이야기 서울에 살면서도 귀기울이게 되네요 김석진 목소리 정~~말 좋다
jin's wonderful dad jokes	Seokjin💜
Maricar Romero	Jinnie looked so elegant. Worldwide handsome indeed. Will visit Korea one day. :-)
Jin forever	He,s soooooooooo handsome!!
Mimi Jiji	Seoul has saved by BTS
my lovely kim seokjin	Kim Seokjin💞💕
Worldwide JIN-tleman!	This advertisement was MADE FOR JIN! 🍵💜👌
Rayan Mohammad	Really need to thank bts for introducing me to korea i probably would never have seen this if it wasnt for them
2 hyun	Jin 😍😍😍😍😍 💛💙💜💚❤💗💓💕💖💞💘💋
Suci Suci	Hii
NINING _	근데 진짜 퀄리티 좋다..
Bangtan is my everything	I would enjoy going to museums, Jin wanna go with me? 😊
Manshi	yessss teach me history sir
Aya Kh	💜💜💜💜💜
Matoki Asylum	This is so calm, it matches Seokjin perfectly
Fierly Aprilla	jin and seoul mean perfection
Jose Bleu	Jin 💜😍💜😍💜
lucky	jin looks gorgeous
r. white	Seokjin so cute and beautiful 💜💜
Exo Chenbaek	Seokjinn
SINGULARITY TAEHYUNG'S DEEP VOICE	I really do wanna try jin I really love Korean traditional houses because it looks so beautifully build the paintings and the history.
으누깅	너무 잘 어울린다ㅠㅠㅠ💜
Jin CEO	seokjin
alan t	Jin😍😍😍😍😍 I wanna try!!!
enteraname.	*„So show me,“ ‚I seoul you‘* This will be stuck in my head for a bit now.
Peanad Taetae	Jin can you tell me about history of Seoul
appletree ca	Seokjin is such a cutie!!!!!!
Alondra Springer	La elegancia y belleza de Jin ❤️
Tami	cute
Nidhi Masalia	Amazing work💜
JEE H	차와 석진이라니! 딱 어울라는 조합이다♥ 깊고 은은한게! 멋있다💜
Hina Bts	💜💜💜💜💜😍😍😍😍😍
ثوثايه صاكه	اوووووه جين شنو هل جمال تروحلك فدوة سيؤول وكل ناسها 😊😊
Fluttering Wings	Jin i love you ❤️❤️❤️
Milton Xavier Palacios	♡♡♡♡♡♡
min yoongi	Go go go ke Korea 😍😍😍
athrix skye	Are there any more videos like this with the other members?
August Strindberg	Sweet and gentle Jin✨✨
tae army	So many things to look at
rubi cruz	La historia también es una parte muy esencial por conocer 💖💖
ryehaaan	jin got the historic cos hes the oldest? jdhdhd he should be the food theme 🗿
Moonchild	King Seokjin
Deniz Şahin	JIN JIN JIN💜
Acorán Guerra Abad	JIN👑💜
Shubha Shree	Jin..😘😘💕💕💕
Angie Jagdewsing	THIS IS soo beautiful and calming, I kind of want to study the Korean history
love jin	진 목소리 넘조앙😍😍😍😍😍 I LOVE JIN~❤❤❤❤❤❤❤❤
kim sadg	Oh my gosh the beautiful 👑 Jin👑❤❤❤
김민정	my  jin♡ my bts♡
Tsering Peden	Woaaaaah. Just like the charming Worldwide handsome.
jungbebeeh	I can’t wait to be in Seoul and have my Bangtan itinerary! Who’s with me?? 😊😊😊
예니손	Jin so cute♡♡♡ 귀여워 석찌니
Gülsüm Yıldız	i love you seokjin you are really worldwide handsome 💕
Looney Tunes	Jinnieee😍😍😍
고카페모카	love you Jin
Happy chu	Welcome to seoul in korea🇰🇷👍
TATA Hyung	I came here for BTS who else did? Hehehehehehehe 😄😄😄😄😄😄😄😄😄💜💜💜
veautiful_twt	Baby u did a great job 😭💜
jimin-ssi _	김석진!!!!
Tiến Phạm	❤️
Trần Hiếu	wow I am not fan of BTS but why you are so handsome, you make me can't breathhh
러브러브화니	와우 영상 넘 잘나왔어요~~^^ 넘   이쁘네요 ~ 색감도 넘 좋구요 울 진이 얼굴은 역시 넘 잘생겼네요 목소리도 깜찍하고 ~~항상  응원합니다
Mendes Army_01	Pensé que el mostraría la gastronomía :'v Fui timada 😂 Handsome💛👑
Linh Vũ	I love u so muchhh JIN ahhh you are so handsomeeeeeeee
Kaity Nguyễn	omg so handsomeee
Daydream KTS	Que lindo :"
Jin luv	My love Jin❤❤❤
HANI Is there	You’re always my worldwide handsome 😭
Miri BTS	Jin -> Seoul, I am coming ❤
Vian Kuti	I want to visit Korea and see BTS  go to their fanmeeting and concert and then die in peace😭
Marix Arroyo	TT vamos 💜👏
유리아	진! 연기 공부한 티 너무난다~눈빛 좋구요..발음도 또박또박 전달력 있구..외모는..이거 뭐... 진! 너무 다갖춘거 아니야? 어디 빠지는 구석이 없어.  방부심 상승해서 지구 똟을듯.. 👍💜💜💜💜
jin park	💓
aalishaJSatan	I want to visit Korea and go to BTS concert... Someday 😂 Saranghae Jin 💜💜💜
Amarachi Nosike	Jin: Do you want to try too? Me: Too broke, but I want to try yo- I'LL STOP! Whoops.
Kizzy Von Doll	I really want to visit! Jin is fantastic 💜
Jjang Jin	한국어로 말하니 좋다!! 나라를 알리려면 이렇게 해야지 광고 좋네요
Sunwoo is my bias And Seventeen is my bias group	I love Him so much ❤❤❤. WORLD WIDE HANDSOME, I am coming to Seoul 🏊 😍😁
Diana	Am I the only one who remembered that bts run episode when BTS were making pottery
Hope world	worldwide handsome jin
Ana Andrade	I need money, i need money!!! Brasil wants to go!  ARMY💜BTS💜ARMY
Suman Pal	Thanks BTS for introducing such a beautiful and historic place..love you Jin 😍😍😍😍😍😘😘😘😘😘😘😘😘😘
Alexander Pascual	Jinnnn..😍
Loan Loan	I SEOUL U 😍😍😍
Strawberry Min Yoongi	This video suits him so well
dolis morales	vamonos a seoul 😢😢😢
Don't mess with our Fandom	SEOKJIN WORLDWIDE HANDSOME I LOVE YOU
BTSJin noona	We visited Seoul last summer because of you Jin and BTS. We were disappointed that the Korean tourism didn’t have any BTS in their Kpop corner. We only know BTS and Lee Min Ho. Haha I made sure to tell the people there that they should have BTS. Cause they are the primary reason why we were interested in visiting Seoul
Rieka Melania Ilhami	Jin is just as aesthetic as the content! LOVE U OPPA!!!
Ngo Lam	😀😀😀😀😀
where is BTS	😭😭😭😭😭Jinnie.. I Seoul you too. 💜 💜 💜 💜
Trang Đỗ	My worldwide handsome❤️❤️
Anh Trang	aaaaa best
yoongin aier	So much Jin
Masked Music	Korea is finally giving them the appreciation they deserve. BTS not only represents Kpop to the outside world,but the entire country too.
Anne Siojo	Now I really wanted to go Seoul...Seokjin wait for me there~
슈가민트	*I don't to listen to your seoul, i wanna listen to your epiphany ~~*
bright hope	I hope one day visit Seoul 😣
luana loves jhope¡!	💜💜💜
Risma Surya	Jinnnnnnnnnnnnn
Gucci Prince	Did they actually give historical Seoul to Jin cuz he is the oldest??!!😂😂😂 I can't!!! *I SEOUL YOU TOO JINIE!*
Bernadette Arbues Yosa	Jinnie!!! 💜💜💜💜💜💜💜
Aya Wu	it's suits with him . . ..!!
맹이	언제나 최고멋JIN 김석진 서울이 보고프네~^^♡
RaineJin kim	He look so handsome here he's so fresh 😗😗i love you #kimseokjin
Shibrah Rafaqat	i really wanna visit Seoul one day
jjaru	아 목소리 너무 좋다ㅠㅠ 이 좋은 목소리에 이렇게 귀여우면 어찌하라고
방탄소년단love.	I love Jin❤
dadis aleksis	O kurde*-*
جيميني وجودي	جين 💜💜💜💜💜
Yeahoeyea Yeahoeyea	💘❤💖
Esraa ashraf	Worlldddwiideeee handsommmmme💛💛💛💛💛💛💛💛💛💛💛💛💛💛💛💛💛💛💛💛
Sarah Alimami	WAIT TIME TRAVEL THE THEORIES
Lily	Mr. worldwide handsome : welcome to Seoul👀 hahaha
Monie's Dimples	네 BTS랑 함께 해 보고 싶다고 ㅋㅋ
Lily Ella	Wow! SEOUL looks AMAZING!!! Booking my holiday to Korea next yr!
songhee han	진 목소리 좋음
Alejandra	La única historia que quiero saber es como te hicieron tan perfecto bebe
ゼヒJAEHEE	한옥진 좋다
vivlodia	Thank you BTS for giving me an insight of Korean culture ❤
Ximena Vazquez	Mucha Historia rica,  que lindo 😊
Lesly Melissa	❤❤❤
hafsa malik	this man himself is national history
Mariana Cruces	Jin aren't you a piece of art
Arzamand KSJ	Yes I wanna go seoul😘jin oppa take me their
Faith S Park	I wanna do like JIN n RJ...
Jessi C	RJ also act like jin in BT21 drink tea ^^
Binti Rosida	why you so handsome jiinnn
Gianella CD	SEOKJINNNN💕💕💕💕💕
Love Chim chim	Worldwide handsome jin 😍😍😍❤️❤️❤️👑👑👑
Je Oblianda	💜💜💜💜💜💜💜💜💜
It's just Rachel	Definitely fitting for Prince Seokjin! I Seoul this and I Seoul you.💜
Ara N.	Por ti iría hasta el fin del mundo 😍❤️
Yatogami Yuki	historic sounds suit for jin.. everlanting beauty and calm 😭😭😭💜💜💜💜
Tae-Nado	Jeez, why does Seoul seem straight outta 2085?
Janica Tacderas	Seokjin fits this campaign segment well. With his soft yet sophisticated features, it really blends well with the historical theme and rich culture of Seoul 😍💙
Anon miaw	Worldwide handsome 😍
최애는일곱명다	진이 꽃미모 실화?ㅜㅜ 너무멋지잖아~~~ 😍😍
Renata Romero	Bts bts! They are the best!
infires nation	Yaaah jin💜💜
dhepict dhestory	babe, why so gorgeous?
ncw 307	Me: Yes.  🙋🏻‍♀️
Kim Seokjin’s personal servant	YYYAAAAAASSSSSSSS
Kisuna	A Jin le queda perfecta esta temática!!
s k	오 드디어 한국 소프트파워가 강해지고있네
Giang Trần	You looks so profession!!!
mary rose fernandez	Korea is a beautiful country..
Christina Trần	CAST HIM IN HISTORIC DRAMA!!!
라니지니	목소리가 녹는다🤧
Pau. CC	Kim SeokJin a.k.a worldwide handsome you know?   Quiero ir a seoul :3 💜 #MonoIsComing
Rosa Vera Quirioz	KING Seok Jin 💕
Nadya Danielle	Thats my husband. ❤️❤️❤️❤️😍😍😍😍😍
Yuly Rojas	Solo me imagino todo esto en una cita con él 😭
Arigato Kiss	Jin, our handsome prince
Ashiq Ali	My desire jin work in Hollywood show a romantic show as a lead by lipsing bec he don't speak eng much  Plz anyone cast him its a request but in Hollywood
Trần Giang	I want to watxh Jin in historical drama so much 😢❤❤❤
TAEKOOK😍😍😍	Artes marciales? Ah caray! Eso si me interesa 💜
Kxookie	Jin is indeed _worldwide handsome_ *fite me*
월와핸	김석진 목소리 달달해서 녹는다ㅠㅠㅜㅜㅜ
Deep Ocean	Shining Kim Seokjin ❤
Maria Ali	HE IS THE LOML IJDJEISISIS THE MOST BEAUTIFUL MAN
Sin Sin	So handsomeee
SUNG FLOWER	woah😀 I can't wait to hear more Seoul's history from you Kim Seok Jin. fighting!!
BTS' music is my drug	AAAAAAAAAAAAAAAAAAAAAAAAAAAAAAAAAAAAAAAAAAAAAAAAAAAAAAAAAAAAAAAAAAAAAAAAAAAAAAAAAAAAAAAAAAAAAAAAAAAAAAAAAAAAAAAAAAAAAAAAAAAAAAAAAAAAAAAAAAAAAAAAAAAAAAAAAAAAAAAAAAAAAAAAAAAAAAAAAAAAAAAAAAAAAAAAAAAAAAAAAAAAAAAAAAAAAAAAAAAAAAAAAAAAAAAAAAAAAAAAAAAAAAAAAAAAAAAAAAAAAAAAAAAAAAAAAAAAAAAAAAAAAAAAAAAAAAAAAAAAAAAAAAAAAAAAAAAAAAAAAAAAAAAAAAAAAAAAAAAAAAAAAAAAAAAAAAAAAAAAAAAAAAAAAAAAAAAAAAAAAAAA
Rhea May Frejas	I love you jin
Minkun Hoo	🤗❤️
Late Choco	Hanbok suits Jin very much awww I love professor Jinnnn  😆❤❤❤
m l	목소리 사랑스럽다
Taetae ARMY	Sang kakak 👏😍
Andrea estefania	I love you jin♡
Ligie Jinnie	Seokjin ah you look super handsome in Hanbok 😍😍👍👍👍
leslie Alice maco jimenez	I love you Jin ❤❤
Vale Gi Jeon	Te Amo intensamente Kim Seok Jin  💕 ✨
ddaengsara	I Seoul you Jin! <333
Jane Cruz	Jin always associated with time travels. Omg hyyh feels 😂
Umokom ytzel	Increíble lossss amoooooooiiio
LoveYourSelfisTheAnswer !	Let's run to Seoul 🏃‍♀️
Candee Tran	🌑🌑🌑🌑🌑🌑🌑 🌑🌕🌕🌕🌕🌕🌑 🌑🌑🌑🌕🌑🌑🌑 🌑🌑🌑🌕🌑🌑🌑 🌑🌕🌑🌕🌑🌑🌑 🌑🌑🌕🌕🌑🌑🌑 🌑🌑🌑🌑🌑🌑🌑 🌑🌕🌕🌕🌕🌕🌑 🌑🌑🌑🌕🌑🌑🌑 🌑🌑🌑🌕🌑🌑🌑 🌑🌑🌑🌕🌑🌑🌑 🌑🌕🌕🌕🌕🌕🌑 🌑🌑🌑🌑🌑🌑🌑 🌑🌕🌑🌑🌑🌕🌑 🌑🌕🌕🌑🌑🌕🌑 🌑🌕🌑🌕🌑🌕🌑 🌑🌕🌑🌑🌕🌕🌑 🌑🌕🌑🌑🌑🌕🌑 🌑🌑🌑🌑🌑🌑🌑
Genesis Luna	Jin!esto es muy lindo 😍!
Elham M	💜💜💜
TDP GamingVN	💜💜💜💜💜
마리엘	I majored in social studies, so I'm interested in different cultures. I wanna see and learn about the other cultures including Korean culture. This is one of the beautiful ways of promoting it. Thank you for this! 💜
Anime lovers	Seokjin' voice is cute
MONO	JINNIE<333
Liltaelian Youtube	CUTEEEEE JINNIE💜💜
fatimah z.	all hail professor kim seokjin
little melody	Professor Seokjin Kim 😍😍😍
j jang	0:01 giving me flashbacks to that one RJ animation in a tearoom lol
kiều giang Bùi	JIN I LOVE YOU
ven pala	느으으으나ㅏ아아ㅏㅏㅏ석진오빠!!!!!!!!!!!!!!!!!!!!!!!!!!!!!!!!!!!!!!!!아악@@
Jenn R.	Ow great
Lucila Pérez	Jin ❤
Alrumaili Al Dossary	My husband really likes the historic Korean drama I wish to experience this one day.
Sarhy AjjaJin	Kim seok jiiinnn, love you so much.. our worldwide handsome 😘😘😘
Khesi	✨💙💜💚✨
07 JADE	Kimseokjin 🤗🤗🤗🤗🤗🤗
Rebeca GAG	Te Amo  JIN 😍
ssunny y	very traditional and stylish~~~ !!! awesome♡
mariisa torres	vos fuiste mi inspiración para conocer Seúl y Corea del Sur en general Jinie...❤️❤️❤️❤️
Lil Namie	I would really love to visit those historical places 😭
Bourne Ku	To some of ARMY, this is NOT an ad for Seoul featuring BTS, BUT an ad for BTS featuring Seoul.  ^O^
Christine Grace Simpas	Wow
Nina Love	WORLDWIDE HANDSOME
니아마	*كيم سوكجين💜.*
Jins Bitch	Seoul such a beautiful city 👀also I love u jin 💙
Loba Étoile	Historic Seoul seems very interesting. I would like to visit historical places and learn about Korean traditions.
Shakira diaz	He looks so good
youjin yinn	BTS KIM SEOKJIN
skywalker	Thanks BTS for introducing me to KOREA!
Zeynep Gul	Cutest baby boi 😍
TheBeginning of LoveYourself	Historical places are 😍 If I can go to Korea, that might be the first place I'll visit 😁 사랑해 김석진
Mel Dy	I SEOUL YOU TOO JIN, BTS, BTS, BTS
José De Jesús	Algún día estaremos por allá 🤗🇲🇽🇰🇷
rippan dhanda	💜
WasuWasuSu	The history looks beautiful here
Waffle Leo	jin is so handsome
Ro j1702	Insteresting and amazing culture thanks Jin we love you
Shannon Rochon	OMG...I would LOVE to try my hand at traditional ceramics!  The beauty of traditional Kirean arts goes well with our Worldwide Handsome Jin.
윤지원	BTS JIN ♡♡♡♡
TaeHyung VH	Te amo Jin ❤❤❤ ángel.
young kim	Jin  😍😍💜💜💜💜
Kerone Harrison	_Worldwide Handsome_ 💖💜
Lim Min-Hyun	My sons (´༎ຶ ͜ʖ ༎ຶ `)♡
Carla Nieto Castañeda	Kim Seokjin, me encantas😍💜💜
Yuly	💜💜💜💜💜💜💜💜💜💜💜💜💜💜💜💜💜💜💜💜💜💜💜💜💜💜💜💜💜💜💜💜💜💜💜💜💜💜💜💜💜💜💜💜💜💜💜💜💜💜💜💜💜💜💜💜💜💜💜💜💜💜💜💜💜💜💜💜💜💜💜💜💜💜💜💜💜💜💜💜💜💜💜💜💜💜💜💜💜💜💜💜💜💜💜💜💜💜💜💜💜💜💜💜💜💜💜💜💜💜💜💜💜💜💜💜💜💜💜💜💜💜💜💜💜💜💜💜💜💜💜💜💜💜💜💜💜💜💜💜💜💜💜💜💜💜💜💜💜💜💜💜💜💜💜💜💜💜💜💜💜💜💜💜💜💜💜💜💜💜💜💜💜💜💜💜💜💜💜💜💜💜💜💜💜💜💜💜💜💜💜💜💜💜💜💜💜💜💜💜💜💜💜💜💜💜💜💜💜💜💜💜💜💜💜💜💜💜💜💜💜💜💜💜💜💜💜💜💜💜💜💜💜💜💜💜💜💜💜💜💜💜💜💜💜💜💜💜💜💜💜💜💜💜💜💜💜💜💜💜💜💜💜💜💜💜💜💜💜💜💜💜💜💜💜💜💜💜💜💜💜💜💜💜💜💜💜💜💜💜💜💜💜💜💜💜💜💜💜💜💜💜💜💜💜💜💜💜💜💜💜💜💜💜💜💜💜💜💜💜💜💜💜💜💜💜💜💜💜💜💜💜💜💜💜💜💜💜💜💜💜💜💜💜💜💜💜💜💜💜💜💜💜💜💜💜💜💜💜💜💜💜💜💜💜💜💜💜💜💜💜💜💜💜💜💜💜💜💜💜💜💜💜💜💜💜💜💜💜💜💜💜💜💜💜💜💜💜💜💜💜💜💜💜💜💜💜💜💜💜💜💜💜💜💜💜💜💜💜💜💜💜💜💜💜💜💜💜💜💜💜💜💜💜💜💜💜💜💜💜💜💜💜💜💜💜💜💜💜💜💜💜💜💜💜💜💜💜💜💜💜💜💜💜💜💜💜💜💜💜💜💜💜💜💜💜💜💜💜💜💜💜💜💜💜💜💜💜💜💜💜💜💜💜💜💜💜💜💜💜💜💜💜💜💜💜💜💜💜💜💜💜💜💜💜💜💜💜💜💜💜💜💜💜💜💜💜💜💜💜💜💜💜💜💜💜💜💜💜💜💜💜💜💜💜💜💜💜💜💜💜💜💜💜💜💜💜💜💜💜💜💜💜💜💜💜💜💜💜💜💜💜💜💜💜💜💜💜💜💜💜💜💜💜💜💜💜💜💜💜💜💜💜💜💜💜💜💜💜💜💜💜💜💜💜💜💜💜💜💜💜💜💜💜💜💜💜💜💜💜💜💜💜💜💜💜💜💜💜💜💜💜💜💜💜💜💜💜💜💜💜💜💜💜💜💜💜💜💜💜💜💜💜💜💜💜💜💜💜💜💜💜💜💜💜💜💜💜💜💜💜💜💜💜💜💜💜💜💜💜💜💜💜💜💜💜💜💜💜💜💜💜💜💜💜💜💜💜💜💜💜💜💜💜💜💜💜💜💜💜💜💜💜💜💜💜💜💜💜💜
Stefany Love Jungkook	Jin siempre atacándome con su BELLEZA
sopy so	Jin  💜😍😚
Simone Fagundes	Interessante! Adorei a questão histórica/cultural! Me interessei!
Karen Dominguez	SEOOOOOOOOOOOOOOK JIN✨😍😎😍😎😍😊😍😊😊😍✨😍😎😍✨😍😎😍😍😎😍😎😍😎
Hadrian Dias	This concept can be a good example for other big cities in promoting tourism.
Sumi	Why is Jin so cute
tanniejoinedBT21	loving SK because of BTS
BTS ARMY	OUR *WORLD WIDE HANDSOME* OUR WEIRD *JIN* WE FOUND U LUV U💜
Huyền Nguyễn Thị Thanh	I wan to go to Korea right now Really!  😍😍😍😍😍😍😍
hyunju kang	우리왕자님♥♥♥
MARIA SHIN	Jin worldwide handsome, you know? Te amo demasiado💖💖💖💖💕💖💕💖💕💜
beth wor	Jin:Do you want to try too? Me:With you? Of course!
Saya Dearg Due	Wow la cultura, el Folklor y color de Corea carajo 💘👏 Jin es excelente I PURPLE U 💜
CJ :3	Jujuju Worldwide Handsome :3
janny as	😘😘😘
NicoL !!	HERMOSO😍💖😍💖😍💖🤗🤗💖😍💖😍💖
Marina Pessanha	O jin é tão encantador, me pergunto se ele é realmente real🇧🇷💓😭💓💓💕💕💕💕💗💘💓💝
Ý Phan	💜
꾹꾹아	봉5개 저거 이름 뭐더라ㅠㅠㅠ
ODD	해보고싶찌! >_<  ㅋㅋㅋ 젤큰형 젤귀여움.
YESISCA YN	I wish I can go to Seoul and enjoy its histories.💜💜
Dua'	Wow! didn't think the historical part would be the most interesting! Will be definitely among the things I'll check if I ever visit soul  in the near future
Ratih Prima R	Real Worldwide Handsome!   I Seoul You 😘😘
Long San	Could someone tell me if Jin's back blond ? 😱
pardon	0:17 it reminds me of that one bts episode where they made pottery for each other
Zemi T	Wow
Rikki Mei Lising	King
Nell Park	Jin💜💜 handsome
Reggie K.	Besides Seokjin looking extremely cute... BRO! Look at all of this amazing art and culture! It's beautiful!
YehetYouGotNoJamskaepsong	Such a rich history 👍
Jiminliked	JIIIIIIIIIIIIIN
BTS Noona	i'll visit Seoul soonest - thank you Jin
Rima Santika	I dont know why, but Seokjin Kim looks so hot♨
Cindy Martinez	Kim Seokjin❣️#LiveSeoulLikeBTSDoes #LiveSeoulLikeIDo
NicolXD	:0000
anty agustiany	Jin x Army 💜
judit rodriguez soto	0:14 Quiero visitar ese lugar
Rosy Stha	Go go kim seokjin!!! ❤❤❤
oh okay	Aiyo oppa so handsome 😍😍😍😍😍😍😍😍
21다	석진아 옷 너무 잘어울린다ㅠㅠㅠㅠ
Andrea Huaman	Live in Seoul like I do 💜💜💜💜
Aline Regina De Souza	Lindo um príncipe coreano !!!  Kim Seokjin is a Prince!!!  💜💜💜💜💜💜💜💜💜💜💜💜
Ingridt Huacho	Por ti jin me gustaría ir a ese hermosos lugares
JUNG KOOK	Jin 😍💜 su cultura es fantastica 😊👍💕💜💖💜
Le jindary	If jin was my history teacher will never sleep in class and never skip class
Girl Of NamJoon	JIIIIN MÉXICO TE AMA💜
Andrea Y	JIN: Do you want to try too? Me: with you? *of* *course*
Sugamyonlysenpai S2	Meu príncipe.
CB C	I love seokjin Worldwide handsome😍
Amor Fati Bangtan.	Jin💜. I love everything that has to do with history!
BillyHali	My baby ❤❤
Barbara	Seoul looks like a great place to visit!! Thanks Jin
Army Best	Ooooow bebé hermoso te amo , me encanta aprender cada vez más sobre Seúl 😍
Yami Ramirez	Hermosoooo!!! <3
Sunshine BTS	I seoul you too💜💜
Zoya Haider	Woo this is so amazing😍💜
Tanne Budiatma	Yess i seoul you Kim Soekjin 💕
Lisbeth UT	Jinnie 💕
nathalie_ xiv	Being the eldest means he's incharge of history lmao
BTs ARMY	Jin♥
Amandi Vishwa	KING SEOKJIN!
happy k	I Seoul U. I 💜 Jin!!!
Sá Army	JIN♥️👑
Sabrina Ayunani	I Seoul u
No me Llamo	♥♥♥
s un	진  💜💜💜💜💜💜💜
BTS MyLife	I really love South Korea and its culture...🇰🇷🇰🇷🇰🇷🇰🇷😘
Akane Apples	The pottery reminds me of their Run BTS episode, that was so much fun!! 😂💜💜💜
moonchild0405	찐 ❤
Liliane Negrão	Seoul 💜
Mariam Bts	💜💜💜💜💜💜
Montse  Peña	I love you, Jin.
caramelmacchiato96's	I love you, worldwide handsome.
BTS's One of Army Rai	JINNNNN 💜
tata Taetaq	Kim seokjin : historical seoul
Yoongles Mochii	I seoul you too Jinnie
TaeKook's Noona	Yes Jin, I want to! 😍😍😍
Rubab Naz	this suits with jin's sophisticated and elegant nature
GreenTeaTM	If Jin was my History teacher I would never skip class
Flávia Francis	Kim Seokjin I love you 😍
ferchichi houdaxBTS	Jin💜
Nomi	SEOK JIN AKSIXKX
Evelyn Denise	Al toque roque
j kelly	JIN💜💜💜MY HEART❤
Jeon Jungkook	So much history 💜
p p	💜
Not the real RJ	the love of my life inviting me to seoul, what should i say? YES SIR !!
terry jin	I love jin  i love seoul.
Stephan Denaer	EAT JIN BABYYYY I LOVE YOU SO MUCH CAN I KISS YOU
BTS ARMY L.S.	Jin😍
Mango Orange	This reminds me of RJ’s tea 🍵 ceremony...
strong fetus is jungkook but i am an ot7	Oh wow 🙁.... I want... To go 💜
R M	Legend
King Seokjin	SEOKJINNIE
Clo Chu	Goshhhh so beautifuuuul
Sandy TaeTae	Every ARMYs dream is to go to Korea..hopefully one days guys🤞🏾🤞🏾
Yuliana B	beautiful
Cynthia Laureta	Suits Jin to a T. Good thing they didn't include a clip of him doing pottery. :)
Bella Zhinin	#JIN  #WorldwideHandsome  ❤ My love 😍 My boy 💕 Eres perfecto 😚
Hye Won Park	석진이가 달려라 방탄에서 만들었던 자아있는 도자기가 생각남ㅋㅋ
ARMY Jimin	💜💜💜
mary armyarmy	Woow It looks so beautiful!!
Alexandra Hern	Seoul... i want to experience everything it has to offer!💜
Emy Kim	Jin 💜💜 so beautiful
mark tuan can't relate	I seoul U, Jin. 💯💗
Maryjane Noriega	Jin
ARMY & BTS	WORLD WIDE HANDSOME REPRESENTING SEOUL😍😍💜💜♥️♥️😘😘
Emely M	JIN!! I LOVE U 💕💕💕
aimfineyoongi _	Seokjin i seoul you worldwide handsome
Ariana Ramos Vergara	Cuteeeee ❤️
DChile! :D	Wowww this is like a movie!!! And Jin is a Prince 🤤😍✨💖✨
Yara Alves BTS alves	❤❤❤❤❤🇧🇷🇧🇷🇧🇷🇧🇷🇧🇷
Dulce Yoongisshi	Wow, is amazing 💕
susan yhoselin	IGUAL QUE RJ :D MI WORLWIDE HANDSOME
Ashley Epps	Excellent 👏👏👏👏
sugasweetv	Hi guys~~it would be great if you can check out my new mv💕💜 “I’m fine”
skyup sin	목소리 너무 좋다 서울구경하러 꼭갈끄야 서울가고싶어 진이처럼
Agustinaxa x	Interesting
Jenny Monroe	I LOVE YOU JIN
V	This suits Jin so well! I love it so much! 👍🏻❤💜😊
Griselda Martínez	Ya me convenciste Jin... ahora lo único que me falta es dinero :v
pied piper	💜💜💜💜💜💜
Jennifer Rivera	It looks interesting!!
Gabriela Cristovan Lopes	Minha vontade de ir pra Seoul só aumentou meu bebê ❤
yuyun ayuni	I seoul u Jin💙
연주	💜💜💜💜💜💜
Mariana Ramírez	King Seokjin. 💜
Hanna Purplelove	You Seoul me Jin....😂💜💜💜 Good luck 🙏 I . SEOUL .U 💜
Nancy Soberanis	👍💜👍💜👍💜👍💜👍💜👍💜🇬🇹🇬🇹🇬🇹🇬🇹🇬🇹🇬🇹🇬🇹🇬🇹🇬🇹🇬🇹🇬🇹🇬🇹 me gusta la cultura koreana love
Rachel_ Rosé	WOOOW. A HISTORIC PRINCE.
se jeong kim	i love you jin~~❤️❤️❤️❤️
Inés Martínez	I love this man so much.
anyil dominguez	Belleza
Wilyanne Monique	Quero conhecer de perto a riqueza de Seoul
Tine P	This fits you so well Seokjin-ah! Saranghae!
nochu mochi	SEOKJIN NATION WHERE YOU ALL AT!?!??!!!!!
jess JBTS	It’s interesting🙌🏼💜
Hilda Ortega	So beautiful 💜
LR	I would really recommend visiting the National Museum of Korea. It's huge and really fascinating to see so much history preserved. I think I spent 3 hours there exploring it was so much fun.
magda uvu	SEOKJINNIE 💜💜💜💜
Lovely BTSfan	I love this. Absolutely beautiful history. Ah~ I want to visit Seoul even more now.  And the worldwide handsome ambassador is completely beautiful inside and out!
L o R	Kim SeokJin with the history and culture of Seoul...perfection! 😘
Haislane Moreira	Que lindo, sou apaixonada por Seul #BR
Wanudya Lightwood-Bane	Everything is perfect until 0:18 reminds you of BTS doing chaotic pottery in Run BTS.
BTS HAPPY I AM HAPPY TOO BTS SONG MY HEALING PILLS	I love history culture 😍😍😍😍😍😍 my Jin 😍😍😍😍
molly dariuss	I’d loved to explore all those cool places
dumbo popo	I SEOUL SEOKJIN 😍😍
신종순	꺄아아아악~!!! 목소리도 너무 좋아. ㅜㅠㅠ
C Suh	김석진 사극에 캐스팅 해주세요. 우리 진오빠 연기도 잘하고, 완전 사극 이랑 찰떡궁합!!
Love yourself: final	RJ = JIN c:
Daniela Aguilar	Oh cute💜
Rocío ;	TE RE AMOOOO
Ivan Veliz	AMAZING🤯💗
hobihoping	Ugh yes, Jin, you look so amazing! And I definitely wanna see the sophisticated and rich history of Seoul!
Rosmery Geraldino	💜💜💜💜💜💜💜💜💜💜💜
Nora Oliva	TE AMOOOO JIIIINNN😘😘😘😘😘💜💜💜💜💜💜💜💜
Ayu Lestari96	Go get tickets and fly to Seoul 😊😊😊
ygstanthatstansbts	a prince.
L a r i	QUE LINDOOOOOOO SEOKJINNNNN
osuka al	Seoul is so beautifullllllll, like jin 😍😍
riima M	Jin-ahhhh I'll come to Seoul to meet you ❤️❤️❤️
hoseok's cute elf ears	he's so cute oh my GOD :(
90xm	king seokjin invented the world
Giant Kookie	I love this!
Alexassandra D L Cruz	Jin Jin Jin te amo
jianzui	I love it so much 💜
pocaari	king
ana alba	Amazing 💞💞💞
Mrs Jeon97	😍😍😍
Hye Lee	귀여워 석진이 ㅠㅠㅠㅠ
Yessenia A. Bahamondes Parra	the vocal god!! yes!
Amal ARMY	اححب جيني وسيول معك ياشيخ 😍😍😍😍
Ui jeonggg	I really love these historical places and cultures! Thanks BTS for introducing me to KOREA!
Sherine Bilal	i love you jin💜💜💜💜
Mel Ack	Worldwide handsome 😘
Claudia Yana	Tan bello todo
SHARna loves lilseok	This suit jin so well. Like that polite royal vibe...
Belen Salazar	Lov u
Gabriela Leyton	Lo ame 😍😍😍
햄마스터	귀여워 ㅠㅠㅠㅠㅠㅠㅠㅠㅠㅠㅠ 금이진 돌아와욧
Angélica Quintero	Jin is so beautiful, I can't believe someone like him exists in this world😩 also Seoul looks like a great place to visit, I will someday!
Mariachi El	Seokjin 💙💙💙
Yani	Seoul 😍
Velvet Oc	Why i can see RJ there?
らら리리lala	Definitely a place to visit soon....💜💜💜 kim seokjin thank u
Eytham	Kim Seokjin 💜💜💜
Kaah  rocha	I want to go to Korea💜💜
Recthel Lovendino	❤❤
Joss	KING
Jin0412 BTS	Seokjinnie
아미방탄소년단	Our worldwide handsome talented man💜
Mel López	Bien 👍
cyndi cavestany	Jin 😘
ianka alcira mendoza lucano	Hermoso mi Jin,   da emoción por conocer de la cultura coreana.
Luisa Fernanda Alvarado Medina	¡Muy hermoso!, aprender y conocer toda la cultura 💜.
Lyn Joy	seoul is historically beautiful. thank you jin for showing the ancient side of a modern city seoul
Jenniffer Faria	Thank you baby 💕
Koya	Beautiful
Antonia Amin Coliqueo	💜💕
Mia Mancilla	HERMOSOOO
Balala Tatat	Our elegant and handsome Prince ❤ deserves lead role in historical dramas
katie soo	😭😭😭😭😭😭 Kim seokjin ❤❤❤❤❤
Fitriana Rahayu	Makes me want to study history^_^
Amy _bts	Seoul is beautiful!!💜
BTS ft my Tears	This is so beautiful
Yeii Park	Thanks Jin 💜💜
Nahir Escudero	Worldwide handsome ❤️
niarah	KING
강윤희	진 목소리 넘 좋아^^*
Idk :D	MY CUTIE
Rawan	Jin💜😭😭
Hillary Rose	Historic legend
bijj you know BTS???	That one dislike👌😌
Ana Itz	Jin so cute 😍💜
장애선	진💖💖💖
dulset yoongles	Bat sayo napunta yung historic seoul napaghahalataan ah ahahaahgaha charot i love u jinnie so much
Daniela Carrillo	My worldwide handsome I love you I love South Korea 💜
JA NNA	QUE LINDO TODO 💜💜💜  KISS FROM 🇦🇷
김냐옹	Worldwide handsome jin😍 잘 생겼다
rena	💜💜💜💜💜
yoon jin	💜
Johana segura	Ahh jin bebe hermoso fuiste a explorar con Rj
chim chim	Es tan lindo mi jin ;"v
Yesi Hernandez	Wow! This is beautiful. I can’t wait to finally visit
Jazmin Vazquez	¡Se ve muy interesante!
BONSAE.POMSAENG.POMSA MH	Please tell me I'm not the only one who thought of that one Run episode when the ceramics scene came up..? 😂💜💜
Selina Perez	😍😍😍
Misaki tan	Holaaaaa Jin jqjdjfkjdjsmslfbal 😄😄😘😄😘😄😄
goldencloset_jk	i'm in love pt. 2
Nina KatyBTS	Why I'm so early.!!!  You're so beautiful JIN😘 Love you BTS💜
georgina leon	wow korea's tourism promo done right ... their mind.
gayatri bali	Kim seokjin ❤️ 😍
Angie Pham	"Do you want to listen to my Seoul?" HA good one
luli Moreno	Jdifbeidbdkndbfidk  seokjin 😍💕
지민랜드	진 너무 사랑해해❤❤❤
bla bla	Jin looks so noble.
Susana gonzalez	Jin💜💜💜💜
bluë pop	SEOKJIN 💜
اسيا السالم	We love jin , Bts , seoul💛💛
딩 딩	jin!!!!!!!!! i love you man
Thatyane	SEOKJIN 💜
Marie Katrina	YES JIN I WANT TO TRY IT TO
ريكا سان	طين أصعب حرفه بالنسبة لي 😂😂😂😂😍😍بس احبها
No Thunder	영상미가 좋네요오-! 진 목소리까지😍♥️♥️♥️♥️
Daisy R	I want to visit Korea because of BTS!
Worldwide Shoulders	I am now convinced to go to Seoul...
햄토리jin	Jin😍😍😍
I'm manggaetteok	♡♡
YESE NIA	Wow que bello 👍🏻
아나	Arte mostrando arte.
ButterflyARMY	I love you Jin 💜
kim Nara	Worldwideactor!
Mary Lee	worldwide handsome 💜
kyungah kim	BTS  JIN♥♥♥Love  you♥♥Miss  you♥♥
Sara J	seokjin is amazing
Hannah Faye	💜💜💜💜💜💜💜
Jimena Enríquez	La historia de Corea es tan atrayente... gracias por promover a tan bello país. Jin 💙
laalways lala	Jin♡♡♡♡♡
리스김	Seokjinnie~~~
Phùng Linh	I Seoul U 💜💜 I love Jin 💜💜
Soohyun Yang	어흐흑ㅠㅠ  짧아도 좋구나~~♡
Adry VMendicuti	Corea tiene mucha riqueza cultural, necesito ir :D
Samanta Gaytan	Jin!!!! I promise I'll go to Korea I'll go to your restaurant and I'll see the same beautiful places you always see  I love you so much
Indah Dwi Ariani	I want to see him more 😭😭 my worldwide handsome I hope you get an acting role very soon ❤💙
Nuna Nuna	THis is so cool.
ARMY are BTS fans	SeokJin ah I Seoul you
Nicole Alvarez	Me encantaría ir! Parece un lugar totalmente enriquecedor 😊
lazygirl98	Wow i want to try it !!! 👏🏽👏🏽
love yourself	Jin you look so good
kdrama Krazy	I Seoul U Kim Seokjin
yngisjin x	Wow seokjin is beautiful
Liv Miller	I would like to go to their museums! So much history and culture to learn, amazing. Jin looks as handsome as ever, yup.
BTS 7	김석진 귀여워 ㅠㅠ
CATANAIAH MESA NUÑEZ	Mi vida te amoooooooo 😍😍😍😍
lara frind	JIN
Book is Life	KIM SEOKJIN!!! 💜💜💜💜💜💜💜💜💜💜💜💜💜💜💜💜💜💜💜💜💜💜💜💜
hope and candy	por el unico Kim Seok Jin sere capaz de aprenderme toda la historia de Corea e ire a visitar lugare historicos! aunque ahora no porque no tengo plata XD
Chika Cho	Love you Kim Seokjin🙆💜
Jackie Andrea	Jin tan bello 💜
boy December	영상 이뿌다
Kamineko13	as expected Jin representing historic Seoul ❤ I want visit the museums
Romina Fuentes	Que lindo jinn!! ❤❤😍😍
진한손키스	응 진이랑 해보고시뽀♡
Mi Mi	TE AMO SEOKJIN
ARMY DO BTS	JIN MEU DEUS QUE LINDOOO 😍😍😍🇧🇷🇧🇷🇧🇷🇧🇷🇧🇷
베로니카	PLEASE LIST THE VIDEOS  SO WE CAN FIND THEM MORE EASILY INSTEAD OF ONLY PUTTING THEM UNLISTED THAT MEANS THAT WE CAN ONLY WATCH THEM IF WE HAVE THE LINK
softmochi	WORLDWIDE HANDSOME
kim sj	MY KING
Isa Min	MI PRINCIPE
A M	Really suit jin's personality. Fine and good looking !
ABBY RABBIT	Jin: Historic Seoul (Seúl histórico), muestra la historia de Seúl, incluyendo artes marciales tradicionales, museos y cerámicas.
Alejandra Vkookmin	SEOKJIN!!😭😻
LY_kimchi	Seoul has so much rich history! Just like rich Kim Seokjin himself. Winning!
Lauanda Barros Ribeiro	AAAAA KIN SEOKJIN😍😍💜💜💜💜😍💜😍💛
Mundo De Mirella Mayer	JIN! SEU LINDO! 🇧🇷❤ Muito lindo! Muito top
Ivone Ro	This suits with Jin sophisticated and beautiful!!! Thank you!
magickoya	KIM SEOKJINNNNNNN YOU INSPIRE ME EVERY DAY
LINA R	Wow
Irrezel De Jesus	Armys let's go to Seoul
Jay Frost	JIN💜💜
Cristine Ibona	My love
nona nano	THE LOVE OF MY LIFE
아기 천사	MY KING
MEL T	JIN BEBE
sopearlx	Worldwide handsome 😍
Elizabeth Yepes	ESTOY MURIENDOOO
