Saida Mohmad	Omg amen god blees you insha allah mgkatulyan kayo sa panahon hehehr
rose gainsan	I love you Edward for may2
Zabeth Abgelo	Thank you twba,titoBhoy & abscbn na vngyan nio ng chance c edward na mainterview kgabi sbrang pinasaya nio kmi.😊😄😉👍WeLoveyouMayward.💑💑💑💑😍😍😍😍💙💘💙💘
Christine Nivera	My god kinikilig ako yes talaga Wala na paligoy ligoy my god swerte ni maymay 😍
gedz Mustapha	Grabi 😗😗😗😗😗😗😂😂😂😂💋💋
Joselyn Pao	Wla.na finish na tlga road to forever n tlga.  Cla
Grace Perez	Sabi ko na nga ba... pag nag18 itong batang ito saka sya aarangkada. He he he...
Jubelyn Mata	haha teaser palang may dislikes na alam na  haha
cresilda labolera	UWOIAN NA MAY NANALO NA MAYMAY HEHEHE😍😍😍😍KAKAADIK PORAS NG PAGTULOG PUUATAN KAKAHANAP NG BAGONG UPDATE SA MAYWARD PA SHOUT OUT NMN KAMI DI TO SA #DHAHRAN,SAUDI ARAMCO KSA LOVE YOU MAYWARD SAMA MAGKATULUYAN KAYO❤❤❤
Obaida Taher	Oh my goooddddddddd😲😲😲😲😲I can't sleep because of waiting for TWBA😂
ruchi ms	YONG YES ANG NAGDALA ,SKRENGGE MAY NANALO NAH MAYWARD HABANG BUHAY😍😍🤗🤗
Cha Gomugda	Omg!! Kiligness overload! A Big Yes n no hesitation talaga c baby boy edong  about marrying may2x question! Teaser p lang to!
Helen Cantila	HA HA HA GRAVE BAI URA MISMO INAMIN NIYA WOW ..GOD BLESS BOTH OF U MAYWARD..
Ruby Abalayan	Subrang,bilib,@,happy,ako,para ky Edward,,, subrang totoo lng sya ,kong ano yong nasa isip at puso nya,,,isa to sa mga winiwish ko for maymay ,na makatagpo sya ng mamahalin nya na makakasama nya pang habang buhay,,,at sana c Edward na nga ito,,,,kasi for me distiny talaga cla ,ilang ulit ,bisis nato nangyari sa kanila sa pbb house. Piro. Nagpatuloy yong journey nila dito sa labas,,,ganun pa din,,kaya i wish u all the best maywards,,stay strong lang no matter what happened and dito lng kaming mga tagahanga nyo to guide @ support u,,,luv u. Luv u ,,god bless to all of us,
beth Catid	kasalan na yan
Vian Batan complete episode please	Sa manunuod Vedio nio nmn please...wla kme t.v sa Lebanon 😍 😘😂
Singwe Mangansakan	Kahawid cla ne enrique per0 mas gwap0 cya😍😍😍
Everette Verano	Ngayon na ba to ipapalabas
MikLot More	its a BIG YES!
Leonor Samaniego	bonggang #maymay😍😍😍😍😄😄😄panalong panalo na! uuwi nko😂😂😂
Elaiza Ortiz	Tapos as usapannn MAraming salamat TWBA 👏👏👏🙏🙏🙏🙏😍😍😍💘💘💘💗💗💗💓💓💓🇵🇭🇵🇭✈️✈️🇩🇪🇩🇪🇩🇪🇩🇪
Yam Magtanggol	exciting! #MayWard😍
Cxiejhay Rosales	omg dodong s sagot  mo plng n yes patay n lhat ang mga isda s dagat naglutangan n dahil s kilig😅😅
carina gonzales	Pastilan ka doooooong😭😭😭 kilig na kilig ako...woooooh😍😍😍😍😍😍 ambot nalng gid😂
Lizel Lamera	Nang Dahil kay Maymay at Edward kaya Nag Subscribe kaming magka barkada sa ABS CBN...kasi masaya kami sa Mayward
ASMAIRA Ali	Patay na yesssss
Erin Alley	How adorable!
Rheagrace sumaya	ayyyy aabangan ko to
Ana Soriano	You're the man edward barber !!!
Nancy Yousef	Ang big yes ni dodong hay hindi ako maka hinga dong😍😍😍
Rosalie Cruz	Wala pa ang episode na to? I really inlove this loveteam i always pray na yong relayionship nilang dalawa mapunta sa happy ending to build there own family,grabeh infact nilang dalawa sakin,wish that i will see you in person.God Blessed you both.
Toneth Manzano	Grabeee anG saGot aGad aGad wla nG paliGuY liGoY P haYYY... Overload kiliG n nmn kmi we love u maYward and suPPort Godbless😇😇😇
Romey Osano	20 timesko na ata inuulit2 yung vid na to..😍😍😍
Priscilla Escama	BY GOD's Grace and WE Are FERVENTLY PRAYING to GOD that YOU'd BE HUSBAND and WIFE.... in GOD's PERFECT TIME, MAYWARD!!!
Jo Panganiban	MayWard 😭😍😍😍
Naima mimbalawag Maoyag	Saan na full video nito
Marilyn Labto	Wahhh..nakaka excite to
Angel Light	Makatingin nmn c edward kay maymay kahit sa pic lng makikita mo talaga ang admiration sa mukha nya. God bless MayWard. MayWard is <3
Lee mariz	Pwede na po ako sa langet😅🙈😄
Miso Kim	Tapos na ang laban Intertwined" bla mali ata spel.ko Bsta Tapos Magpapakasaaaal cla!💏💏💏💏 shit mga bai KASAL NA PAG HAHANDAAN NG MGA FLYER'S 😍😍
MayWard Forever	Huhu😭😭
arlene corano	Sarap mag basa ng comments ninyo.
ross tito	Excited for tonight's episode #MayWard 😍❤️
Alona Taguibao	oh may marry.you
Aisha Mich	wow😍😍😍😍😍i love dodong grabi kilig oi😍😍😙😘😘
Pearly Shell	😂😂😂Natawa nlng din ako kay tito boy prang gusto nyang gayahin c dodong sa pagpa stretch stretch sa bibig nya😂😂nahirapan syang gayahin c dodong🤣🤣❤️❤️
NEW GRP aim in motion	wla na tpos na ang laban..😊😊sabug na..dodong..sna hbang buhay..😊😊bravoooo..
fangirl MayWard	NAG INUSARA sa buhay ni miridil , One & Only guy , nag iisa ka edward barber 🙌 saludo ako sa katapangan, at pagka honest muh, grabeh pagmamahal muh kay maymay !!! habang buhay na toh💍🙏
zainab Eijaz	Nakakatawa excited na dodong
GRAVITY TEAM	Jusko lord. ..nakarating na sa pinas ang kilig ko sa diretsahang sagot mo Edward. .57 naq felling ko 30 lng aq. ..sa tanang buhay ko ngayon lng aq nag idol ng ganito! Kaya sana wag kayong magbago sa isa isa. ..god bless sa inyong dalawa ni Maymay. ..
MAYWARD Arlene Bajan	Graneh babyboy detetsahang sagot talaga basta Ky Maymay lang sya talaga...Love u both !
Myrna C Binektas	Oh what a good news so kilig nman  this answer😍😍😍tlgang direct to the point no hesitation na YES...he will marry MayMay😍😍😍❤❤❤ Good luck MayMay and Edward. Ipagpatuloy nyo yan. Looking forward in the near future. God bless.
Sean Pauline Palmares	Saraaap ulit ulitin huhu 😍😍😍
laurenz techo	Juskolord! ❤
Cobi J Rosswell	last night of the world,i want to.attend the wedding of edward and maymay😂😂😍😍😍hahaha😂😂
Glory Abubo	full episode po
Amarah Jung	Para sa economiya,,yes!
Bing Velasco	Ayan na ha? Nasagot na...he will mary Maymay... Just go MAYWARD....
Jane Paradia	Can't wait to fallin in rehab again.😍😍😍😍😍😍😍😍😍😍😍😍
Somer vhria	Yes may nanalo na...uwian na mga bess hahahahha
YLem Mely	Panalo na mga besh hahaha..Kilig much s sagot he Edward
mochi/kookie jikook 4ever BTS/MW	huhu.. makabuang jud!!!😱😱😱
Sonia Acovera	Direct to the point he answers yes.if he wants to marry may2.wow what a brave young man the battle is finished.they are waiting for the right time that they will announce that they are official bf gf.i cant wait that to happen.
Mona Mona	Ganyan pag mag isa lang c Edward deretso  sagut pero wag magkasama cla ni mayang kahet San interview hndi nasasagut ni Edward ng maayos pansin  niyo nmn qng  may tanong kai Edward tumingin c mayang kai Edward qng  hndi sinisiko ni mayang c Edward para hndi masagut ung tanung galing kasi mag tago ni bebe girl eh kaya wag c Edward lang hainaku halos patayin nah ni Edward ang mga  basher ni mayang 😍😍😍
JONEL BERDAN	0:05 MONDAY NIGHT DECEMBER 31, 2018
jho mapag mahal	Ung mga umaasa jn na mga isda tumigil na
Noraisa Montawal	wahh bagay mging model perpectmatch tlg cla ni maymay,binatng binata kna tlga im so inlove of u #mayward
Pangit Aqo	Graveeeeee😍😍😍
Cherry MW	He doesn't have to think twice..he knows it already from the start...she's his destiny and vice versa.😊
Tet Lopez	Yes
laoc dioresa	Grabe bai...sana my mg upload ng full video nito sa pag na air na ito. Hindi kc mkapanuod pg Monday kc late n masyado.
Diana Relos	Yes na yes todo nato hahhaahah
pretty baby	wow aabangan q tlaga eto guyz upload nyo ha??? malayo aq hahahahahaha im much excited .... graveh...
Rey Doruelo	Owh em gosh!!! 😍😍😍 Ang bilis tlga mka yes ang dodong!!! Aabangan ko to bukas supahhh xcited!!!
Jhohana Landasan	Oh my god san may uncut ang intervew n ito....😍😍😍😍yung yes mo edward nkka tindeg balhibo....
MARK ARELLANO	wow ...I can't believe it amazing answer ....strait to the point
Jemalyn Alcantara	Woo kaabang abang ang dodong nmin MayWard forever
Dianne Turonan	Grabi si edong walang paligoy ligoy sagot..yessss agad..hehehe
verlyn ybanez	Excited n ako para bukasssss TWBA....
karenann Bawing	omg!! gusto ko yan edward basta kay maymay
marnilie Aquio	Ang cute ni tito boy
BlackTwice Fan Forever	BOY:WOULD YOU MARRY MAYMAY?? EDWARD:YES!! EAHHHHHHHHHHWWWAAAAAAHH UNG KILIG KOOOO UMABOT HANGGANG LANGIT!!!WAHHH
Rochelle Villanueva	Ang lutong ng YES! ni dodong edward😍
Nenia Licardo	naih! ako ng bigla sa YES nya.. naku dong sana mapanindigan mo yan... walang baguhan...
Maria Movi&Music	Tandaan nyo yung sinabi nya ha... Kasi kung hindi magkakatoto ibig sabihin showbiz lang pakitang tao pra sa fans... So yes .. Tandaan nyo isave nyo ang video na to pra may saksi ok
Eliza mae Pantaleon	Kainis kau mayward. Kilig much si aq...❤️
gonzales joy	uwian na ...😚😚😚
Ida rica Thompson	Kilig mayward 😍😍😍😍
Dory Bajande	Naloka ako sa walang pagdadalawang isip na YES ni dodong, yung kilig ko from head to toes, back and forth
calvin Hawkins	Tinamaan na c edward😆
Ilyn Manantan	Sila na talaga kasi di yan sasagot nang yes if di cla in relationship.
zuseth gumata	Bushaak oi...!😍😆😆😄😉😘😘😘❤❤❤mayward💑
Genaline Tungul	Im so excited!! Omg talaga!!! Dnko makatulog,,  kakainis nakkabitin ka po tito Boy 😀😀😀😀 wala pa man mag saya n ang lahat yahoooo... Mabuhay ang bagong kasal 😘😘😘😘😘
Bella Tubil	😱😱😱omg mabuang ko dodong ung heart ko ano na to lalo ako mababaliw sayo dodong edward ng buhay ni maymay 😄😘❤❤❤💓💓💓💓💓💓 Mayward💋💋💋
Normina Tan	O M G 😮😮😮😮😮 Plsssss oxygen  Hnd ako maka hinga..... 😍😍😍😍😍😍 Patay na ako dtu sa OMAN
vanz drew	thats really what we called love ...lupet mo edong love u fan here edward
Jhanz Cadeliña	..ayaiii gikilig kog wala sa oras hahaha
Bellie Rose Fortalejo	Wala na... Teaser palang yan pero halos tumigil na sa pgtibok yung puso ko sa kilig panu pa kaya pag buong episode na.. 😐😐😭😭😭 RIP to my ❤❤❤
Rodolfo Finez	kissward
Lorna Mae Bautista	WaaHhhh.. Cant help myself from screaming.. 😍😍😍 MayWard forever 💑💞💞💞
Chappy Thebunny	Paulit-ulit akong nalulunod dito!😭😭😭
roxel secret	Aeyyeeeeehh
Robert Rabilo	Oh my !  Tito boy - Last night in the world would you marry maymay? Edward - YES !!!!! Me - arghhhhhh 😍
Realtalk Casual Viewer with Honest Opinion	MayWard😍😍
Madelyn Emperado	Paktay na edward ❤💞💟
Josie Jamieson	yes well done baby boy edward thats awesome answer to tito boy abunda thats  what we want to hear from you that you will marry baby girl maymay our heart beating so fast sa kilig
Margarita Almedilla	I like your being straight forward edward.... 😍❤
Evangeline Agustin	Teaser p lng yaaaaan!patay na ako!
Bebs Navs	D k alam bkt lumulukso ang puso k basta sla na ang nakikita k sa youtube parang may kiliti d k mawari  bsta ang alam k mhal na mhal k ang mayward
anivee amado	omg c dodong yes kaagad dong maaga pa wag mo muna kami patayin sa kilig baka hindi namin maabotan ang kasal nyo ni may2..
aldinabdurasa Abdurasa1	Halaaaaa! Ang sagoooot!!  Nakakahimatay, anubayaaaaaan dong !!!    Ay wala na talaga tinapos ni dong ! Mr&Mrs Marydale Entrata Barber 😍
nhorz lapastora	Oh yeah.....so happy both of you ni Maymay Edward. God bless your marriage life. hahahaha advance ako mag isip.😍😍😍
Elgibe Baguna	Fish Kill  Yesss Libre na sa palengke  ang mga isda
Rio Cruz	He really is... One of a kind in this world... I really love Edward, his personality, attitude, so brave and really smart....
Devera Everlyn	aabangan ko toooooooooooooooooo
Norhaisa Dabpil	Hahaha ganda non tips ni maymay
Mary an Abueva	Weew.    Nemen ,, tinago tago NYO pa ilalabas Lng nmn pla ang totoo nyung naramdaman,,
Gin Miguel	YAN  ANG TOTOONG  NAGMAMAHAL YES AGAD AGAD ANG SAGOT.. HINDI SIYA KAGAYA NG IBA NA  MAG-IISIP MUNA NG ILANG SIGUNDO BAGO SUMAGOT SA MGA TANONG LOVE YOU MAYWARD
Jenicar Talde	😘😘😘 kakapanood kolang ng shes mine tpos ito na nmn😂😂😃😃... mai nanalo na . advance din c tito boy mag tanung ehhh😐😐😐😐
bella camar	sobrang astig grabe ang gwapo im so proud of you ang galing mo na magtagalog❤️❤️❤️more blessings for the both of you #mayward😘
UNO's 13vlog	Sobrang bagay nilang dalawa kung imaginen mo magiging anak nila ang gwapo at gwapa jd tas matatangkad p😍😍
Geniveth Enes	This is it! Noon paman Edward may tiwala na ako sa'yo para kay Maymay kasi yong mga pagcare at clingy mo kay Maymay the same sa asawa ko at lalo na' pareho kayong maka Diyos. Looking forward for the wedding celebration. Mayward.
margarita balusdan	Yehey!!!! Mayward talagang d nakakasawang panoorin ang mga ganap nila 🐖🐓
Lanzie mae KSA	Wuh!.kinilig ako sa Yes mo dodong 💕💕💕 Monday na bukas😘😘😘😘
Akiah Princess	Bat hindi scripted😂😂😂😂😂bushakkk agad2x?yes?hindi talaga ako pala.comment peru dito comment ako😂😂😍😍godbless mayward
rose agunias	waaahhhh...ayw ko na😂😂wala pang  lunes nkkmatay na..
Rhaine Pesigan	Speechless kinilig nlng ako sa straight na sagot ni edward💝💝💝
whemz nhem	grabi ngayn lang ako nakarinig na bata pa nga love team marry na agad pinag usapan omg!exited na me hahah....lv this love team mayward from the beggng until nw heheh...
Nasra Hasim	wow mka yes talaga ohh.
Arnavic Sila	Ayeeeeeeee kilig much ......Go-gogogo MAYWARD....we love.....you so much....abangan Talaga nmin ang kasalan.....💑💑💑💑💑 kaya MAYWARD stay strong forever....ever
Diana Manalastas	Haba ng hair mo may!😊
Helen Macero	Kinilig ako duon ah big Yes talaga tapang sumagot ni edong grabe nato Aabangan nmin Yan Dong, pero kailan Kaya, by the way Maghihintay kme sa Tamang Panahon
EDEN'S BLOG	bushakkkkk!!! na yes mo DODONG ang lupit
melyn aballe	Maka yes wagas 😂😍😘
NapsaMartinez Martinez	Halla hahhahh May uwian na nanalo na
Eilyn Amor	Parang hinugot ung puso ko pataas 😂😂😂 haaaay!!!   Kabuang na mga bata to 😂😂😂
Mylene Limon	yes !! i love it
Marelene Paris	Yes n yes even at the beginning not only for the last day of the world, he can marry Maymay... Bcoz maymay one of a kind, she's a gem to be care, protect and to be loved.. lab u Mayward 😘 😘😘
lyza santillan	Ang pag YES talaga ni Edward ang nagdala.. 😍😍 R.I.P  ⏪ Button😱... Monday na unta ui.. 😍😁
Cerela Genisan	Sana my full vedeo neto.....🙏🙏🙏bushak..nakakamatay...straight to the point talaga c dodong sa pgsagot...
Mhons Abdul	Mayyyyyymay godddddd guapo nia edward, di nakakasawa......
Mellicent Musngi	Saved
Aileen Mae Buccat	UWIAN NA!!!!! MAY NANALO NAAAA!!!!! HAY NAKO EDWARD!!!!!! SI MAYMAY NA TALAGA!!!!!! 😭😭😭😭💙💙💙💙💙💙💙💙💙💙💙💙💙
jUzmirah sapalon	wala talGang paLtos ang sagot diretsahan aGad bushaaaak mamatAy anG fLyers ng waLa sa orAs
gene Marade	Kaway kaway sa mga pinapaulitulit tong vidio  💓💓💓
Marielah Barrios	OMAYGHADDDDDDDDDDDD HE SAID YESSSSSSSSS
Florentina Boyonas	Ung tipong maiinlove ka sa mga commentsssss😍😍😍😍😍hahahaha😂😂😂😂kailangan ko ng oxygen ang puso ko tumalon bigla sa narinig ko kay edward ilang besis ko nirewind at damdhin ang cnbi nya na wlang patumpiktumpik na salitang ANG MALAKING YES😍😍😍😍😍Inshaallah dong mahal mo si maymay.
Pabz Zamora	Uwi mga baks,hahah May nanalo na c maymay.
Leslie Yadao	Hahhaha..grabe ...sa comments pa lng busog kana...pano pa pag narinig mo kay Edward ang salitang “yes”..pano na hhahha
Kristia Darlene Campomanes	Marami tayong mawawalan ng oxygen sa Lunes. 😂 Excited na ako.
Darlen Gay Quileste	Bushak ka edward..wlng patumpik tumpik ang sagot..yes kaagad..ha..ha.
Amy Bela	waahhh mag monday kana.atat lng si ako.ayyyiiieee walang alinlngan YES agad agad #MayWard
Rodjean Marcelino	Monday pala to hahah akala ko kahapon
Yllas Leal	Hoooh ilove to hear that, boss boy abunda. Thank you Prince Edward...... yllas leal from hongkong
Mobile Legends	Lydia amoku sml?
Mary Grace Martinez-del Rosario	RIP replay button ahahahaha!  Game over na, ending na, finished na, panalong panalo na talaga si Maymay Entrata!  Happy ako para sa inyo, keeping you both in prayers, God bless you MayWard!  Thank you po for sharing this video 😊
Hey Ligayax	Waahhhh 😍💗
Lydia Amoku	Of course he's going to marry maymay because she's pure pinoy and he will definitely follow his father footsteps of marrying his  pure pinoy mother and he is lucky he found a pure pinoy with values like maymay and Edward adores his family and especially his mother and sister and amazingly they both love maymay...... Laura found a friend in maymay and mommy Cathy found a daughter in maymay who am sure reminds her of herself
Anabel But-ay	edward
Jalilah Pitiilan	Cgorado daming mamatay nito sa Monday haha
TokkiYangYanGG 22	Napasigaw na talaga ako dito, RIP walls RIP my precious Pillows. Sisihin niyo si Edward sa sagot niyang 'YES' bushak! Bushak! Bushak! 😍😍😍😍💞👏👏 Ginalingan!!! Sheyyyyyt!!!!
droob m	Napaluha ako sa tuwa😂
jr kraft	Oh to the Gee to the Em....OMG...juice colored...Dodong, Yung pa YES mo Ang papatay sakin...relax heart we need to wait for the Monday to come...ahhhh...!!!can't wait for this....😱😱😱
Leonhy Sornito	Lord wag mo muna kaming kunin gusto pa namin masaksihan ang kasal na yan for the future. Thank you Tito Boy.
PR N	Believe talaga ako kay edward pagdating kay Maymay   walang paligoy ligoy ang sagot😍
gladays santos	finish na sasama na talaga ako sa liwanag with my pakpak charr  love u.dong sana d ka magbago sa bby girl.nmn at sana wag mo.siyng saktn
Elijah Maur	Shit..nagsiliparan mga dandruff ko s yes nya😍
Mayward fangirl	teaser p lang pamatay na jusko Dong hahahhaha  pero seryoso eto tlga una kong nakita kay Edward since PBB, my Paninindigan s kung anu ang s tingin nyang tama!
Anna Gonzaga	Pa'no mo malalaman pag may MAYWARD SYNDROME kana?:   Signs and symptoms 1. Unang tingin mo palang sa video ay kinilig kana. 2. Pinapanuod mo na lahat ng video nila sa youtube. 3. Gumagawa ka ng account sa IG, tweeter at iba pa para lang may update ka sa kanila 4. Hindi kompleto ang araw mo pag di ka nakapanuod ng video nila, mapa latest video man o throw back videos. 5. Nanunuod ka ng video nila pagkagising sa umaga, pag may vacant time ( para sa mga may trabaho), at bago matulog sa gabi nanunuod ka pampa sweet dreams. 6. Masaya ka pag masaya sila at nasasaktan ka pag nasasaktan sila o di kaya pag may nangbabash sa kanila. 7. Advance ka nang mag.isip tungkol sa dalawa. 8. Nahihirapan kang huminga at feeling mo sasama kana sa liwanag dahil sa sobrang kilig.  Kung meron ka neto may MAYWARD SYNDROME kana rin...hahahahaha😄😄😄
Diwani Ofracio	The best answer of Edward..is to Marry Maymay Entrata..and I know it will happen in the right time..
Mae Serv	ang gwapo 😍
Kaiting Liang	Always maymay edward hahaha
gema vargas	yes ilng bisis ko na view tong video nato can't wait for the full episode tnx Mayward for being my inspiration even I am single but I felt in uninspired with you guys. God bless you always
joy emnacin	Omg aabangan ko 2😍
Milk Magbanua	OH MYYY GOOOOSSHH😍😍😍😆😆
toni lou	from Dreal Tour concert Cebu to Inside showbiz cover then sa Monday eto twba!!!!  #MayWard lunod na lunod na kami pls help!!!!
Katrina Abdulmaid	Can't wait full vdio❤
Kiara Montano	Animal nqpasigaw aq ng wala sa oras
hanie derp	its amazing how good he can speak in tagalog now. remembering the days in pbb where he felt left out because he was the only one in the house who wasnt very good in speaking the language. shows his passion and dedication in learning our very difficult language.
Gliin Dee	Kaya panamn namin dooong okeey pa kameee shege shegeee lang 😍😍😍😍😍😍
Maricel mar Marañon	Omg excited na ako
Cris 1015	RIP rewind
Regz Yatyaret	Wala talagang pa ligoyligoy na sagot...
Rhaine Juanillo	Yan ang batang may laban😂😂😂...straight to the point and honest,nag iisa lng yan..."I believe there's no one else in the world that's like you,that's why im so lucky to have you by my side"EDWARD JOHN BARBER TO MARYDALE ENTRATA...😍
Bärli Dumfart	Ay grabe ka inlove si Dodlng talaga..anu bayan grabe sya oh...Panu maka move on sa ganitong sitwasyon...hnd na kakayanin ng mayward fans ang mga ganitong tanung..
SpreadLove JOY	💖💖💖🤩🤩🤩
Fragile Pavement	MONDAY!!!! DUMATING KA NA!!!  JUSKO,  EDWARDO. OU NA,  HALATA NA TALAGA NAMAN. MAHAL NA MAHAL NA MAHAL MO TALAGA SI MAYANG 😍😍😍😍
Alma Alentajan	Jusko!!!nd ko kaya!!!huhu
maria lourdes toroba	Tagal ng Monday... 😢😂, sobrang ginalingan mo Edward, excited n aqng mapanood ang interview mo, malamang puro May n nman yan... hahaha, lab it ❤
maryjay solito	ay kaabang abang DIOS ko LORD salamat at tinanong mo yun tito boy amazing question at amazing answer dong.😍😍😍
maribel peralta	Tang itssss tlga kagigising q lng YT agad at ito a gad nakita q.. I can't wait nahhhh... Go edongggg
Story_Maker 05	AAAAAAHHHHHHH MAYWARD!!!!
Maximillian Kolbe	Pde ng matulog ng mahimbing hahahahaha
HANA JUAREZ	OMAYGHAAAAAAAD!!!!!!ANG KALULU KO. . . WAAAAAAAAAAAAAAAAAAH.😭😭😭😭😭😭😭😭😭😭❤❤❤❤❤❤❤❤❤
Aziel Meneses	waaaah excited na ko 😍😍😍 Go Edward 😍
Anton Flores	Ahaa.. Naniniwala aq sau Ed..
Yeng Canpay	Hoy edward nabuang na gyud ka bah..igs puro nalang si maymay..perting gugmaha dong..ang mga  peranha ni k..suko na kaayo..hahaha
jesselou tagalog	Tinudo na ni dodong marami na kasing amaaligid aligid,😍😂😘
bhing pagobo	omg I will say yeshhhhhhhh toooo^ooooo im fan her mayward hongkong
Joash Nikka Avellanoza	Shet puso ko.. kilig na kilig!
Lulu Mar	Edward is a brave and honest young man when it comes to  maymay...he's diff.s lhat ng actor's straight answering the question w/feeling or comes to his heart..mkikita m tlga love nya sobra c maymay at proud svhin s national tv only maymay...
yram yam	...ito tlga young pamatay s kilig....ung p YES ni Edward s  tanong ni Mr boy abunda would you marry maymay?.... Wla n ubos n ubos n ang oxygen  naming Mayward fans... kilig overload ikaw n bebe girl maymay ang my Plaban n jowa.... 😄😄😄😄😄💕💕💕💕Mayward road to lifetime...
Fair Kim	Yung pusoko. Bushak. Diko kineri. 🤗🤗🤗
bretzie skyma	Waaaaaahhhh 😍😍😍😍
esmeraldaraul	UTANG NA LOOB I MONDAY NA.BUKAS I.kennatttt    kagabi.nahimatay n.kami.sa.SHES.MINE. NOW.YES.S. VOWS OMG❤❤❤
Laiza Miralles	JUSKO 😍😍😍😍 EDWARD . BATANG MAY LABAN TALAGA .
Maricel Satera	❤✔💯🙏🙏🙏😍😍😍
Isabel Patalita	Omg kaylan to eeri shit ang puso ko
Dhonela DelaCruz	😍😍😍😍😍
Charles Ong	Super excited na ako sa monday..thank you po twba..
Lorenzel Dadez	Tnx u tito boy #MayWard
Jingga Langit	0:13 HOOOOMAYYYGOOOOOD why sooooo cute Edoooong! 😂😍😘 In GOD time, MayMay is a future wifey ni Edong and Edong is future hubby ni MayMay ❤❤❤👆🙏
Benny Tiu	Panalo to! Tito Boy!!!😍 Si Dodong sinaniban na naman ng other half nya. hahahaha! ginalingan ni Dodong nemen! Ayosss! (insert Onyok)😂😘😘😘
Ronalyn Labitag	Kaabang abang!!! Lunes n b bukas?😂😂
park shin yhe	hala fishtea ang tgal pa ng monday 😂😂😂    😍
Apol Ilagan	Sana talaga he will marry Maymay soon,🙏parang ang hirap kapag masaktan na namn si Maymay.She deserves to be happy.
Lovely Malaya	,type ko tlga pg May lng ang tawag ky mm kc ang sweet pakinggan
Fan Fan	Woow grabeh kilig
Edna Benitez	My fav couple #MayWard 💖👫 real hindi pa showbiz
Kimberly Soriano	Ay grabe ang YES wala ng pag dadalawang isip yes agad sarap tlga interviewhin si dodong pag wala sa tabi nya si tsuma maymay nya kc derederetso walang mkakapigil sa knya...dati nririnig nmin bata pa kmi pro now di ko na naririnig yan sa lahat ng interview nya grabe inlababo na hubby ni tsuma yamyam
Leah capaoay	so guapo binatang binata na,ung yes ang ngdala diritso talaga😍😍
Dominga Tajanlagit	yes na yes, bwahaha
Al that Matters	Bushaaaak ayoko na sa earth finish naaaaaaaaaa 😭😭🙊😱😱😱😍
blink 17	PATAAAYYY ......KALULUWA KO HUWAG KANG SASAMA SA LIWANAAAAG😰😰😰😂😂😂
Maricel Anggi	Tapos  ang  usapan....yes  daw  eh,  kaya   wag  na  pumapalag  sa    cnabi  ni  Edward, sapol  sa  mukha  sa  mga  nag assuming  jn. 👏👏👏👏rock'n Dodong!
Smooth Sailin1	Tsuma-tumbling ang puso ko sagot mo Dodong! Can't wait for Monday! Haba ng hair ni Maymay! Kailangan mag-order ulit ng oxygen. Naubos kahapon sa concert. :)
Genevieve Tagun	Waaah sana monday na grabe yun YES ikaw na jud edward mkainluv
Keren Margarette Alcantara	Oh my ghad...sana monday na bukas..😂😂😂🙏🙏😇💑
Sydney Brown	OMG!  Pwede na bang hilahin para maging Monday na! Excited for this episode. Si Dodong batang may pinaglalaban talaga. :)
cristy jimenez	E yung mukha n tito boy after edward uttered "yes"..... Parang sinasabi "awwwww"
Nice Try	waaaaaaaahhhhhhh ang gwapo ni edward wushu inlove na yan thats why
Remy Fe Cajilla	Omg kelan to ipalabas?waaaa...
Anastasia Ji	Iba Din hahahaha
Sunflower Seed	Napayuko na lang si Tito Boy at napangiti sa sagot mo Dodong.....HANDA NA NG PAMASAHE AT PANG REGALO feeling ko sa bayan ni Dodong kasi malayo ang Cagayan para sa mas nakakarami na MAYWARD fans at gusto nila KASALAN Church Garden Beach Wedding "ANDYAN NA LAHAT" ang Pangasinan malapit sa Beach pwede naman pagawa ng kapilya at lagay ng damo at flowers PRESTO all in one 👏👏😍😍😍👏👏👏❤❤❤
Jaq Pena	Hoyyyyyy😭
leah fernandez	Ang cute talaga niya huhu haha parang ikaw na din si may2 dong. Haha
charmaine rosaroso	OMAYGAD!!!  😭😭😭😭😭
gotchoked #fakelove	potah potah!!!
bunak na Malandi	Hhahahha natatwa ako kay titoboy
kaila maree	ohhhh emn geeeee! rest in peace fishtea haha nkikiramay kmi sa mg inang bisugo charooottt
LLAMA Josephine Fan	"Last night of the world, would you Marry Maymay?" walang patumpik tumpik na "YES" galing kay Edward. Wala na Kasalan na Haha ❤
It's Jeneskiey	TSUMA is WIFE  TB: Last night of the world would you marry Maymay? EJB: YES!  I kennnnnaaaaaaaat... 😭😍😢😍
__dirkBLUE	jeskelerd!! Edward Barber,  BATANG MAY LABAN!! hahahahaha 😍😍😂
tiffany mendoza	2 years ago di pa Kita bet para Kay mm, baka kasi pa showbiz ka lang din. Gaya Kay Gerald at Tommy; ✌ Mahal na Mahal ko kasi SI mm ayoko na masaktan Rin sya pagdating ng araw. Pero ngayon heto ka patuloy mong pinatutunayan na mahal mo talaga sya. Salamat baby boy, oo naniniwala at may tiwala na ako na di mo sya sasaktan.  I love you MayWard.
Telia Inampo	Mapapamura ka ng palihim eh😕 eh di kayo na, ako na ang inggitira sa lablyp niyo😂😂
Tita Ganda	wala na talaga 😭😭😂😂
Riri Besana	😍😍
Isagani Villasis	Lagot na...iba tlaga..marry na tlaga to.
Tres Marias	uwian n mha besh my nnalo na...haha...❤❤❤..psub ndn po sa chnnl q..qng gsto neo lng po.qng yw neo nmn aus lng dn po 😁😊
Rex Mari Cabagnot	And what I like about him is the improvement of speaking filipino. From pbb na hindi talaga makaintindi to now na medyo tumatatas na.
Razhidah Santos	Omg 😭😍❤️🌹❣️🕊💫🙏🏻
Mary Dela Cruz	Napatili ako ayoko na aaaaaaahhhhh 😍😍😍😍😍😍😍 I love you #MayWard hanggang sa huling hininga ko
The Bro's	❤❤❤
Waley havey	My God kahit namatay na ang pinakamamahal na foreigner kung boyfriend 6 months na 😢 pero honestly #MayWard lang talaga nakapagpasaya sa akin lalo na sa tuwing malungkot, love you #MayWard my lifetime loveteam wala nang iba 😘😘😘😘
Rahma Degay	Grbi ka dong hntayin nmin yan kailan kau magpakasal iyak ako sbra na tinanong ni tito boy c dodong pakasalan mba c mayang hndi ako makahinga sa kilig at happy birthday tito boy we love you mayward engat lgi
Lovely Marie	Pans/Bashers be like: Fan service utos ng Management,si Maymay magugustuhan ni Edward? Mas bagay si Edward kay ano.... kasi ganito ganyan blah blah blah............. ito linyahan Lagi ng mga bashers ni Maymay
PAK GANERN	Si Edward di lang puro salita ..pinapakita nya rin tlga kung gaano kahalaga si Maymay sa buhay nya . Gaya nga ng sabi nya ..kaya nyang itaya ang reputasyon nya maprotektahan lang ang Tsuma nya  😍
Junelyn Manigos	Abangan ko to.Ang gwapo ni Edong.Puro Maymay nalang nasa isip nia ah..
Ella Mayward	Parang yong sa pbb lie detector test lng din ehh walang paliguy ligoy
watt ebber	💏
Jhaycris De Guzman	If masisimulan mo interview nya dati ibang Iba n now sarap ma in love sila na tlaga
Tine Rentosa	Excited na tuloy ako mag monday...yong pag yes ni edward aabangan ko sa future...mygad
Celaine Valdez	WALA NANG PALIGOY LIGOY PA !!! YES NA AGAD !!! ILANG KILONG BONAKID NILAKLAK NI EDWARD JOHN BARBER !!!! GRABE 😍😍😍😍😍😍 PWEDE NA SUMAMA SA LIWANAG !!, AY WAG MUNA PALA. Hahhaha
Tilia	Masyado ka dodong my gashhh😍😍😍
Maricel Palaming	Wahhhhh ohhh myyy gushhhh edward grabe it's a big YES tlga ,  excited na me sa Monday abangn ko to.  Huhuhu.  Salamt po.
Maryvie Lamoste	Shiiiiiiit edward ka lami ba nimo bibi boy oyyyyy!!! Hahaha
Bbydoll Hello	Wahhhhhhhh parang kukunin na ata ako ng liwanag 😭😭😭😭 tabang mga langit di ko kinakaya . Hahaha palaban talaga dododng
Jinky Publico	aabangan ko to 😂😂😂 yung yes nia Ang bilis😙😙😙ikaw na tlga dong..😍😍😍
Joan Evangelista	Juskolord pwede ba Monday na agad 😭😭😭😭
cindybeeroli dubai	Yung  nag dislike, sila ung mga alagad ni bunakid na nag kklat n nag pasalamat daw s knila si edward as supporter. At aasa p rin daw tlga sila sa tamang panahon 😄😄😄😄😄😄 yung bilasa nilang idolet n 2 years n s industry n wlang na i inpart kundi negative vives hahaha.. yung ibang kasabayin ni bunakid  nkapag lead role n s wansa at my maingay n LT n rin ha.. talent, karisma at pagiging totoo kasi ang puhunan. Yan ang hindi matutunan ni bunakid kasi premature
ShowbizzUpdate MLAv2	SUNTUKAN TAYO!!!! GG, KINIKILIG AKO!!!! KAGIGISING KO LANG PARA AKONG BALIW NA NAKASMILE AT KILIG NA KILIG!!!! KAYO LANG NAKAKAGAWA NETO SAKIN MAYWARD!!!!!!!! JUSKO FROM EWWW YUCCKK EEEW YUCK DATI NGAYON JUSKO HALOS SUMAMA NA KAMI SA LIWANAG.. WALANG MAG LOLOVE LIFE BASTA KAYO NA FOREVER,LIFETIMR PALA!!!!!  Ps. Nakacapslock tlga para ramdam niyo yung gigil ko HAHAHAHAHA
jucelyn ducay	Ano bah!!?..Edward na'kikiliti kami....for alifetime nato bai..😊😂😍😍😍
ellen duga	Ang sincere nung yes!!! Huhuhu..dodong...binata kana tlga!!...iba tlga kapag wla ang jowa..straight to d point lage...d pilit ang mga sagot..totoong totoo!!itooo ang REAL na totoo!!waaaahhhh..nabuang na!! Lab u mayward!!😍😍😍
K.i.M	waaaahhh yezzz❤❤❤
anjay calamaya	Peste na 😍😘😄 batang may Laban talaga
Bembol Bemz	Yes Marry Her Edward Barber Para makita na namin mga pamangkin namin Ahahahaha!
Rhaids Sadon	Mamatay naako sa yes ni edward
none none	sana Lunes na ❤❤❤
Baidido Guinda	Nahulog ako sa upuan.diko kinaya ang yes.ang haba ng hair mo tsuma maymay.
Karla Bello	Ang aga aga yung puso ko hulog na hulog na naman sa inyong dalawa!❤
lanie patiag	alis n aquo sa earth
Tin Ferrer	Waaaaaa bushaaaak! 😍😍😍
Reti Boncales	Wala na finish na. May kasalan na nabanggit. Sino maninirahan sa Mars? Don na ako titira, di ko kinaya...😂🤣
LyndyWu	Grabe nmn.. Dong wag ka munang aamin pls🙏
Red Rows	Walang pakundangan hahaha. Ayan ang tunay na nagmamahal. Walang pakiaalam bulgaran na kung gaano nya kamahal si Maymay. Iwan ko lang kung may aasa pang iba sa talas ng dila ni Edward para ipangalandakan na pakakasalan nya si Maymay. 😛😚🔥😇
Warlang Tunay	PUTRAGIS!!!!! YUNG PGKAKASABI NG YES SURE NA SURE TLGA!!! LINTEK KA EDWARD UMAGANG UMAGA!!!
Pinky Deguilmo	Omg kakaexcite sana monday na bukas
Joseph Samsom	Wow first of all happy birthday Tito boy and omg nawala antok ko sa yes ni dodong Edward maynanalo na talaga all mayward fans super duper happy
MayWard Lovers	Hahahaha RIP sa mga FishTeah😜😜😂😂😛🐡🐡🐟🐟🐟 may red tide!!😂😂😂😂👊👊 Finissshhh na talaga...panalo na c dodong sa heart ni inday❤❤❤😍😍😍
Joylyn Ariston Jurial	Gusto ko yog yes agad n edward ilang balik kona panNuod yong s part ng pag tanong n boy at sagot n yes n edward
aneong aseo	Owwwww my God  kasalan na
Ana Falip	Yay
makshin	Yes wuhuuuuu... Bye earth.
Noel Lopez	fully paid niyo na lahat ng may golden haven...  para may paglagyan kayo ngayong lunes..  hahahahaha...
Pinoy RandomTrend	yes.. waaaahhhhhhhhhh.. waaaaahh
Heta Catilo	Ang pogi mo dodong...grabe
Mary Alagao	Abangers hehehe
Eveee G	batang may laban ka talaga!
Golden Voice	Hala ang malutong na yes ni Edward 😍😍😍💝💝💝#MayWard
pasawayka16 eedyah	Wala na finished na...uwiaaann naaaahhh...tinapos n ni dodong ang usapan hahahha...Mr &Mrs Barber in tge near future...😘😘😍😍
asli asil luv	Patulog na sana ako ehhh... anebeyen😊😊😊 kiliggggg excited to watch this ahmmm... watching from ksa❤
whutuphexie	GAAAAHHH!! CAN'T WAITTTT!!! Sana Monday na!!! Huhubess!!! 🙏😭❤
GLICEL Castro	Oh my god edward  really  u marry maymay
Mona Lisa	Kakainis matagal pa ang lunes.
Elizabeth Brigino Gonzales	Josko Lord..teaser palang kinakapos n ako ng hininga s kilig....😊😊😊 Mamamatay yata AQ ng ilang seconds s Monday ahh...
Yanyan Mae	When he said YES 😊 and his smile myghaaaad i caaaan't . inlove po sya. So cute
Dhesa Tacorda	Nakakakilig Ka nmn Edward manginginig na nmn Baba ni mayang nian 😍😍😍😍 sure AKO first love Nia c mayang at magiging first girlfriend Nia in the near future Kaya Todo bakod Sia😅😅
jonjie mae	OMG,  xcited for this....❤❤❤
Maria Claire Tan	Edward grabi ang matured at tapang mo.yes agad to marry maymay.follow your heart as your father said before.and kung magical ka ka to do. Kaya aabangan nmin ang kasal nu ni maymay.
Ahmath Althani	Edong nmn haha tapang walng kautal utal na sabihing YES 😘😘
jan benedict lucero	edward be like "i can't fight this feeling any longer"..
Jorma Jeffries	I like Edward when he answering question straight forward. LOve you Edward!
Fe Apduhan Lascuña	Juskooooo
wil gallego	Sanaaaaa monday na ahahaha!!! Mlapit na tlga aq nitong tsumama sa liwanag eh..
Loving hopie	Omg!!!!! I died!!! Grabeeeee!!!
MW Lifetime	Dito yata talaga tayo flyer sasama sa liwanag haha
Nhecy Sebolino	Wala ng paligoy ligoy pa...wala ng explain2x....yes kaagad.....Lord isa ako sa milyong nananalangin sau na please make this two become 1...in the right time....kc yung pagka straight forward nitong bata na to he deserved to be happy at si maymay lang ang mkakapag bigay non sa kanya....and also maymay deserved this young man,they both deserve each other...bihira sa ganitong loveteam ay may isang straight forward sumagot sa mga tanong about his private life specially when it comes to love....sa ganitong klase ng buhay meron cla bihra yung ganito na in national tv masasabi nya na kung ganu kamahal at ganu ka importante at kung panong hindi nya kaya na wala si maymay sa tabi nya in national tv....na hindi lang buong bansa ang mkakanuod kundi buong mundo....kaya my dearest edward saludo kaming lahat sayo.....salamat for always being so.proud and being so supportive to our dearest maymay.....we love you both....we're looking forward on your future together.....
Wander Mom	Yay! Kaabang-abang ang kasalan na ‘to este interview pala😂 Walay pagduha-duha, Dong Edward! Ana jud YES!” 😂👍🏼
niki niki	Gising na gising ung kaluluwa q sa YES mo edward sarap makipagsabunutan eh😂😂😂  May gugupitan q na tlga yan bohok mo halos sayad na sayad na sa lupa😍😙😂😂
yanzkie 8	That sincere look in his face when he said yes 😭😭😭 mah hart!!!
Cesar Abdurahim	Ayan tito boy sinibukan mo ang batang maylaban namin,,,mbilis pa sa alas kwatro ang pg yes n dodong😍😍😍😘😘😘❤❤❤
Mheza Tuangco	Grabe c dongzkie...wla may lipod2x...😍😍😍#Mayward..abangerz ako dito...
Love Guintawan	😍😍😍mayward lng
Emma Angeles	Waaahahahhaha. Bushak
NAnakim S	Kailangan kona yata itali sarili diko kakayanin to ano to yess na agad agad sagot ni dong
Beverlina Payot	OMG! Nawala ang antok ko sa iyo Eduardo!!!!Mahal ko kayo ni Maymay!wishing for habangbuhay  sa inyong dalawa,at magkaroon ako ng 50 sharks na apo 😂😂😂
Marianne De Silva	OMG..kasalan na INSHAALLAH.
scorpio knights	Waaahhhhhhh pede last night of da world nah ..hahahahahahahahaah
Nora Kudarat	My Goodness's Edong tinapos muna ang laban  Tsuma Mr and Mr's Barber .soon  flyer's may baby JohnDale Barber na tayo Wedding💒👰🤵 💐💏🤰👪👩‍👩‍👧‍👧💞💞💞💞
maldita ko paki mo	Wait lmg muna hihinga muna ako be hahaha kilig josko😘
Larina Dana	OMG  dodong Edward. Ikaw na talaga. MayWard HABAMBUHAY na🙏🙏🙏
Tetchie Baculinao	waaaaaaaaaaahhhhhh OMGGGGGGGGG
Ednalyn Valmoria	Yes💖💖💖mayward
Tessa Mae Equiza	Oeemgee!! Excited na ako. Kelan ba to. Huhu
Suzy Sali	Wow yan gusto qu c edward nasa boy abunda kc totoo tlga sya
Aree Ell	Ai so excited to see the whole interview of you ed!
soledad manalo	Napansin ko dati  Edward didn’t wearing necklace but since last chill out laging May necklace ng suot si Edward napansin ko lang kanino kaya galing iyong necklace.
PangiT Kaedz	Wow....kakakilig
Raynie Mapanton	Ayyyy 😂😂😂😂😍😍😍😍😍💞
mheding mhedz	You are the very gentleman EJ😇great to hear from you👫.. I can't wait on Monday..that is why Im really crazy about MAYWARD because of the honesty and straightforward.. Unnie saranghae to both of you..ALLAH bless, amin
Lynne Delarosa	Ay grabiiiiiiiiii nabingi ako sa sariling tiliiiiii ko😄😄😄❤❤❤❤❤
Kat Pelino	Pogi ni edward. Go Mayward conquer the world.. Hehehehehehe. Kinilig ako bigla. Kakaloka
Mitchiah Hayati	Ohhhlala.....big YES!!!!..
Grace Paciano	Patay na mga isda nito hahaha
Ge 4214	Grabe  bigla  antok nawala just watch 4: 16am💕
viv فلليني	zna lunes na
Elsie Idong	Hala! mabuang najud ko nimo dodong...juskolord maminyo jud ka ug sayo dong.#MAYWARD FOR A LIFETIME NA TALAGA....❤❤❤😍😍😍
senyora dale	Ayun nanamn yung YES tangyna edward gusto ko pang mabuhay wag mong madaliin buhay ko 😂
sailor moon	Atapang  na bta nkalaklak ng lipovitan😂
Calista Rey	Atapang atao din talaga tong Dodong ni Maymay eh. Hahaha😍😁
siNgLe*stAr_ MW	Hoyy!!! Help omg npakabilis na yes..
Jet Gardon	The great imitator of maymay: EDWARD BARBER EVERYONE!!!! Hahaha why so cuteee???!! 😘😍
shane aivie	WALANG PALIGOYLIGOY , DI MAN LANG NAG-ISIP ITS A BIG `YES' AGAD² .. UWIAN NA MAY NANALO NA SA PUSO NI DODONG 😭😭
Nhorain Lovecutiepie	Ayaw kna bess tinapos na nya lahat wawa nman ako.umaasa pa buusshak ka dong hindi ko alam san ntapon un hwak hawak kng panty
Rona Carandang	Grabe sa kilig to ❤❤❤
cassey c	OMG OMG OMG,. liwanag wag mo muna ako kunin gusto ko pa mkita na ikasal ang MW...haha,muntik n ako mahulog s higaan q s kilig nung nag YES si ED..
nathalie cruz	super cute mo edward.gayang gaya mo talaga si maymay😍😍😍
Dauntless	Thank goodness!!! Yes tlga???? Agad agad???? Wala na !!! Finish na!!!!😍😍😍😍😍😍😍😍😍😍😍😍😍😍 LoveU #MayWard and Thanks Tito Boy. Sana nxtym 2 cla ng future wife MM nya ang guest. Looking forward to that Tito Boy PLEASE!!!!😘😘😘
nor reen	Bushak n
thelme	Grabeee kayo mambitin TWBA ha, tagal pa ng Lunes eh
Daisy Endaya	OMG!😍 Edward “YES” for Maymay!👰🏻❤️🤵 ❤️❤️❤️❤️
Nyl Samson	Omg.. ngayon plang kinikilig nkou.😍😍
maywardlover MW	First interview, gusto mo ba so Maymay? A. Yes 2nd interview, ano ang relation ninyo ninyo n Maymay? A. Best bestiest friend 3rd interview, anong level Na ang friendship nyong dalawa? A. Road to a soulmate 4rth interview, (now) would you marry Maymay?. A. Yes..  Me next question saan kayo gusto tumira after kasal nyo😂😂😂😂 advance ako mag isip...❤❤❤
Maria Sanchez	Susme mahabaging langit matutulog na sana ko kaso napanood ko pa to pa to pano pa ko makakatulog nito hahahaha Ay grabe ung last na tanong walang pakundangan YES kagad ang sagot ni EDWARD BARBER
Jaypee Peralta	ang ganda ng pag kakayes nya.
Mine Ganda	Patay k dong ky maymay hahaha
Beverly Prado	Klngan ko na po ng ambulansya, pllllllssssssss, sugod nyo na ako sa ospital, inatake na po ako sa puso sa banat ni MayWard😍😍😍😍😍😍😍😍😍😍
YahRu Moi	Tongueeeeeee inuuuuuuh waaaaaaaaaah .... maywaaaaaaard 😭😭😭😭❤️
Kathy Palma	Nahhh❤💚💙💗💖💕
jenn berna	Waaaaaaaaahhhh waaaaaaaaahhhh kunin mo na ko Lord
sheng shayne	I really admired your honesty and being straight forward edong😍😊 Cant wait to watch it😗😊 #maywardforeverFan! #twbawithbebedodongEdward😍😘 Loveyou #mayward! God Bless always🙏
janna jamma	Matutulog n sana ako kc sakit ng ulo ko pero natawa ako kay ed pero mas malala pala sa huli  duper kilig huhu pano n ako matutulog ngyon
Hey shey Bliss	OMG Ayan na walang preno yan si Edward gooo Edward ❤️❤️❤️❤️ uwe na kayo ng Germany ni MayMay  #MayWard
Maithz Siba	wowwww Edward yes agad. .. masaya kaming mga mayward fans kong kayo magkatuluyan pagdating ng tamang panahon.. congrats sa movie ng FIRST LOVE..congrats Edward subrang proud kami sayo...
romina matias	Nasagot na ang dapat masagot. Watch din natin para clear na clear sa mga nag-doubt. Excited for this episode. iWantv nga lang ang peg ko because of work.
Nene Traya	Kilig
Sam R	Nagpapaniwala naman kayo.. halata namang friends lang ee
FirstOoo Abas	Wahahaha ako lng ba ang paulit ulit teaser palang yan.adik lng s mayward
babyluz france	Grabe ka Edward biglang lumabas Ang puso ko akala ko di ko na maibabalik Kalokang Bata Ito napakaprangka si Tito boy d kinaya
rouda #mayward	I love you mayward😭❤😘
Anne Kuehnel	Grabe ang YES nia, walang patumpik tumpik... kiliggggg
Angelyn Cena	Hahaha musitt sabado pa bukas mga bakz..mgtitiis tau nitong mghintay ng lunes😂
OmgThomas	Malapit na ang Kasal.😄😄😄❤❤❤
Mavic Grundy	Yes jd oi hahaha inlab na na inlab c dodong
Rizza Valdez	Mayward habangbuhay
Stacy Valleser	Hellloooo mga pans...hahahaha....fiesta mga flyerssss...yung mga hiatus welcome back...hahaha❤❤❤❤
Robelyn Tercio	tinapos na...
Rocel Restoso	Ano bayan dodong patulog na ang diwa ko eh,ginising mo pa,maaga pa pasok ko bukas,bat ganon tito boy haha
Ja Ja	Homaygad! May Yes na !😭😭😭😭 can't wait na tawagin na kayong Mr&Mrs Barber! 😭😭😭😭
mylene francisco	Monday na pls huhuhuhu excited na
nylecoj aicrag	Hahaha diosko edward patulog na ako pero nong nakito koto dinaako makatulog gusto kona monday na bukas.waaaa...diretsahang sagot yessss talaga.
Elle Galvez	OMGGGGGG!!! MY MAYWARD HEAAART!! HUHUHU
Joyce legs	Nasamot na ka kilig to the bones. Lapus asa taman lapus.haha that's what I like most of edward. He's so straight to the point.
Naishah Nanding	Juskulord ...as in no dull moment napasigaw talaga ako..😍😘❤
Letecia Cervantes	Para ako baliw na sumigaw ..animels is Edward. Pakasalan mona yan .😍😍😍
Pearljoy Acosta	Waaahhh bushakkk Tito boy pa bitin man oi... Ajajajaja kilig overload bai... Lab u edong love you mayward habang buhay
Safah yusop	Pwede lunes na bukas excited lang,   kong maka yes naman c dodong parang my aagaw ng sagot nya hehe love you MayWard😍😍😍
Raida Abpet	wahhhh papi gusto q tumalon ag bilis mg yesss love love ur so pogi.. #mayward love wins
Merijoy Hizon	Omg Edward
mary ann najjar	My MayWard heart😍😍😍
elsie gamurot	Monday n sana hehe dna ako makapaghintay
najib khan	Litse tgal ng monday hahaha basagan n ng mukha to charet 🤣😂❤❤❤
Annabelle Nudalo	Ang lutong ng YES!! Jusko po!!! Akoy kinakabahan kaabang abang po ito!!😍😍😍😍
Bliss	HOTAENA!!!!sandali hindi ko kinakaya!!!!okay I just died..this is her soul typing!!!
Janet Anasco	BUSHAKKKK 😍😍😍😍😍😍😍😍😍
little pony_ kathleen avery	Advance Happy Birthday Tito Boy 🤩😘🎉
Marissa Biando	teka. monday na po bukas. ready na kau.   busak. busak..
Xyrhen Balaba	Wahhhh can't wait...klan ang airing nito?..
Lyn Salinas	Ang bilis ng "YES" 😭😭 naiyak ako Sa tuwa 😍😍😍😍😍😍😍
agnes aton	Ambot nlng jud nemo Dong😍 ayaw kanunaya Dong ha kay basin mental ahong hugpaan ane ba😂😂😂bsta i love you both😍kamo duha ni '' tsuma''nemo💑🙏❤
Marivic Mina	Bushakkk. Yes talaga. Ayieee
Gina0408 Maglangit	Omg! Yong pa yes ni Edong excited na...❤❤❤
Sanah Angni	OMG2x..TSUMI..dko kinaya Big Yes Ni Dodong.. thank you for this teaser can't wait on Monday.. Yahoo 🙏❤️❤️❤️
chloe Posada	Hahhahahha bushak na jusko po
Wennie Tesing	Whoah!!excited na mg monday
hubby al mine	omgeeee!waaaah puso q edwardo hahaha wla na tapos na mga isda hahahha!labyu mayward😍😍😍😍❤️❤️❤️❤️
Bhingz Datukali	D aq mkhingga
love yourself	Bushak!!!!!! nagawa ko yung face reaction na ganun edward sa last part wahahaahhahaja
Lhian jean Belotindos	woah!! exciting talaga to
malditang mabait	Team real #MAYWARD❤❤❤
Zaida Yanon	Tataya tlaga ako sa Edward nato eh ksu paanu ako tataya eh ito pa lang ikamatay kona God pkakasalan na niya tlaga😘😘😘
yamyam dodong	Wt....oh my godd...!! 😣😣 i cant BREATH...😆😆 oh my god!oh my god!oh my god!! Maluluka akoooo....
Roselyn Palma	Oh edward sana nga mgpakasal n kayo..z😍
Mary Ann Sibara0507	Paano makakaahon sa inyong dalawa???
Robelyn Diesta	Yes ako hilayin naten Ang Monday..,😍😍😍
sally parcon	omg omg😱😱😱😭😭😭😭 ang puso ko nabigla ako sa sagot ni Edward.walang preno ang sagot mo dodong parang takihin ako sa puso. bushak bitin abangan ko to sa monday  huhuhuhu.love u maymay and edward always take care each other and god bless you both😘😍😍😍
mhine mhine	I kennat kailan ipplabaz ito cant wait na sa tfc hahahaha
Jean Abejar	OMG!!!!!!!
Yahwee SY	Woahh!!! Would you marry Maymay ? Yes agad agad
Almera Lee	Grabe bai yess tlga ed love you subra ..🤣parang ako yong jowa e😂🤣😂..sorry pala kc ayaw nya ng EDWARD gusto nya mayward😍🤔
AEM ZUL	Waaaaaahhhh lulutang aq s tfc pg ma air na ahahahaha...😘😘😘
Mama G	oh my gulay!!! sana Oct 22 na!
Joan Reben	DQ kaya to waiiiiiiitttttttt tagal mag monday😢😢😢😢😲😲😲😲😲
Marecoon M	Ito yon ehh.ito yon ehh.bushak edwardo pinatay muna kmi.hindi na kmi mkapaghintay ng lunes..panalong panalo na talaga..wlang hopia mga bai.simbahan na dretso.mayward habangbuhay..naloloka ako s sagot s last ehh.
diamond 29	yoko.naaaaaaaaa
bern mayward	Grave siya can't wait
Lovely Han	Waaaahhhhhh ung kilig ko grbe oi c dodong oi atapang na tao tlga grbe Lang Ang gwpo as in
maria cecelia natalia	huyyy maymay c edward pigilan mo..batang to nakowww
Armando Arca Jr	Nagising kaluluwa ko nawala antok ko. My goodnesss tapos na ang laban... Uwi kana bes la kana pag asa.  I really like your being straight forward edward...
Maryann Delorino	O.M.G edward🙌
crissey selian	Nabuang na
Yesha Matao	Aaaaayeeeeèeeeee .... my godddddd uli nkog pinas oii .mayward make me supa kilig talaga gosh lòrd i can't breath hahahahaha God's well kayo din hanggang end of the word😍😍😍❤❤❤🔥🔥🔥
rea joy namocatcat	OMG...  ano to?.... hahaha... #MyMayWardHeart
Michelle Gutierrez	Jusko nawindang ako sa sagot nya sa huli love you edward
Gym Stein	hhha kuhakuha tlga nta tipz n.mm hhhha
Marisa Busalla	Omg kasalan na to❤️❤️❤️
Evergen Dagoc	Bushaak ka dodong
Nhorsky Medavz	Bushak bushak grabe bai Sabog na sabog na ako sa kilig
رونيدا فلبين	Abangan  na lng natin yan sa simbahan  tlga ang uwe ng mayward  na yan 😍😍😍😍💑👫
Alma Alma	Omg I can't wait na...
Omin Amerol	Aabangan ko tlga yan..
Namrailyn Kadil	Omg I can't wait🙈🙈🙈😍😍😍😍😂😂
Max and Daisy	Daisy: BAD ANSWEEEEEEEERRRRRRS!!!!
nenen sales	OMGGGG!!!! 😱😍😍😍😍
