jaun ajram	3 idiots
Ijaz Butt	U R gr8 man's
Ashraf Zaman	ذرا مولانا صاب کا اس سیناریو میں کردار ملا حظہ کریں۔ چوروں کے درمیان گٹھ جوڑ کرنے کی ڈیوٹی کررہاھے۔ اسکو اتنی شرم نہی آتی کہ خود کومولانا کہنے والے کو ایسی ذلیل حرکت کیا زیب دیتی ھے؟ پاکستانی عوام ذرا ھوش میں رھیں ۔ ریشہ دوانیاں شروع ھونے لگی ھے۔
Tanveer Ahmed	Hmari awam KI ankhe kholne K liye kafi he jab pakre Jane ka waqat Ata he ye rona dona shro kr dete he
Maria Khan	yha hukumat gerana  itna Asan h bs voting Dalo or  gerao  Mgr chor ko pakr k saza Dena itna mushkal h AK chor ko thora torchar kro to wo sach boldeta h Mgr yha to sabot hi pory nh hoty
MsSahil92	وہ ناسور اب ان کے لیے موٹا تازہ سور بن چکا ہے اور سور زرداری کی پسندیدہ ڈش ہے
suhail akbar	Brghairti ka doosra naam, ZARDARI ,BILAWAL & S HAREEFS
Dr Samina Yasin Shaikh	True spirit BC Sabir Shakir, well done others.
ali imran	Salay kuttay zardari ne pee hui hai Is pe media kyun nahi bolta
Ashly Chauhan	Rizwan rightly said....people please whoever you are ...regardless of the faith and religion....please wake up before we all are reduced to invisible particles on the geographical map...please ...dont listen to these....nibblers....they both are ...look at these what they have done and what their qualifications were...whatever IK is , can a single person stand like him at the  time extreme dilemma? can one person? no doubt the team is there to assist him , yet there needed one man lead them all..and IK is here who was called by bloody....that he is this and that and play boy! He was a boy , therefore he could play and it needs guts to play....the ones who dont even have ball...ss to play...
Arshad Hamid	PPP PMLN is a group of choors and money laundrers and killers and gaddars.All must  hang.
taswar iqbal	نون لیگ پیپلزپارٹی اور ڈیزل پارٹی یہ سب ملک کے غدار اور چور ہیں  اپنی چوریاں چھپانے کے لئے گٹھے ہو رہے ہیں اللہ  ان کی نسلوں کو تباہ  کرے  آمین پاکستان زندہ باد عمران خان زندہ باد ❤❤❤
m. akram	Allah pak Pakistan k dusmenu ko tabah kary Ameen
Yabaqi Yabaqi	Saheb bachakar Saheb Meri ungli Civil Hospital doctors na hone ki wajah se ek imported ki wajah se tut gayi hai Imran Khan ko batao
Advocate. S.S.H Rizvi.	Shah shaib Because Fasil Raza Abdi still in jailed shamed Alls political parties choor carpet bad Laws justice system PPP and other's PMLN choor carpet bad news 📰 shamed 😪 😷
Irfan Ghulam Nabi	گلی کے لنگڑے کتے صرف بھونکنے کیلئے نیازی کا لنگڑا کتا ہیلی کاپٹر مٰیں
Babar Hussain	ان غدار کو پهاسی ہنوہی چاہیے
Sadiq-ul-Islam zunnoon	The players on the Chess Board fight with each other violently but when game is over they embrace with each other with all comfort at the same Board so Political Chess Board is the same.
RED ON YELLOW	ZARDARI THO NAWAZ SAY BARA CHOR NIKLA , YAAR LOG AB BI INKAY LIYE LARNAY MARNAY KO TAYAR HAIN,AFSOS HOTA HAY.
Munawar Mazari	Nice opinion
malik shahzad Latif	مجھے فخر ھے اپنے سچے اور کھرے عظیم قائد عمران خان صاحب پر
sohail Ansari	your program  is so good sir.
ghulam akbar	chief justice saqib nisar ka time 2 saal or bara dena zaroori hai  naya judge jo bhi ay ga pata nahi wo kaisa ho or saqib nisar ny jo case start kiye hai acha ho ga agr un ka faisla bhi wo hi kr k jay
Amtul Shafi	insha'Allah Imran khan ya Pakistan ko Kuch Nahi ho ga
rana mudassar	Kaha tha na rolano GA ab Rona in ka muqadar ha chooron ka. Imran khan zindabad
Farzana Rahman	Shahid please  tell about trouser off at American  airport,hahaha 😄😄😄😄😃😃😃
Farida Khajawall	Aur tu gareebon ka masiah hai.Tum tu sab say ziada gunda aur napak insaan hai.
Shoib Malik	لیڈر آف پاکستان عمران خان صاحب نے سب کو ننگا کردیا۔۔۔💪💪💪
fahid sultan	زبردست پروگرام سر ۔  Welldon sir .
majboor Khan	Jab ye program dikta ho tu rona ata hai
muhammad tuqeer	Pti zindabad
Jan Mauz	Salam  Tu Shahin hai ,,,, Afg ki nazar se  Tohri twaja chahtahon Aap chor sepahi kelo ge udhar  Sarhad pe tufan hai , Kaptan Khan ko tanha nakaro 1nazar Sarhad paar Racko , Ham ko apas me larraya ab Aap se ham ko larwayega
Vickey Bhatti	ye u turn nahi
Danny Boy	Imran Khan the hero of east & west should very quickly crush these lannatti makroo munafikeens animals like Nawaz Sharif shahbaz Sharif asif Zardari all soor si aulads plus there makroo lannatti families supporters affilieats & followers on a fast pace. Task force should very quickly recover all the en-looted money wealth from these lannatti makroo animals munafikeens traitors ghaddars of state of Pakistan above.
princess zoni	Ab bhe waqt hy pakistani awam jag jao khudaya ....ALLAH ki khas rahmat ai hy imran khan k shakl me ..is moka ko zaya na kro khaudara zardari nawaz mafad parst haine
Farooq Khan	Zardari chore imran Khan sahib  banzir income support program bi band karna chyaya ismy bi cruption Hy
rebhos1	All of us Know these MF Shariff and MF Zatdari are thieves but greater MFs are the generals of the Pak Army, the CJ of the SC who allowed them to loot the country. MF Musharraf was the main guy responsible to let these MF flourish. Hope a new Martial law is there who will  and MUST "HANG"  these MF.
Kareem Khan	love u imran khan
Mohammad Afzal	Zoordari you are a mad dog of the lowest cast who barks and bites its own owner. Time has come when you will be dealt with properly. Nevermind you join another choor, but all of you have to be accounted for and this will be done soon. You want and see, son of a bitch.
Fiaz Dar	These are the politicians who lik  their own spit from the floor.They are not trust worthy.
Raju Cage	Ehtesham yeh aap hath se bato he bato mein koun se simble banay Tay ho illumanati ho Kya aap ya pher free manson ho dajjali simble banay Tay ho aap aksar mein note karta Hun aapko
naz khan	Allah Pak nawaz sarif ko gark kary  jis ny mamtaz qadri ko pansi di insahAllah is ko saza milay gi
Aftab Ahmed Malik	Great program, even my small kids like it's complete proceedings. Bravo boys
Farozan Bokhari	Anchors of the reporters .... why don’t you help IK n cm buzdar...  by compiling lists of honest bureaucrats n give to them !!! I love this program, but its beyond my comprehension.... why can’t u guyz help this made in Pakistan government! We only watch ur show n dr. Shahid Masood / coz u talk honestly.... plz help the govt. off the show also .... thnx a ton / if I was there I would definitely do it .
Ahsanali764 Ali	شاہ زین صاحب سب سیاست دانوں کا باپ ہے فضل الرحمان
Shazia Tabassum	تخت رائے ونڈ کو ہلائیں گے   اور پھر  اسک نیچے چھپ جائیں گے  لوگوں کو گھمائیں گے      اور پھر  چپکے سے نکل جائیں گے😂😂😂😂😂😂
Yfgjd Yghjje	Nice  porogaram
Waseem Ashraf	Sir Barister Ehtsham Ud Din i have been watching your show since long time it's a very brilliant show, you peoples are giving brilliant knowledge to our young generation and making them literate regarding conspiracies against our country it's a great effort that you peoples are doing now our young generation has woken up ,in the elections of 2013  this young generation was kid and now they have become literate and they know who is corrupt and who is better for our country and we have only one choice none other then the great Imran khan i will just request to our young generation please please give him atleast 5 years then we will see that what he has done for Pakistani nation and in Shah Allah he will do this please please give him time, if we can tolerate Nawaz Lal Nehru and Mr 10% corruption for 30 years and we can imagine that how they have  looted this country shame on them ,these looters have forgotten about day of judgement where they will have to answer about there work , that they have done for there nation , they have done nothing they are just trying to save there corruption and there corrupt mafia,s but In Shah Allah this time they won't be successful i will request one more thing to our young generation that please please prey for Imran khan,s long life in every Namaz and I will request one thing to Barister Ehtsham Ud Din please please telecast this show atleast 5 days in a week , many regards Waseem Ashraf
Akhtar Ghumman	Sabir shaker saab you very slow in these days no give any special new where are you
Ayaaz Auras	زرداری صاحب کوئی شرم ہوتی ہے کوئی حیا ہوتی ہے
HAFEE good Nice song	Lanat Lanat Lanat Zardari
Abdul Wahid	25 تاریخ کو ڈی جی آئی ایس آئی تبدیل ہوگا اور نئی ڈی جی آئی ایس آئی ایک ایماندار انسان ہیں انشاءاللہ یہ چور ناکام رہے گے
Sarwar Khan	Tumhare khan Kia kahta tha phir sub Chor age peeche Hain
Amir Cheema	Arif bhatti sab .sabeir shakeir sab .ehtisham sam good  Pm sab abi ien churo ko chuorny waly nahi ha g inshallah g
Bashir Zaman	Inshallah choron k acche din chale gai aur ab in ka ihtisaab Khan sahaab karega
Anwarulhaq Khan	👍
Abid Khattak kenty ka mely ga	Khan zinda abad
Mohammad Ahmad	Zardari or shareef ko pura zoor laga dena chahye kyunki pakistan abhi ventilator pe thoda zor laga den to zarur kamyab honge.........
S & S Vines	We wish nab and pti walay bhi ye program dekha karain ...#hire them
Mirza Ateeque	چوروں کو فورا" سزا دی جائے عبرت کا نشان بنایا جائے اور بجلی چوروں کو بھی سزا دی جائے کہ آئندہ بجلی چوری کے لئے کنڈا نہ لگائے بجلی چور تو خود واپڈا کے لائن مین ھیں
rokhan shah	In 2008 ppp govt dollor rate 65 rupees  after five year 2013 dollor rate increases 35 rupees and reached 100 rupees.
Zeus7777 Appolon7777	WHY NAB HAS STILL NOT FILLED THE APPLICATION AGAINST THE LAHORE HIGHCOURT DECISION OF NAWAZ GANJA BAIL
Hashim Ali	🌹😍😘☕🌹😍😘☕🌹😍😘☕
sabghatullah kakar	Ye sb mill k b khan ka ball bika ni krskta ab wo time chala gaya....
Zuhaib Pitafi	Imran khan zinda bad aj akela waqat k feraono k sath akela muqabla kr raha hi
Umar Afridi	Imran khan ❤❤❤☺😘
Shakirullah Khan	آج آپ نے  ما شاءالللہَ اچھا  پرو گر ا م کیا  بھٹی صاحب بھی کھل کے بو لے  اور صا بر شاکر  بھی ماشاءالللہَ لیکن کا فی پیسہ نکل گیا ملک سے ،تو ھے کو ی جو رو کسکے
Muhammad Adnan	As vatan mn kuch be ho sKta ha
Saqib Dilawar	میڈیا کیوں ایسے چوروں کو بار بار دیکھا رہا ہے
Fakhar Abbas	Very nice
Kulsoom Hussain	Yeh dakow Imran Khan ka akaily kuch nahi begar sakhty haa app jaisy media mafia ka sath daity jiss tarah shoro din sy tum pti ky pechy pary too mojhy yaqeen hy IK khod  Assembly toor daingy too pehar media mafia samait sary dakow ka woh woh by lag ihtesab hoga keh yeh lifafy or dollars app sy ultya karwa kar nikilwaya jaya jega.
chick chick	Bhatti sahub Zindabaad!
Asghar Ali	zardari NWA's bai bai
Raja Asad Saghir	Imran awam. Ko sachai bta raha hai k mulk kaisy chalta hai.. Metro 🚇 bnao awam. Say 20 lo or bqi imf say asian development bank yah world bank say loan lo yah kise department ka budget dosry main dalo or awam ko phudo laga k govt karo. Os k badh 5 yrs k badh rona shuru kar do
mushtaq butt	خورشید شاہ کی شکل پر ہر روز اللہ تعالی کی لعنت نظر آنا شروع ہو گی ہے اور مزید بڑتی نظر آ رہی ہے
Aamir Iqbal	یار تنگ آ کر بات کر رہا ہوں ویسے میں ایسی باتیں کرتا نہیںہوں تم جیسے گھٹیا اور بےہودہ اور بے غیرت چینل اور اینکر نہیں دیکھے اور  یہ عارف بھٹی صابر شا کر عمران خان جیسے کنجر کی دلالی ایسے کرتے ہیں جیسے اپنی بہنوں کے یار یا اپنی بیٹیوں کے خصم کی بات کر رہے ہو  لعنت تم جیسے دلوں اور کنجرون پر.
ZAHID KHAN	عمران خان زندباد
A G Sayyal	کاش ایسے  لیڈر  چائنہ  میں  پکڑے  جاتے ۔
Rizwan Ahmad	Plz donate for dams thx
Shahzad Ali	چور نواز شریف چور زرداری اور چوروں کا جیو ٹی وی  پر جوتے مارے جائیں
Imran Wiseem	Randi aurat.apni chori bachane k liye sab choor akhte ho rhe hain.lakin in ko yeh pta nahi ha in k samne imran khan ha jis ny agge barna he seekha ha...
Rao Shahid Muzammil	Haqeeqat TV well done 👍 👍 👍
Naila Zafar	Because of Ehtasham     Don’t want to watch this programme any more  I was a regular watcher of this program   Sad.   Can’t stand mr ehtesham
Kiffal Kiffal	zardare dako ha allah pak zaror es hrame ko ibrat ka nashan bnaya ga
Babar Babar	Bati Saab ap ko ktny passy dya p  t I na
Faisal Hussain	Love Imran khan
Nazir Khan	Bhatti Sahib, in next few days many Chores are going to be arrested so they will have no time to buy votes
Miruna Levarda	In Sha Allah in ko Mun ki khani pare gi  Jis ke saath Allah ho us ka koi kuch nahi bigar sakta
Shekh Khalid	News waloo siraf aag lagao
Din Afzal	سناہے قومی مجرم ایک بار پھر اکٹھے ہورہا ہے خکومت کے خلاف
Zahida Parveen	Prime minister Imran Khan is the best.
Ali rizwan	jago Pakistaniyo ab n samjo gy tu kabi n ye nawz ghardari bhai bhai
Shah Gul	کتنا افسوس کا مقام ہے کہ یہ کرپٹ سیاست دان  کتنی دلیری سے جھوٹ بولتے ھیں  شرم ان لوگوں کو بلکل نہیں  آتی ہے کبھی کچھ کہتے ہیں  کبھی کچھ ھم عوام کو عقل کے ناخن لینے چاہیے ھم لوگوں کو ایسے دوغلے سیاست دانوں کو ووٹ نھیں دینا چاہیے جو ھمارے ساتھ دھوکہ  کرتے ھیں ۔بھٹی صاحب بیرسٹر احتشام اور صابر شاکر ھم آپ کے شکر گزار ہیں جو اپ عام پاکستان  کے عوام کی آواز اٹھاتے ہیں
junaid warich	عمران خان زندہ باد پاکستان زندہ باد پاک فوج زندہ باد
Akbar Pti	Arif bahti is not good man
M Ishfaq M Ishfaq	Imran Khan shab please inlogun ko chorna Ni please Ni to hum apko maf ni karen gen
Mjavead Iqbal	ان بھیڑوں کے ہاتھ میں ابھی کوئی شکار نہیں آنے والا بھت ہوگیا بہت لوٹ لیا آپ نے اصل میں یہ سب بیڑیاں اس لیے فکرمند ہوگئے ہیں کہ جو انھوں نے مال پچھلے سالوں میں بنایا ہے اس کی آب پرسش ہوگی اس لئے ان کو ابھی تکلیف ہوگی ان کو جیل کی سلاخیں قریب نظر آرہی ہیں
safeey awan	ایک ہی حل پھانسی بس
Ahmed Salama	Double faced traitors. They think Pakistan is their property.Allah's mills grind slowly but surely.
N. K. Khan	Mujhayy yehh game abb kucch kucch sammajhh aaa rahhii hayy..!! Wohh yehh k mulllkk k karrtta dharrtta’on ne plan yehh bannayya ho gaa k Imran Khan ko iqqttaddaarr de karr burrree tarrahh naakkaam karr diyya jayye..!!  Kiyya Pakistan k awwaam ko nazzarr nahhi aaa rahha k Kappttaan ko kisss tarrah musshkillaatt se guzzarr’na parrr rahha hayyy..??  Aajj takk aisssa nahhii huwwa k mullk ka Prime Minister yeh kehhtta huwwa nazzarr aaye k Police aurr bureacracy mujhhayy kaaam nahi karrnnayy de rahhii..??  Pakistan kkii awwaam ko bayywaqooff bannayya ja rahha hayy yehh kahh karr k mullk ka khaazzaanna ko loooottnnay waallayy corrupt politicians k khillaaff kaarrawwayyee ho rahhii hayy aurr unnse looottee huee daullatt waappass le karr unnkka political career hummesha k liyye khattam kr dya jaye ga..!!  Mujhayy tohh greater plan yehh lagg rahha hayy k Kappttaan ko iqqttaddaarr de karr aurr usssayy her front pr burree tarrah naakkaam karr k yehh saabbitt kiyya jaa sakkkayy k hukkoommattiii muaamllaatt challaanna Imran Khan k basss kkii baaatt nahi..!!  Basss phirrr siyyassii career unn luttaerron aurr chaurron ka nahi ball’k Kappttaan ka khattam karr diyya jaye ga..!!  Phirr awwaam me yehh mashhooorr ho jaye gaa k Imran Khan ko awwaam k kehhnayy pr moqqa diyya gayya lekkin Imran Khan ne siyyassatt ko cricket ka ground samjhha iss liyye naakkaam ho gayyya..!!  Bhaiyyyo.. Mullkk aissayy hhii challlayy gaa aurr abb unnhhii luttaerron aurr chaurron kkii aullaaddon k zarriayye mullkk ko challayya jaye gaa.!!  Pehhllayy Marriyyam aye gee aurr phirr Bilawal.. Phirr Marriyyam aur phirr Bilawal.. phirr inn donnon kkii aullaaden hum pr hukkoomatf karren gee..!!  Duaa karren k me jo kucch socch rahha hooon wohh billkulll ghallatt saabbitt ho jaye..!! ( Aameen )               🤲🤲🕋🕌🤲🤲  Pakistan Zindabad.!! 👍🏻🇵🇰👍🏻
FATA PuKHT00N	زرداری  نواز  بھائی  بھائی 😬😲  مریم  نواز  کا  نیا  نعرا
Shahid Khan Khan	اللہ‎ کے لیے ان کرپٹ لوگو کو الٹا لٹکا دو عمران خان اللہ‎ نے موقع دیا ہے آپ کو ۔
Osaimi Shafqat	I love pti
Pyarali Khoja	If PPP AND PMLN ARE PLANNING DIRTY GAMES AGAINST PTI AND REMOVE THEM POWER THEN ARMY MUST COMI IN AND TAKE OVER
Raheel Ch	wasay ye bt kro tu sb  e chor hain sb syasi log apnay faiday dakhty wo ppp hu pml n hu pti hu mqm hu jui hu anp hu 😅😅😅
abdulhameed khan	پاکستان میں کرپشن کا نام جمہوریت ھے اور اس جمہوریت کو سارے کرپٹ لوگ ھی سپورٹ کرتے ہیں اور اب یہ نظام اپنے آخری سانس لے رہا ہے
Sohrab Khan	Ye batin.sirf ap.jasy or.hum.jasy logo ko.samaj.aty hay or patwariu or jialu or zebru ki.logo ko samaj.nai.arahi ye bigyrat logo nai mulk ko lutta en.kuttu ko ulta latkana.chaye or kutty.ki.muat marna chaye en.bigyrat logo ko
Azmat Hussain	Ehtesham bhai hakumat chal sakti hy or chaly gi InshaAllha ppp or pmln Waly isliya mil rahy hen kion k apny aap ko bcha saken hamen imran Khan py 1000% trust or yakeen hy ham khan sahib ko 5 sall apna PM dekhna cahty hen Allha unko sehat tandrusti dy Ameen
M Younas	نون لیگ ایک ناہل لیگ اور چور لیگ ھے پیپلز پارٹی ایک پلیت پارتی بن کر رہ گئی ھے  اور فضل شیطان کی جنس ھے مکار اور غدار ھے اور ان تینوں سے بڑے بے غیرت وہ لوگ ہیں جو بڑے بڑے عہدوں پر بیٹھے ہوئے ہیں اگر یہ آفسر شاہی اپنے باپ کی اولاد ہوتے تو پاکستان کا یہ حال نہ ہوتا لیکن ناامیدی گناہ ھے اور ہم نہ امید نہیں اللہ سبحانہ وتعالی کی لاٹھی بے آواز ہے اور میں دعا کرتا ہوں اے رب العالمین ان ظالموں پر اپنی پکڑ مضبوط کر اور غریبوں پر اپنا رحم فرما آمین یارب العالمین
Mohammad Yousuf	چورمچائے شور
atique ur rehman baig mirza	Allaha nay in ko apni akhirt or logo ki  duniya savrny ka moga dia,magr in ke tarjehat kuch or thee.
sajjad Baga	سیدھ میں پیپلزپارٹی نے پھچلے 40 سال میں کیا لن کیا
LD TEK	Khursheed sahib if pti made next 5 years then pti will go to inner sindh and Imran can show them what he did for pakistan .then ppp will loose all the seats in sindh maybe few seat they keep.imran khan not a dishonest person and he have feeling for his nation And InshaAllah he will produce what he is saying he is not a business men neither need millions of dollars for him self .it's only 60 days 2months u can cry and try to put them under pressure basically don't take action on corruption. But Imran khan. Will not compromise he need to clear  corruption from the country. If they give hard time then Imran khan give it to army to take over and finish corrupted people's
Zaki Khan	عمران خان ھمارا لیڈر ھے اس کو تمام پاکستانیوں نے ووٹ دیا ھے اور اب ھم 2 سال کا وقت بھی دیتے ھیں ۔
Umar Siddique	Ya ye mulk bachy ga, ya ye chor bachy gy.Yad hai na PM ki bat. Or InshaaAllah ye mulk bachy ga.
Javed malik iqbal	Good Bhatti sb
Azhar	Let's have referdam on nawaz zardari to hang them they are certified beqarats and thevies
nuzhat jehan	They both wants to loted Pakistan money.
Shawn Ali	Great info!  Bhati sahib you’re great!
Mubashar Iqbal	PTI aur Imran Khan ko wqat dain plz 35saal ka hasb ley rehy hain
Masood Ahmed	Agr inngon ne koe ghalat harkat ki to yeh dabadgose ho jaen ge
best videos	Pakistan Kay log dua  dainge AGR in corrupt logo say Jan chot  jaye to
Abu Hamash	حميد بتى حرامى شرابى صا بر شاكر حرامى شرابى دونو حرامى شرابى
Ghulam Mustafa	Nawaz or zardari aik sekey k dow rokh hain. Kal yehi bat Imran khan k barey main nawaz shareef kehtey they. Aj to pmln's or ppp's supporters ko kuch na kuch dont mind sharn to a rahee ho ge.
storm gaming	Bhatti sb zindabad
asif Khan	I love my ledar ik
usman awan	Imran khan in choro ko ni chora ga inshaAllah
dilbaz malik	Dakoo gangs ko jub loota mal k pakra jana ka khatra ho to aik ho jata hain
Sajad Khan	Hang all the corrupt people soon please Pm khan is a grt leader
Qaiser Khan	کبھی کہتے ھیں داھندلی ہوی ھے کبھی کہتے ھیں لوگوں نے راد کیا یہ پاگل تو نہیں ھو گیے کہیں
Ismaellkhan Khan	Pakistan zindabad PTI zindabad imran khan khan zindabad NAB zindabad FIA zindabad JIT zindabad
Mian Sajid	Allah Pakistan pe rahim kryy,Ameen
zahid rafique	Pakistan Mein Naik movie wala role model chaiye
Aftab Arzo	Pak awaam intahai jahil hain jo in chooro ko vot deti hain
Jawad Ahmed	Zardsri dog Nawaz dog
Imran Ali	chlo kush sahfi to achy han
Siddique ملک	ذاتی مفادات پر زرداری اور نواز شریف  مولانا فضل الرحمن  جیسے  ناسور اندر سے  ایک ھی  ھیں .. منافقت کی .سیاست  ڈاکووں کا   مشغلہ ھے .....عوام کو  بے وقوف  بنایا  جاتا ھے. ......
Qadir Khan	Chrou ke mot Ana vali ha
Abdul Qayyum	Saray corrupt wish I can hang them khaqan abbasi who couldn't win from his own area 2 seat's and that (Nawaz Sharif Ka Nisha)and zardari  lanti munfiq
Javed Malik feroz	Good show
Avinash Kumar Avinash	Bhtti sb jardari nawaz ko ek crne valo me aap log  imran khan   adaliya Esteblisment samil hen
Niaz Muhammad	Hara kanooni nezam fail ho choka hy, jo zardar our nawaz ko 3 salo main saza na de saki
Amjid Ali	3 good man salaam 3 ko
MegaGullala	Nawaz Sharif Zinda Baad.
Asim Ali	Imran khan zindabad  p t i
Ijaz Awan	‏اگر نواز شریف، یا زرداری جیسے عظیم لیڈر چائینہ کے پاس ہوتے    تو  10 سال پہلے ہی پھانسی لگ چکے  ہوتے ...😎
Abu Bakar	Allah  inchoro  sy bachay
mario khan	عمران خان زندہ آباد ۔۔۔
Kazi Shahid	نواز شریف  منافق ہیں  زرداری  منافق  ہیں  الله  کرے  کہ  پاکستانی عوام کی  انسیے جان چھوٹ جائے
Shah zain	نوازشریف ۔ زرداری اور مولانا ڈیزل یہ لوگ ۔۔ سیاستدان تھوڑی ہیں ۔۔  یہ سب  جرائم پیشہ لوگ ہیں ۔۔۔!
Razi Sin	Zardari aur nawaz khandaan ko fori andar karo.. yeh buhat hi zalil log hai..
Haji Ajmal	دونوں چور بھای بھای ہیں
Raina Khanum	Reporters report is based on facts & honest true analysis 👍👍
Mike Waheed	aik hota hai  "Aqeeda"  aur doosra hota hai "ehtaram".... yeh eak janglee loog hai  aur janweroon ki tarah  goonda gardee  society may  maal banay kay liyaee   qatal aur maar-koot karwatay hain apnay naukeroon say...enka kisee per na tu  "aqeeda " hay aur na hi "ehtaram"....aur yeh Zardaree jaisay loog  apnay Baap say yehee seekh ker aaj  baray  "politician hain"...jo keh mera joota bhee saf kernay kay qabil nahee...
Ad Ad	عمران خان کو ٹائم دو عمران ملک بنائیگا
Rukashana Waheed	tow theaf together lakdelanet lakdelanet lakdelanet lakdelanet 👋👋👋👋👋👋👋👋👋👋fatamue lanet Lanet lakthelanet
Ali jan afridi	مجھے ان لوگوں کے عقل پر تعجب ھے جن لوگوں نے پیپلزپارٹی کو ووٹ دیا ھے سندھ کے لوگ سندھ پر قوم پرستی کو ذیادہ فوقیت دیتے ھے
Muhammad Malik	You are really Talented.
Shoaib Memon	Imran khan ne bhi to bohot sangeen ilzamat lagaye the MQM MLQ or yahan tak ke independent candidates pe to phir kiya imran khan ne zarorat ki khatir unse hath nhen milaya?  Imran khan Nawaz Sharif or Asif Zardari Subh aek cheez han
Adee Khan	PTI ZINDABAD IMRAN KHAN ZINDABAD ASAD UMAR ZINDABAD CJP ZINDABAD PAK ARMY ZINDABAD ❤️
MALIK ASIF	BEGHRAT PPP AND PMLN
Waseem Akram	Pigggg nawaz piggggg pmln
Hina Niazi	بھٹو وہاں زندہ ہے  جہاں جہالت زندہ ہے نوازشریف وہاں شیر ہے  جہاں جہالت کاڈھیر ہے ۔۔۔
Shah Zaib	Allah kry IK khamyab ho
