Trung Hoang	miền Bắc ngta gọi là viruss đag nhè
Thắng Hoang	virus cả video chỉ có vãi cả nồi :))
NNK OFFICIAL	Viruss nhìn gầy quá!
Bill :v	Đạn với nồi bay lung tung :3
Phyyy	1 mình Phương Ly ngủ chung với 5 ông....
Tung Phan	Just văn lắm =))))
News4Game	Rượu gì đây mọi người  ???
su hao	Đoạn cuối video em thays nó bình yên và dễ chiệu sao ấy
VIP Boy	4:23 Sếp Tee gắt vcl ^^
The Darkslayer	gầy thế uống nhiều vậy có ổn ko anh uống cái này nhiều ko tốt đâu a
Era Barrela	Tee say xong cute vcl 😂
community BIGO	Méo hiểu mấy ôg uống rượu gì chơi toàn ly to vậy 100% k say.hay uống sochu
Nguyễn Chí Hùng	ông vãi lắm thế :))
Duy Tan Vo	Mé, ông Tee có khi nào chấp hết Gaming House của a Rớt k ta =))
Dương Sói	Vl ông kia riệu vào lời ra sợ thật 😂
Ke Tama	Xem videi này t lại nghĩ đến một bộ phim có tên là: 2 chàng trai may mắn và cô gái ngây thơ :))))
Trưởng Nguyễn	anh viruss cả người có 5 que củi mà bắt uống như thế à
rock star	Thanh niên tee say xong lầy quá :v
Lường Đức Hải	Cho m hỏi rượu mn uống là rượu gi vậy ?
Nguyen Duy	Bá lầy 😒
Ông Nội TFT	tộii ông viruss vđ 😆😆
TomTom Tom	Thật ra uống rượu không người lái thế này gắt lắm.
༄PhÚc VăN࿐[BeN Tồ] Mobile	Tee nói như chủ video í ròi :))
lê tuyên hoàng	vui nhỉ , tự nhiên cũng muốn nhậu phát :) <3 !!!  p/s : Anh viruss gầy kinh khủng , Gym gủng đi a ơi
Sougisha 792	Tập gym cùng xeme kìa a =)))))
Tuấn Kulbill	Viruss dạo này ốm quá cố gắng ăn uống vs tập gym đi nhaa
k t	ông justatee nói nhiều vãi cả đạn
Thịnh Hoàng	Bị kích vcl
thanhsuong nguyen	a gầy quá kìa ăn uống đều độ y
Quyền cuốn	trông kiểu kia là bt rượu nhẹ tênh r
Gamer Funny	Thử thách tăng cân đi Viruss
Nguyen Trong Hau Gaming	Hóng chú Lâm bài mới 🤣
Yolo Polo	Vãi cả nồi ạ :V câu tủ khi say
Công tình Đỗ	gầy quá a ơi.. cẩn thận sk nhé
Gia Lam	giữ giọng anh ơi
Kenzo _Tiger	Bà phương ly uống rượu như uống nước thế kia😱😱
DesTroy TV	Thằng điên nói đúng rồi.. k bh đc nói share để uống nhé
an đoàn ngọc	à ông mà trong mv ấy là ông nước ngoài
Bowser Chan	Ép rượu gắt VC
Thương Nguyễn	Phương ly đâu r ??
Best Music & VSCO Formulas	. Mấy ông ôm nhau ngủ kìa :v
Duk Sun	Thích nhất lúc Justatee kêu đừng mặc cả vs khán giả
Đoàn Bá Minh	Justa Tee bửa coi không cay ko ghề đúng ít nói ... nhậu vô nói đúng nhiều :))))))
Hàn Linhhh	Chú Vạn đóng MV thằng điên à :v
Luong Nguyen	Ko nên quay cảnh uống rượu, sợ bọn trẻ nó nghịch theo.
thai nguyen	Má ông virus với ông đội nón lầy vc
FRIZZY HAIRY	Nhìn viruss ốm vãi nồi ra Má Ông coi lên cân dùm tui làm nghề cho sung coi nào :)))
Đỗ Duy Đức	Ghét nhất thể loại bạn ko biết uống ma ép gặp t cho sấm mặt
Trần Tiến Tâm	Viruss lát rượu :))
Tùng Lê	T nhấm đã say r mà jus chs hẳn 2 ăn 1 :))
Thiện Thành	rượu hàn quốc uống ko cay như rượu vn à
tao thích tên ngắn nhưg tên nó cứ dài	e thuộc cả bài tk điên r kakakak
Côn Aladin	Anh tee lầy vãi cả nồi nha giờ mí biết
Sơn YT Gaming	Anh justatee đang rượu nói chứ k phải tự nói
Đức Trung Trần	Gầy quá rồi anh ơi, giữ gin sức khỏe a nha
marmotdragon	Nát =)))))
Mr.Stoner	" Vãi cả nồi ạ" :)))
Đông Pan	A hoàng nhóm máu O thì phải😂😂😂😂
Doãn Chí Bình	Thích nhất nhậu vs gái:say dễ đc chịch
LUÂN NGUYỄN	Ông viruss uống ghê thật
Hoang Nguyen	how to dạy con =))))))))))))
Anh Dv	Viruss da bọc xương ah
Nguyễn Dũng Sỹ FC	Tao thấy thằng say là thằng áo đen, bây giờ nhậu còn ép, mặt thì vênh vênh,
Rinmoto Akyramoto003	Uống xe không được lái bia
Morrin Channel	Nhìn mặt Viruss tội vãi cả đạn
Thanh Nguyen	công nhận người có gia đình chín chắn thiệt
Heyy Lovee._.	Anh ốm quáaa rồi, giữ gìn sức khoẻ nha anh.
NamSTM Fc	Chac 3 4 chén thôi:-):-):-)
Cuong Ho	Nhìn mấy bạn thấy zui ghê. Xỉn vào tự nhiên luôn 🤣
Lala Đoàn	virrus gầy gê
Mai Son	Chú lại k nể anh 🤣😂
Thu Hoai Tran	Lạy ông Tee :))))
Hồng xạo loz	Ông áo xanh như ông điên
Hải Hot Channel	Uống riệu trắng là phải chai CoCa đây ăn thua gì
black blue	Anh gầy quá
kamaitachi rei	Chao ôi, hô 100% thì nhấp môi, người k hô j thì uống hết.
NNFS	Ai thấy Viruss thương vcl k =))))
DuyThanh To	Ghét nhất mấy thằng đi đâu cũng đeo cái túi,xong ngồi ăn cũng ôm cái túi đéo pit có cái mẹ j ko mn nhỉ :)))
Khắc Nguyễn	Nhìn anh vr trông hiền lành nhìn có cảm tình ghê
Thanh Bui	Kết em gái quá
Hạnh Herry Official	Anh Viuss gầy quá a ơi, tăng cân đi cho đẹp hơn ạ
Trang Pham	Đm thằng hoàng như da bọc ương ý
ßee TV	Ai thấy virus giống hươu cao cổ khônggg
Bumble Bee	Thích Phương Ly vãi
tu anh	cứ “vãi cả nồi” ??? -.-
Hung Tran	Li thứ 14 nhấp nhấp thôi, không tính nhé :)))
Do trinh	Thnh niên Tee uống tý rượu vào triết lý vl :))
Phi	Có 14 chén thôi á
Kỳ Vũ	Bỏ giúp cái túi ra cho bớt swag cái Tee ơi...ăn uống mà đeo cái đó ko thấy gượng gạo à?
linh nguyenmanh	Phương Ly đẹp gái lại còn uống giỏi nhỉ
Bùi Thị Biển	vợ ly uông giỏi thế nhưng xinh vẫn chủ yếu :3
Do Manh Cuong	rượu sochu à :))
Free Max	ông tee này hay ép vs mời ae uống là ko đc đâu nhé, rượu bia ai uống đc thì uống đừng ép nhau nó mất vui :)) vui thì cùng nhau uống nó mới thoải mái
Lương Viết Quang	Tee chuẩn lý uống rượu rồi.Phương Ly mới vào quất mấy chén liền cũng gắt làm Viruss hoảng 😂
Tuấn Vũ	Hài vãi.kkkk lần sau ông Hoàng chuyển ngay rượu nặng hơn để đỡ phải uống nhiều. Sấp mặt ngay từ mấy chén đầu luôn kkk
Màn Đêm Xã Tan	E nói thật,  uống thua cả con gái,  a hoàng kì qá àh nghen 😊😊😊
Hải Trần	E cũng kh biết uống giống ah, e uống mấy ly là mặt đỏ như trái ớt lun :)) có ai không biết nhậu không kkk
nam lê	Nhìn thật là vui
Kt Jun	Tụi này chả bao h có tình bạn chân thảnhh. Toàn lợi dụng rồi tương tác cả thôi. Làm cái lồn ji cũng đăng
ke La	Uống vậy chấp trc 1 cốc :))
Mạnh Tuấn Trần	Vãi cả nồi ạ, vãi cả ......
Nam Tenshi	Toàn nồi với đạn ((= Cơ mà nhìn a gầy quá... Nhớ tẩm bổ nha a :3
Nguyễn Thùy Dung	-a viruss mà tập gym tăng cân... chắc đẹp trai lắm đấy 😊😊😊a ấy gầy quá à :))) chị Phương Ly ❤️❤️❤️idol của lòng mị!!! đúng xinh luôn...nét đẹp ấy :3 chu cha... ư hư hư ủng hộ chị Ly đóng phim 😊😊😊
Lực Nguyễn	Sau đó say cả chấy :)(
KiY PDA	khi nào về tui cho uống ko quá 1 cốc 😁😁
Trần 627dz	Nátttt :))
Thái Hoàng	Jay Tee chuếnh choáng lắm r. Nhưng vẫn cố tỏ ra là mình ổn 😌
James Vlogs	Ai sub chéo kh
Huy Ahihi	combo nồi liêu boom đạn
TM C	Anh quay có ngồi chung ko vậy
Khai Duc	xem từ đầu đến gần cuối như là 1 buổi nc bình thường không cho mình có ấn tượng gì... nhưng xem đến khúc cuối mọi người nằm lê lết tiếng nhạc vang lên thì lúc đó khi nhìn VR.. mình cảm thấy được sự cô đơn của anh như anh chia sẻ đến lặng người và nổi cả da gà..  và nhận ra ngay sau đó mọi cố gắng của anh đã gặt hái được thành công với sản phẩm đầu tay, và có những người bạn bên cạnh! chúc mừng anh và mong anh có sức khoẻ để tiếp tục làm việc!!
Đạt Donald	Vãi cả đạn ))) Vãi nồi ạk ^^ --- thánh Vãi + thánh nhậu nói nhiều justatee
dalsi pl	a viruss gầy thế nhờ??nhìn mà xót giùm ghê
Duc Quach	Anh vr buôn đan với nồi à ae. Hay có hãng nồi đầu tư viedeo vậy 😂😂😂😂
Long Lê Thành	Ly xinh wa
Tú Nguyễn	yêu a justatee ghê, lần đầu được xem 2 a uống r
Movie Channel	Thánh văn uống rượu Justatee :v
Toan Dương	Nát
trithuc nguyen	anh viuss gầy vãi cả đái ráng ăn nhìu lên vs tập gym nha anh
VINH NGUYEN	ko phải riệu là nước.thằng lừa đảo,ĐỊT MẸ MÀY.BÔ tiên nhân mày.;KÊNH YOUTUBE CỦA MÌNH LÀ VINH ĐẸP TRAI NHA AE VÀO ỦNG HỘ.OK MAN
Cô bé quàng khăn đỏ	vÃi cả nồi ạ 😄
Anh Tú Lê	Văn vở vlin =))
G Toilatrinh	Ui Tee uống ghê vl Vr chụi thôi 👏👏
Tiến Hoàng Trần	Justatee văn vãi =))))
trang Nguyễn	Đói thối hết cả mồm ra. Vl ông Tee
Thu Phương	*_Bà Ly xinh gheee :3_*
Dưa ARMY	Anh Viruss dạo gần đây anh ốm quá, nhớ ăn nhiều vs lại giữ gìn sức khỏe nha anh. Ốm vậy em lo lắm
Anh Long Nguyễn	Mình ko biết ông áo đen là ai. Nhưng mà mình ngồi nhậu mình ko thích kiểu người cứ xem ly rượu là quan trọng nhất. Rồi so đo, bắt bẻ người ta. Mình ko phải fan viruss ... Nhưng cảm thấy mất vui
Khởi Việt	Anh tee nói chuyện nge thích thật
My Boss	Mấy chén đầu uống cứ cầm cái bát
Trouble Maker	"Biết làm con khỉ ko?" =))))).
Tung Lee	ông virus gầy chỉ sau Lynk Lee  nhìn sợ vl, vỗ béo đi a ơi
chiến nguyễn	Trong bàn nhậu. Jus là ng u đc và càng u càng nát 😬😬 Vr là ng biết u và giả vờ say k u đc. Và đến khi tới tầm . Càng u càng vào 🤣🤣 Ly là thánh diệt mồi Thằng điên là thánh né tránh nhấp môi 😆😆
Leuleuleuleu Leuleu	Tên đoạn nhạc đầu là gì vậy ạ ? Mình cảm ơn hihi
Hoang Nguyen Minh	Ah ơi.các ah cj uống rượu hàn hay sao vậy ạ.
Toàn Nguyễn	Viirus say nói nhiều vãi
Đào Thanh Tùng	Quả ảnh nát rượu 😆😆😆 Nhìn chị Ly nằm thần thái vl 😆😆😆
Nhật Nguyễn	Xin link nhạc vs mnq ơi!!
NYL YEAH	Best Tee
Nhung Ngô	ông tee say
Thành Nguyễn	Hai ông Kia ôm nhau ngủ :))
Tiểu ngư nhi Hs	Còn sức khoẻ mới kiếm tiền đc nhe ông. Ông bà ông cũng trông ông tốt đẹp và vui vẻ lắm nhá.
PII LYRICS	3:06 bắt đầu thấm lần 2 ông bắt đầu xổ lời :v
SWAG CAT	"Vãi cả nồi ạ"
hung nguyen	2 chén cuối nhấp kiàaaaa
nbees	tán Phương Ly đi a :D
Garena Liên Quân Mobile	Rượu này nhẹ thôi, rượu đế ở quê xem 2 chén nát họng
Ếch Phởn	Vãi cả văn rượu
Thảo Lê	Vãi cả nồi ạ !!!
Hoa Nguyen	Ông Viruss yếu thế đỏ mặt nhanh hơn Just
Đường Híp	Just nói hay nè Virussss cứ vãi cả nồi,vãi cả đạn :))))
Cường Bách Vlogs	Uống song rồi 3:1
X Gọi Yamix là Hầu Ca	PL xĩn roi lại chiếm lay Linh Hon di
Hiền Nguyễn	Zui quá xá mà. Mọi người tiếp tục ủng hộ 3 anh chị nào. Mà anh VRus hơi gầy, anh ơi ăn uống nhiều vào anh nhé
Lee Baro	VÃI CẢ NỒI =)))))
Hưng Bùi Anh	Vãi cả tee phong cách bợm nhậu vãi :)))
Văn Đồng	để nghị youtube có nút haha :))
Quang Đông Vũ	Vãi cả nồi aaaaaaạ
Trang Hoàng Linh	ai biết nhạc nền đầu video là gì khôngg
sơn hà	Jus đúng chuẩn cách uống rượu và nói chuyện trong bàn rượu của người miền bắc :))))
DrKenD Lee	Ly dễ thương quá 😍😍😍
Tùng Aka	Chỉ có vãi cả nồi há há
Lighting Zed	nói nhiều mà to vkl
Kunka ND	ôi lily uống má ửng lên xinh vãi :D
Bảo Nguyễn Hồng	Công nhận ông just bị thần rượu nhập nói với nhây vcl
Toan Vu	Mời bợm rượu thì anh cũng phải bợm cùng chứ. Cứ uống cho gục luôn thì thôi. Nhìn buồn quá anh :(
Quangduong Chu	Muốn xem lại cả cái talk show kiểu gì bg ???
Sam Sam	Đoạn cuối tất cả nằm ngủ trông dễ thương thế trời . Trông như họ là người một nhà vậy đó hiu hiu
Anh Vuong	Tee hay quá tee ơi . Bả Ly thì yêu quá trờiiiii
Mạnh Hùng	Justatee number one.
Quốc Hoàng	Phương Ly💜
Quỳnh Hoa Lê Dương	"tôi sẽ che chở cho ông"😂
HA CHEESH	A tee gắt😂
Gaming Experience	Ông Tee ép rượu chất quá =))))))
Phạm Đức Việt	Hahah
Hoàng DH	Trông viruss buồn cười vãi đạn 😂 Có mà viruss giống mình uống rượu tý là đỏ mặt 😄
Thành Đàm	thôi chết Viruss rồi >"< vào tròng rồi :v :v
Hòa Nguyễn Trọng	hình như uống rượu yun chu của hàn phải ko các thým
Kiều Quang Sơn	318 từ “vãi cả”
Tronie	Sao gầy quá vậy anh? Giữ sk a ơi
NgocLanVy Phan	tnhien nhìn cảnh tượng cả đám bạn tụ họp ăn nhậu xong lăn ra ngủ v vui gê :v
Linh Phạm	Vui nhờ. So funny
Dương Thanh	vãi cả
Nguyễn văn Tài Official	Russ nhìn gầy quá
Tân Hồ	Cho tui hỏi quan hệ viruss với tee như nào mà quen nhau vậy anh em.
Hai Anh Bui	triết lý bàn nhậu: Thằng nào uống rượu mới là đàn ông :))
FANS GOKU VN	Đàn ông có 1 số người uống vào thì đập phá,còn 1 số người uống vào thì ngồi tâm sự và tình ae đi lên
nghia nguyen duy	Cái này gọi là uống rượu có bài, vr còn phải luyện nhiều.hj hj hj....
PTL Gameplay Channel	chị Ly xinh gái bị cận à ??
Huy Ngô	Say quá rồi anh ơi
Bàn Thờ Vắng Em	Phương Ly lạc loài :)))
Giang Tống	Rượu này nhẹ
Van Hung	Viruss bỏ thời gian đi tập gym ăn uống tẩm bổ đi bạn
Nô Tì	Nói chuyện mà có chớt ta ti thì đừng nói nữa nhé!!!! Có nói thì cx bị ổng dành phần :))
Rod Jacky	Ủa anh lâm đang ngồi cái đi về rồi :((
Tung Prince	Haha Justatee cute vai
noob gamming	tội viruss vl
Tuấn Anh Nguyễn	Rượu thì 100% miền nam ko lại với miền bắc được, miền nam rượu đế nhẹ hều nên tửu lượng trong nam mức thấp lắm nên ông viruss chạy là đúng rồi !!!!!!
A-Tem Trường	soju hàn xẻng
Phương Nam Nguyễn Công	anh ăn hành nặng vãi
Ken No	Vừa tỉnh rượu thấy uống muốn say lại r
Game PUBG.	*_Virus nhìn người như con cò hem ý nhầy.*
bun keytion	Ông mặc áo xanh say từ lúc tôn ngộ không nhập vào người ổng
xa quê	Jtt như thằg bạn mình chuyên gia kháy đểu :)
mon.key.D. luffy	:))
Jackie Newyen	nhạc nền là gì v ạ?
Vũ Anh Quân	Công nhận a Viruss quan hệ tốt thật
cường hoàng	Ghét nhất cái kiểu  ép rượu
Quan Nguyen	viruss uống không thè hơi ra à , chắc phê lắm
Sơn Lê	khi nào rủ tee uống rượu xem thê nào
thu truong	chén thứ 13 là đến cổ rồi :v
lBossl Hiếu	uống sochu này k ăn thua a ạ
Thiên Thiên	thấy anh cưng vờn :)))))))))))))
Giang Bùi Hương	Tee nói lắm thế đau cả đầu 😒 còn ông Vi toàn Vãi cả nồi 🤣
Linh mát Nai	a Viruss dạo này gầy quá
Nikama TunKo	Vr gầy vãi cả nổi :)))) a làm hành trình thay đổi bản thân đi a :)) dự chắc sẽ hot
Danh MV	Cái câu "vãi cả nồi" nói phải 1001 lần :))
Run _isme	Khổ vlin :))
Nhật Huỳnh	Aww chị Ly xinh quá, ước gì được uống với chị cho dù say sml nhưng quá là đáng
๖ۣۜBøss ๖ۣۜBig	AI THẤY PHƯƠNG LY GIỐNG PHƯƠNG ANH LEE 😉
Gathering TV	Six Som
Đạt Nguyễn Văn	Bị gài rồi =)))
Kien Hoang	Phong cách ăn nhậu kém v l ăn uống mà tay cầm bát tay cầm chén gà  v l
Chuyện đó đây	Team Phương Ly điểm danh nào :))) Xinh Quá Trời
Trà Nguyễn	Đấy là mới uống shochu thôi đấy 😂😂😂
Streamer Viet Nam	mấy ông đô cao vãi nồi?
Hồng K	Ôg a đội mũ cứ gáy trăm phần trăm mà lúc uốg lại thơm rịu thế à 😂🤣😂
Kids TVA	-ai fan viruSS điểm danh-
Hấp Tiểu	Ông tee kiểu say lè nhè vcl :)))))))))
Trang Nguyen	Ông Just kiểu mấy ông nhậu đám cưới đám cỗ, “ chú không nể anh”, “ chú không xứng là đàn ông” :)))) giống bố mình :)))) mình uống hay k k qtrong, cứ p ép ng khác uống ms vui :))
Sniper The Wolf	Viruss cứ câu "vãi cả nồi" mà phang lặp đi lặp lại hoài 😂😂😂
Pim Kute	viruss làm việc nhiều trông gầy quá .giữ gìn sức khoẻ nha bạn
Thảo Army	Anh Tee ngủ dễ thương quá
Le Bach	Cho xin tên nhạc nền với
Khánh Đỗ	Không uống được, khổ vãi nồi :D
Jos Minh	Nhìn mặt ông Tee kiểu như mình bố cân hết :)) trông y hệt tập ăn cay vs Thuỳ Minh. Thần thái vãi chưởng. Điềm đạm phết 🤣🤣🤣
Tuân Bá	Rượu vào
Hải Việt Đào	4:06 nghe Ly cười kiafaaaaaa :(((
Vũ Quang Thắng	Wtf =))
Mario Le	Nồi vãi cả nồi ạ :)))
Vinh co	Ui a hoàng gầy qá v. A giữ gìn sk nha
Nhi Nguyễn	Ông Tee lầy vãi :))) cười ỉa
Anh Đức Dương	Ko bt nói gì ngoài Vãi Cả Nồi :)/
võ long	jaytea nhay vcc
Anh Tuấn Trần	đậu xanh, đang để loa máy tính to, tự nhiên "anh Điên" hú hú há há cái, cả nhà chạy lên tưởng bị làm sao. hết hồn
Huutho Nguyen	Nhìn ông tee cười chảy nước mắt 😂😂😂
Hoàng Long	vãi cả nồi ạ :)
ZeNo C	Chắc ông này chưa tới 50kg quá
Cậu 7Thanh	Ông Just nói quá trời 🤣
Nguyễn Cường	Chắc rượu xochu rượu quê mà chén thế kia sấp mặt hết rồi
Nguyễn Ngọc Hòa TV	*Nhìn a như th nghiện*
minh hoan	just bá vê lờ ♥♥♥
ngọc phạm	Từ phút thứ 6 là bạn just đã say chưa nhờ??? Nói nhiều vãi đạn =)))
Nguyen Hung	Phương Ly là phải 3 ly mới nói chuyện .VÃI CẢ NỒI ...Mời nhầm khách rồi.:))))
Quang Nguyen	Rượu vào lời ra ahihi, Phương Ly cute quá :))
Hoàng Trọng Thịnh	01:32 chính là lý do tao dislike
phuong duy	Để dòng chữ trên vid nhìn khó chịu vãi
Nam	Thôi chết ! Bị phê P.Ly rồi 😐
Thuật Bạch	1
Nhu-Ngoc Truong	Bạn ơi nhớ giữ gìn sức khỏe nhé, nhìn bạn ốm hơn trước nhiều quá. Take cảe nhé!
Quang Chu	anh vi rút gầy quá -.- hic
Pham Thuphuong	Anh ấy có tí men là nhiễu lun
Nguyên Bé	Ông Tee nát quá 😂.
Super TV	:)))
Bạch Lê Tần Tiến	Nhạc nền là gì vậy mọi người
hiệp trịnh	Hahah hai anh tâm sự chị ly chỉ biết cười phải chăng có sự bơm nhẹ ;)))
Hồ Khải	"Vãi cả nồi ạ" a ns nhìu :v
Chánh Kiệt Đặng	Jusstatee lầy vãi :))
hưng nguyễn	Sao uống ít vậy anh viruss em là em chơi đc hơn nữa chay ák
Kien tran ngoc	mình mà trong cuộc nhậu này phải mời ly liên tục mất,ly xinh quá <3
Vitalina Nguyen	Uống ghê nha
Duy Phong	Hahahaha
Thanh Đức	ViruSs khổ vãi nồi :))))))
Channel Slowyy	cái đoạn cuối cái tờ giấy bay bay trông buồn cưỡi quá :)))
Văn Quang Phạm	Xem lai mấy lấn vẪn hài 😆😆😆😆
[Anime] Love's Story	Vui hen =))) nhìn Jus nói nhiều khiến t nhớ thằng bạn gốc Hà Nội vãi . hễ đi nhậu là nó nói t ngồi nghe à @@
Tuân NGUYỄN	nhìn như thằng nghiện
Underground - Rap Viet	*Tao vô đây chỉ vì coi Phương Ly*
Vân Hà Bùi	Nhìn cô Ly uống rượu là biết team này tốn cồn rồi. Trong bàn nhậu hay có câu "Rượu bất khả ép, mà đã ép là phải hết". Hết mình or hết rượu.
Nhân Pro	tôi đã thấy được đằng sau Justatee =]]
Trường Giang	ông nói tôi đau đầu lắm, ông chỉ cần uống thôi không cần nói :)))
Đăng Nguyễn	Anh Tee bắt bẻ ghê quá =)))
Trần Huy Official	sub cheo ko ae
DucViet Pham	Phương Ly nên đổi tên thành Ngàn Ly vì uống ghê vãi nồi :)))
Đức Nguyễn	Vãi cả nồi lần e nờ :))
Mai Dương Channel	thích cảnh cuối
văn điều nguyễn	Nhìn Phương Ly ăn khô gà như đang bucus ấy ae nhể 😈😈😈
Hưng Hồ	phương ly quá xinhhhh
Hieu Phan	uống dc 100 ly ko
hùng lê lâm lý	Rượu văn của ông Tee khiếp quá
Lil Skies	Đúng rồi, hoàng làm thế kiểu cứ chối rượu mất cả vui, ae đã tới tận nơi rồi cứ chối rượu, sao gì đâu
Tạo Nguyên	Say chỉ biết nói mỗi "vãi cả nồi "🤣🤣🤣
Phuc Nguyen	Phương ly xinh vcđ 😍😍😍
Channel Aggregate	Gái 1 con trông mòn con mắt
The Sun South	Nhãm
Đức Vlogs	Tôi đức vlogs chào ae Chéo sub nào ae ơi
Văn Thành Official	Ae qua kênh Mình xem phim zombie đi hay lắm
Dang Quang Huy	A hoang lúc say :))
MON	🤣🤣🤣
Cover hit TB	Em ms làm video gõ bút mn vô coi like giúp em nhé nếu tốt hơn thì sub vì nó miễn phí mà  Sub đi rep cmt em trả cho  https://youtu.be/RJIzMpIRn1o
Rimzy TV	Quả tóc ông rớt ngáo quá😂/tee giảng đạo hay quá😅/ Phương Ly xinh chết ng😍😘/ông Lâm giống khỉ đột quá😃🦍
Hà Quang	Haha nát quá
Mr. Zuster	rượu vào lời ra
Dương Ngô Hoàng Điền	Nói chuyện cứ như anh đức phúc ấy
Quốc Cường ICT	Vợ tương lai uống cũng khoẻ quá cơ 😍
Quân Trần	Ae nào bt nhạc nền k ??
Thái Tạ	A hoàng ơi a gầy lắm rồi :(((((( a hưu sức khỏe đi anh
2,641,998 subcribers	Ô sáng tác thêm "thằng hài cốt" đi
Minh Lê	Tôi kh thể đứng vững trước vẻ đẹp của Phương Ly -.- kiểu gì cũng xinh ❤️😒
SubestgameR	*Vius được 40kg không vậy?*
đăng vo	mấy ông bảo 100% mà uống có 50 viruss uống nhiệt cmn tình =)))
AA Esports	Phương Ly xinh qué! Rụng tym rồi <3
Công Nghệ Mới	Ông Justatee uống bá thế :))
Dương Đỗ Hải	1:18
Viết Tuấn Nguyễn	Nhìn ông đóng thằng điên trong MV toàn 100 phân trăm xong uống không hết hài
Liên Quân Gema	Rụ này uống dễ say lắm bữa tôi uống có 6 sáu li rụ này là say say rồi
Ngọc Armybts	Câu cửa miệng"VÃI CẢ NỒI RA"
Linn ™	Mấy thằng này nhạt vãi lồn :)
gia bảo Trần	LY CUTE QUÁ <3
ngoc vi	Virus a ốm thế. Phải lo cho sức khỏe chứ a.
Gia Hưng	Chả qtam đạo cái moẹ j nhưng hay vãi ra a ạ ❤️❤️
Ngọc Hân	em uống 2 ly vào thì xanh đến khi hết xanh rồi  vài phút sau hết xanh rồi uống tới sáng anh nhé
Phương Thị	Thằng kìa cười ít thôi :v
Đạt Biu	Anh viruss hạn chế dùng từ "Vãi cả nồi" đc không, nó thành thói quen rồi khi nói chuyện không được hay lắm
Nightbot	12:44 sai xót rồi nha, a nhấp môi có cái mà tính lên 14, điêu thế chứ lị
Nguyên Ninh Kỷ	Ông Tee nói câu nào chí lý câu đấy :)
Thắng Trần Văn	Đến lạy thánh Tee
Hoàng Vũ Trung Anh	VÃI CẢ NỒIIIIIII Ạ =)))))~
Thiện Kiều	tee tửu
Anh Duc	Bài nhạc nền của video là gì vậy anh ơi
Giang Pham	Ladykillah mà lại. Uống rượu bia như thuồng luồng uống nước =))
duc jp	đm giống minh vl
Tân Hoàng	Sau khi xem xong clip và em nhận ra là đã lâu lắm em k đc la ca như các anh r
Nguyen Chien Thang	Anh Hoàng nghe anh Tee nói thấy đau đầu, choáng váng :))
Minh Khánh Võ	chị Ly xinh qué <3
Tu Hoang	Ghéy nhất thằng nào ép riệu
Duy Coconut	Cầm cái chén hoài vậy ông
bưa dz	Nói chuyện nhạt vl
FB MC	thèm nhậu quá
Bo Thắng Yang	Đã lâu lắm tao mấy nói nhìn a Viruss như Yoo Jea Suk á 2 ông này để ý kĩ như ae sinh đôi haha cá nhân thôi đừng quang đá e nha bà con
Duy Pham	tiện thể a Viruss hỏi idol Tee dùm e là bài Lả Lướt khi nào xong thế ?thấy có cái bản demo gì là thôi ??vãi cả nồi ạ !!
Minh Trường Vũ	JayTee :))))))))))))))))))))
Trung Tử Cung	Một ông ít giao lưu trên bàn rượu vs 1 ng đã vào ói ra bò trên bàn rượu!  Trình độ nó khác hẳn 🤔😂😂
Trung Nguyentritrung	Vãi nồi vs vãi đạn nhiều vậy baaaaa 😂
Eyes Blue	Tee lầy vl
Hoàng Lộc Nguyễn	ViruSs anh nhớ ăn uống kỹ lại anh ơi, chứ ốm quá chời ốm rồi :((
Ngoc Hiếu	vãi cả lồi ô justatee ô ấy phê con mẹ zồi kểu này say đéo ai cản đc đâu =)))))))))
Ryuk	Anh ViruSs giống em quá, uống chút xíu là mặt mày đỏ ké!! :))
Trung Nguyen	Chất trai bắc
Trần Thanh Thảo	Virrus gầy quá anh ơi giữ gìn sức khoẻ nha
Hieu Nguyen	vãi đái thanh niên JT lầy vl :)))
Bank Plus	ông tee nát phết nhể ha há
hùng nguyen	tee uống ghê vãi xoài ạ
Hạnh Minh	Cảm giác gió có thể cuốn viruss bất cứ lúc nào ⚙️⚙️⚙️⚙️
Chen Hồ	👍👍👍
Lyric Nhạc cũ	Bễ phết nhỉ
David Troller	Ai cho xin cái tên nhạc
Hương Ngọc	Phương Ly mà say rượu là xác định quẩy nát nhà viruss -.-
d nguyen	Tee lầy vcd :))
D VQ	bộ xương khô virus à ?? nhìn thế này chắc k tới 50 cân, 45 cân à ?
Trứng Biến Thái	Đúng kiểu rượu vào lời ra... chưa uống thì còn ngại ngùng... mà đã lê tê phê rồi là tới bến
nguyen phuong	Tập gym cho mập lên đi a ơi. A ốm qá
Min Suga	Viruss ơi dạo này anh gầy quá.. Ăn uống điều độ chăm sóc sức khoẻ nhé.
Nguyễn Đức Thọ	chẳng có câu nào khác câu vãi cả nồi
quang pham	văn hay vcl tee ạ
Khang Khang	Vãi cả nòi ạ
Hue Nguyenhuu	Vãi cả lồi ạ
Kiên Trần	1 2 3 zo
Nhat Huy Vo	Chị ly xinh vãi tèo
Hồ Hải ĐĂNG	Ông tee say , xàm vãi đái
Earth News	tập uốn đi chế ơi....vui ghê
trung vu van	anh làm clip về bài Thu Dẩm của LK đi anh
thiện tạ	Ông Tuấn nát quá
Huy Trần	người gì đẹp dữ v trờiii :))) Ly ơiiiii
Hacker Anonymous	Mời nhằm khách rồi😂😂
Anh Vy Tran	không co artro vs deep k ak anh
Vu Manh	Thầy t nói cấm sai...3 ông nhậu ko sao,thêm 1 cô gái vào nhậu là có chuyện liền
Tân Phạm	Đậm chất người hà nội anh tee ơi 😂😂😂
Vi Lục	để e đỡ cho a vai rớt :))
Tinh Teo	A tee nát quá 😅
khuất hữu bình	Ko có full à
Quan Khải	Khách mời cục súc Vãi Cả Nồi,Viruss khều khều cho Phương Ly cứu bồ sắp quắt cần câu rồi bã xạo xạo em đang nch vs m.n cho Just triệt Viruss 🤣
BTM Táo CaCa Vlogs TV	Kkk, đã à nha!
Chỉ Cần Lý Do	Tiên tửu viruss 😃😃
Sơn Thanh	Xin link full dc k anh hoàng mn ơiiii
Thinh Pham Le Gia	Cực kì thích nhạc của Tee nhưng mà clip này thích thêm tính cách của Tee nữa =]]~
Dat Tran	- Ông làm mấy cái vlog này với bác Tee như này vui nè ;v
Duy Khánh	haha xem mà cười ỉa😂😂😂
dat truong	vãi cả lồi ạ !!!
Việt Hoàng	Mua thuốc tăng cân đi anh
Tina Nguyen	justatee toàn dậy đời buồn cười vđ :))))
Lâm Văn	Bà ly uống kinh dị vậy  😂 hớp một hớp một 🙄
Cong Lao	Ãi cả nồi ạ. Ok. Vãi cả đạnnn .  Ãi cả nồi ạ. Ok. Vãi cả đạnnn .  Ãi cả nồi ạ. Ok. Vãi cả đạnnn .  Ãi cả nồi ạ. Ok. Vãi cả đạnnn .  Ãi cả nồi ạ. Ok. Vãi cả đạnnn . $$
Sinobi Aliec	Ống đang bay thì phải 😒😒😒😒😒😒
TÚ LIÊN QUÂN MOILE	Mé chỉ thấy nồi với đạn 😂😂😂😂😂
Vy Nguyễn Tường	Anh " thằng điên "😛😛 bảnh quá
channels JAV	Ngồi nói rất nhiều nhưng uống rất ít
Thanh Quí Lê	Bố quỳ với 3 ông này :))))
Ngọc Xuyến	Ai ôm ông Tee vậy 🤣
DTD _Vn	vãi cả nồi ngồi uống rượu.
bao nguyen	Chú Lâm đang uống chạy đâu rồi?
Tô Ly	Xem mà cười vl 😂😂😂
Vũ Hoàng Long Dương	anh tee trêu anh viruss vui v :))))
Son Le Hoang	cú lừa giành cho viruss rồi :))
한란김	S ông Viruss như miếng dán ép v -_- ăn nhiều lên nha a
To Hung	Hay
Chú Tư	Ổng cứ vãi cả nồi... Vãi cả đạn... Nghe cấn cấn khó chịu
Monkey D. Luffy	Kêu uống 1 chén say ngủ :))
Hà Tâm	Thanh niên Tee không về thay bỉm cho con à :))
duc anh pham	k phải rượu quê k lo sếp eiiiiiii
and game music	Lần đâu tiên mình like clip của virus và cũng là lần đầu tiên mình xem 1 clip của 1 stream mà cảm xúc lẫn lộn thế này  Hãy sống thật vui vẻ a nhé Và hãy chân trọng những gừi bạn đến với mình sự chân thành ^^ Chúc anh sẽ ngày càng phát triển trên con đường âm nhạc của mình :)
Nguyen Vinh	Phương Ly xinh vãi cả nồi ạ
Linh Ho Xuan	Mặt ổng uống rượu nhìn ngu ngơ quâ !!!
Soi. MV	Vc khỉ😂
Lệnh ý hoàng quý phi	Tớ 20 chén vẫn tỉnh nhưng k bh uống quá nhiều
Bờm Ka	ông kia sàm vãi nhỉ say cmnr
Con Mèo Đen	*nhà a viruss lắm nồi vãi ra*
Xuân Trung Nguyễn	11:45 to 11:55  Viruss said : Đỡ đỡ..... 🤣😂🤣😂 Đoạn này chị Ly cute vãi cả nồiiiiiii ❤️
Hoàng Nguyễn Đăng	1:21 đeo tai nghe giật hết cả mình với ông Lâm ( Thồn)
Fresh Juice	vãi cả nồi ạ :))
ăn cứt dũng	Mấy thánh lầy vc
Đức Nguyễn Việt	Nồi đạn nhiều vl haha
Dương Nguyễn	Nhậu xỉn xong group sex luôn đi a hoàng sau đó làm clip group sex :))
Ngọc Gooner	best ép uống =))))
Dương Trần	Phương ly xinh vãiiiii!!!!
King Monster	Ông rút gầy vãi đạn ạ  Hỗ trợ thêm vài nồi đạn tăng cân đê
Anh Tống	Justatee nói phát im re thề tắt máy quay ra văng ra chửi nhau sml viruSs một phút bốc đg r
quyen monter kid	Bao nhiêu câu vãi cả nồi
UX tuw2	A tee lên hà giang uống rượu với bọn em nhé Vài chai đấy nhắm mồi thôi😅😅😅
Đăng Hải	Ko bt bao nhiêu câu v~ nồi :))
Hien Nguyen	Uống ở nhà bạn, nhà mình thì say sm ra thì vẫn yên chí ngủ lại. Chỉ khổ người dọn "chiến trường" thôi :))
Dư Trần	Nhìn virus giống ông mc quốc dân bên Hàn quốc
Ichimoku Trịnh Phát	Mấy thanh niên này uống kinh quá
Khang Minh	Toàn vãi cả nồi vs cả vãi cả đạn
tam pham	just say nói hài vcl ra
maruko chan	Ông jus bình tĩnh dã man
Tin Nguyen	Sỉn vô ngồi vãi liên tục
Tôn Ngộ Không	Chị kia xinh thế
Huy Hùng	vãi cả nồi + vãi cả đạn x3.14
Jasmin Vuong	Sai rồi Rớt owiiii :)))
Thành Nguyên	nhìn anh tee ngứa mắt vc
Hoàng Tuấn Phạm	ViruSs bị vật nát
Khánh Nông	sếp uống xong toàn VÃI CẢ NỒI Ạ 😂😂😂
Giang Vu	Haha 😂😂😂
Quang Trinh	Chị ly xinh quá
TS LQH	Vãi cả nồi
Nhật VLogs	say roi
nguyen quoc tuan	Justatee ác vl
Fan VR	"vãi nồi quốc dân" =)))))
Romantic	Ly ngon quá :(
Nguyễn Duy	thay vì đếm số ly  đã uống chi bằng đếm số nồi số đạn vãi ra hay hơn
Gầy Gaming	Toàn vãi cả nồi ạ
Prince Micheal	Anh Viruss uống khoẻ vậy
RR Kull	Tee căng vãi nồi
just my opinion lol	1:22 rip earphones users
uchiha sasuke	gat the
Ta Là Gió	Viruss nhìn ớm vãi , ko bik bà Ngân chăm ổ ntn mà ớm vãi.
Tỉnh Nguyễn	Ngực chị Ly đâu r
Paddy nomal	Thực ra ông Tee say mẹ trước Viruss rồi :P
God Jane	Thằng kia quay đi . Mặt anh đang chềnh hễnh trên tv m lại xoá hết cả mặt anh . Con ạ
Hiệp Trần	Gầy vđ ạ :))
PHONG Yêu	Vai rớt gầy thế, ăn vào, chịch ít đi
Minh Anh Đỗ	Cả cái video toàn: VÃI CẢ NỒI😂
Hùng Kird	Chuẩn người hà nội. Chuốc cho rút sấp mặt lol kk
Enterty Clan Vlogs	1 phòng 5 ông 1 bà ???
NgaoDu90	Đúng văn của mấy thằng bợm. Hay lằm JT =))
Hải Đăng	Đạn với nồi nhiều vl 🤣🤣🤣
HKD Monster	v~ hài
lam vũ	ông tea ác vãi
N3n3	hahahaa
Lâm Phạm Võ	Vãi cả nồi :))) Vãi cả đạn đạn :))) Vãi rượu. Vãi gái
Vu Nguyen Quang	jaytee kieu mot. ruou vl =))
Paul Dz	nhìn phương ly thôi mấy ông ạ
trung anh nguyễn	Vãi nồi * 3,14.... vãi đạn * 3,14...
Khánh Việt	Vãi cả nội ạ :))
juun trần	Đau ruột
VU VƠ	Vãi cả nồi ạ hài vc
april .09	lầy vcl ông tee ơiiiii
๖ۣۜNAM๖ۣۜ Aoyama- ๖ۣۜKun	xem mấy thánh phán chỉ bt ngồi cười :))
huy nguyen	vãi cả nồi, vãi cả nồi, vãi cả nồi ạ :))
Khang Phan	phương ly <3
Hồng Hài Nhi	Đọ gì thì đọ. Đừng đọ rượu với ng miền băcd
Trương Gia Vinh	ông kia làm con khỉ :)))
Nguyễn Đăng	kk =)))
SINO N2M	Anh viruss uống 1 ly là đỏ mặt r
MIN Senter	Vãi cả nồi ạ BÀ LY bả nằm cái tướng...Vãi cả nồi ạ 🤣😨🤣
Neko Mikiyo	Nhìn ViruSs béo ghê :))))
Nguyễn Luân	Thề ông viruss càng ngày càng xấu và ốm quá khác xưa
kim son hoang	Ok anh say! nhưng tim anh đang đau ấu
hung tran	T đang ngi ngờ éo bit có phải riệu k :))
Nam Trần Trọng	Vãi cả nồi ạ.............vvvvvvv.......vvvvvvvvvvvv
tan nguyen	thôi ông viruss nát rồi ông ơi  vãi đạn ...vãi cả nồi x1000
Tran Thanh Binh	nguyên team điên và chất :))
MP Nguyễn	Phương Ly có con rồi mà nhìn nuột vcl
Hưng Lê	Chị ly ngủ cute quá
duy nguyễn	Cắt cốc
Minzuz Tv	vãi cả nồi ạ
VN-GàCon	Vcl jus uống kinh thế thì cha nội viruss chỉ có nằm 😂😂
Quý Vũ	Uống rượu sochu nhẹ hơn vang chút mà gục hết ntn à :)) Phải dùng rượu trắng VN chứ a ơi :))
An Pham	Cả nhà ngáo hết luôn rồi.!!!
lang nguyen	Uống rượu mà gặp kiểu tee sợ vl
Nghĩa Hà	Tee uống kinh vãi
Van Thao Chu	cười ỉa
Thành Văn	Ông hoàng hôm nào mời cả team youtube về. Làm 1 bữa. Đảm bảo cả triệu share
Công Bình Nguyễn	V~ cả nồi, đạn x3.14 :))
Nguyen Nhi	chỉ có TÔI và v~ cả đạn xuyên suốt video t đã biết 1 mặt khác của j
Tố uyên	Tấm cuối dễ thương vãi đạn
Hưng Nguyễn Thành	Rượu bất khả ép. Ép bất khả từ :))) ai cũng như vr thì nhậu vui vẻ gì :)))) ngồi giữ kẽ à mấy nam thanh nữ tú :))))
Binh nguyen van	Tay viruss bé vãi lồi
Đạt Cter	ViruSs bị hấp diêm haha
JJ Hilley	Đại hội võ lâm mọe r
Chính Văn	Cái nồi bình dân
Hoàng Phạm	Sayyy rồi hâhha
Hậu BgG	Bị chửi sml luôn 😂😂😂
Ngoc rong sv4 Dragon	Virus ăn hành sấp mặt 😂😂
Đỗ khánh	Chả pk sao ViruSs nhấp môi k à
Sad Meo	Cho em hỏi chị Ly có người yêu chửa =))? Nếu chửa thì nên có người yêu đi =)))
cccnek hoi	nhà bác viuSs k có j ngoài nồi vs đạn
RÙA GAMER	A hoàng sao gầy vậy
quốc huy đinh	Có ai thấy JT uống vào xong cứ xơn xơn qua vr nhìn giống gay vl
Đức Bình	Ai đếm thử coi có bao nhiêu câu vãi cả nồi èn vãi cả đạn =))))
Vương Hiếu	Khà khà khà😂😂😂.
Nasus TV	Buồn cười 😂😂😂
Hoàng Long Lê	Rượu vào lời ra Lần sau không muốn mời luôn
HD258 Gaming	Vãi cả NỒI x 3,14 Vãi cả ĐẠN x3,14 ạ ạ ạ ! :))))))))))))))))
Đen Trắng	Team bợm rượu :tee ly Team ít nhậu : viruss  :)))
Akagami Thành	Hôm nọ đọc báo nghe nói là những ai uống rượu mà mặt đỏ là tỉ lệ ngộ độc cao gấp 10 lần người bt 🤔
King NV.Tiệp	Ông tee ru hay quá😁😁
Night black	Nói thật nhìn bà Phương ly nhìn giống boxbox phiên bản nữ :v
Minh Nguyễn	Tee:"Lại nhảy vào mồm tôi rồi " =)))
Thành Long Nguyễn Phạm	Ty lầy quá A Hoàng e yêu a
Pew Noy	XONG phương ly nát r
Supper SWannaCry	Haha bà Phương cute ghê
Hiếu Lê	Ai giải thích viruss liên quan gì đến «thằng điên»
pham thanh	K uống đc k nên ép, đấy là lịch sự 🤷🏻‍♂️
An Bui	A tee bị dính rr 😂😂
Subino Đặng	đáng yêu thế nhở 😘😘😘😘😘
Vũ Hoàng Giang	Rượu nhẹ rồi =))
Nguyễn Hải Nam	15 chén đã say thế này thì hỏng rồi :))  lại còn là rượu soju nữa chứ
Đào Mai Quỳnh	Đau ruột vch,rượu vào lời ra,đúng bài luôn,ông tee mặt tỏ ra tỉnh lắm 😂😂viruss vật vã ăn đủ văn tế của ông tee 🙏🏻🙏🏻
- Jikey-	Jt nát kiểu mới =]]
Hoàng Duy Bùi Vũ	Có ai chỉ kém anh Viruss 2 tuổi nhưng vẫn kh biết uống rượu bia như mình kh?
Tiến Anh Trần	Phương ly uống rượu kinh vậy
Lucifer	A vãi cả nồi hơi nhiều =))
supper Vip	#phuongly2vn ae eii =}}}
DIY Costume	Jus say nói chuyện lầy quá
Ly Hạnh	nhậu bét nhè! ghê thặc haha
Bergkamp Denis	Fps thấp quá a ơi
Vương DRX	*Viruss auto Vãi :D*
Cảnh RMA	gầy quá viruss ơi
Kiệt	Ai biết info áo phương ly không
Đăng Phạm	Đoạn cuối ngầu nha :V
Hi im Mưa	"vãi cả nồi" x 3,14 :#
Thành Ngô	Uống nc lọc thì có 😑
chuotbi_yeu_gaoxu	Ông tee ép rượu hài vãi chưởng
Xe điện PEGA	Chị Phương Ly xinh quáaa 😍
anh kygo	Đã nhiều lần hứa k uống bia rựu nữa nhưng nhìn vào cốc bia chén rựu lại nghĩ tới người làm ra nó. Mk k uống thì con cái họ lấy tiền đâu ăn học rồi còn bà hàng xóm cạnh nhà ông bán bia nữa chứ
FPS Đàm	Virus con thứ 2 r ba  :))
Nhiều Kí Tự Zombie V4	https://youtu.be/niQcutIVAaA
Minh Nguyen	Ông viruss ốm quá r :/ tập trung ăn uống tập thể thao đi ông eiii
Mạnh Vũ	Tee say rồi
Hao Le	ai đăng kí kênh mình đi ít lược đăng kí quá àk
Nguyễn minh đức Lê	Có mười mấy chén rượu mà cứ bảo jus nát với gì là sao??? Đm bọn mày ngồi trong cuộc vui chẳng sấp mặt lồn ra ấy.
quy bui	Khổ thân bị chặt
Hoàng Nguyễn	Phương Ly xinh vcl :3
Fan Bé Chanh	*Phương ly uống rượu như nc ý tu ghê 😁😁😁*
Kiệt Onbi	Đậu xanh. May mà mình không có bạn nhậu như thế. Lầy vãi nồi
Cu Thóc	Vãi nồi liên tục thế viris :))
quynh nguyen	Ai thấy viruss giống chú Jae suk running man điểm danh nà
tiểu cương thi	Ông tee sỉn lầy vler
Tĩnh Hàn Nhi	Hay ho đéo gì mà ép  Cứ tưởng thế là hay
tea đinh	anh justatee lầy qúa
Mạnh Cường	studio của virus ở đâu nhỉ mọi người
Huong Truong	Vãi cả nồi ,vãi cả đạn ạ 😂😂😂
CHÍP Studio	Tựu lượng tee ms ly cao quá thề
Fenix 25019	ViriSs gặp cao thủ ép rượu rồi nếu không biết cách từ chối  khéo thì nát người ngày tại hạ xin bày chút kế cho có thể sử dụng trên bàn nhậu cũng sưu tầm cả thôi : Uống rượu không thể giải sầu uống  rượu chỉ tổ nhức đầu mà thôi  để không tổn thương tình cảm tôi uống để không tổn thương sức khỏe tôi uống ít thôi nhé  ép dầu ép mỡ ai nỡ ép rượu  ông không uống là không tôn trọng tôi xin lỗi tôi hầu như không tôn trọng những ai ép tôi uống  cả bàn uống ông không uống mất vui ông xem cả bàn vẫn vui và bằng chứng là họ vẫn đang uống  cứ uống hết mình đi, say tui đưa bạn về khi say là tôi không về, mà không về không được, không được tức là tôi phải về, mà muốn về thì tôi không được say  nốt chai này rồi ae mình về đây có phải là công việc đâu mà nốt cho xong  nể nhau thì uống hết chén này đi nếu ông coi uống để chứng minh tôi nể ông thì tôi không uống chắc ông hiểu chứ  rượu bất khả ép, ép bất khả từ câu này hay vế đầu do thầy dạy, vế sau do bọn phàm phu thêm vào  tôi không chơi với bọn tục tử  chén này uống vì tôi không lấy rượu làm thước đo   chỉ có thằng sợ vợ mới không dám uống chỉ có thằng không não mới không sợ vợ   đàn ông gì mà uống nước ngọt uống rượu cũng chắc gì đã là đàn ông  anh không uống ly này thì anh không nể mặt tôi nếu đem sự nông sâu của tình cảm so sánh với tửu lượng nhiều ít vậy thì mối thâm tình của chúng ta làm sao so được với 1 ly rượu, với giao tình lâu nay nhấp môi thôi cũng là ngọt rồi  tôi tôn trọng bạn nhưng tôi nghĩ bạn cũng nên tôn trọng tôi   hiểu tấm lòng của nhau là tốt quá rồi , không nên đo lường tình cảm bằng tửu lượng, chúng ta vui là 9, uống được bao nhiêu thì uống bấy nhiêu nhé, rượu không cạn nhưng tình nghĩa vẫn sâu đúng không nào
XUÂN QUANG	Haha
khét lẹt	Nhìn người ô viruss chả khác gì ô lynk lee , khung xương đi động :v
Hoàngg Huy	Anh Tee bừa quá haha 😂
Tom Phạm	Mẹ tee nó ép gắt thế lms đỡ đx
Âu Đức Trần	1:22 Lâm vissay hóa THẰNG ĐIÊN
Tuấn Dola	Chưa có ai say mà bảo mình say =)) nên thôi là uống đi đừng có xạo vãi cả nồi ạ =))
Kiên Nguyễn	Khi xong xuôi tất cả đều ngất hết 🤣 nên chẳng có ai dọn 😂
Thạch Dừa Gaming	Reaction những kẻ mộng mơ đi bạn viruss ơi
Gầyy Gaming	*cmt này đc 200 like sẽ tìm tận nhà virrus làm clip nhé ae ^^ qua kênh đăng kí nhê*
Sherlock Homles	nồi quốc dân
tuấn nguyễn	Rất mong đc 1 ngày gặp a hoàng. E rất quý a. 0888900388 hi vọng a nhá máy e 1 lần. E ơ Vĩnh phúc
Nhi Nhi OFFICIAL	Đạn và  nồi =))
Đức Leo	Ly xinh vãi nồi
Nguyễn Tùng Lâm	gầy quá rồi anh ây ;) giữ gìn sk anh nhé
Le Toan	justatee noi chuan vai
NNH Vlogs	btw ViruSs vẫn là người tội nhất, bị giã cho tím cả mặt :(
Thu Hà	Cíu cíu cíu.... anh Tee ép giỏi vch🤣🤣 mà nghe ông ấy nói cứ tg ông ấy phê cơ Anh Viruss thì hiền quá Chị Ly xinh khỏi bàn mà uống đỉnh quá😁😁
Like You	Ông kia đống a trai Hùng trong Người Bât Tử quả tự tử nhìn ngầu phết hâhhah
Linh Di	Viruss thực ra uống được nhiều đó chứ nhưng ko máu bằng justatee đó thôi😆
Khải Phạm Quang	Uống rựu mà cứ lăm cái chén v ba
ATSM TV	nhìn vai rới tội vãi
Thành Lương	Team nửa lít đâu rồi. Tôi 19 tuổi nhé.
Huy Dinh	ly xinh vcl ạ=(
Mr Pillow	cô Lyyyyyy
MONSTER NVQ	Hài quá anh Tee ơi 🤣
TP Gamer Vlogs	Vãi Thánh Khỉ Giống Vl Sub Chéo Nha!!! Kênh Mình Chuyên Sub Chéo
Thu Hiếu	Chị Ngân ơi... cho mỗi ông cái mềm
Tú Lê Minh	Uống nhiều vào và nói ít thôi =))))
Khanh Le	chị ly mạnh dữ
Trinh Phan	Hình như phương ly lớn nhất trong 3 người đúng ko ta😞
sẹo chiến	ông just đúng chuẩn kiểu dân hay nhậu đây này
Thắng Hoàng	Viruss gầy như thg nghiện ý ae à :))
Cao Manh	Tee nát vãi đạn 😂😂😂
NL T	Ông tee uống kinh thế
Nguyễn Trung	Nhà anh Hoàng rất nhiều nồi. Vãi riết nhưng vẫn chưa hết nồi :))
Nguyen Nguyen	Vãi cả nồi vãi cả đạn × 3.14
Thu Tang	Phương Ly xinh qtqđ <3
Nguyen Thang	ông nội Viruss ốm quá, phải lên tầm 10-15kg nữa thì đẹp trai :D
khang nguyễn	nhà anh không có gi ngoài  " nồi với đạn "
Trình Nguyễn	Vr ông bớt mặc cả với người xem đi nha Hết mình với người xem đi🍻🍻 zô🤪
ueki cute	Team a ko thể nhịn cười đc😂
phong ngô văn	Hay đó
Vit ơi	theo dõi hết video thì xác nhận anh Viruss uống dc rượu nhưng do la anh k thích uống và anh k uống nhiều nên là chưa qen :))) chứ để mà uông qen r thì ghê phải biết
Thích Cover	Vui quá
Mạnh Nguyễn Văn	Justa kích :v
Zing Minh	uống rượu có thêm cái đàn thì phê nữa các ông ạ <3
베트남친구들	Chế Viruss mặc áo kia nhìn gầy quá.....😂😂😂😂😂😂😂
Tam Bui	Tee lầy vc! Cứ như vậy mới là người thoải mái
Thành Mai	Làm thêm clip nữa đi anh, nhưng thay vì đếm số ly đã uống thì anh làm đếm số câu “vãi nồi, vãi đạn” từ đầu đến cuối clip :)))
Minh Mày Mò	136 câu vãi nồi
Kai Osti	Phương Ly xinh quá :(
anh turtle	Up top 1 cho thằng điên nào mn 😇😇😇
Tuan MG	Anh tee bê quá 😝
Bùi Xuân Thủy	Uống được thì uống không uống được thì ráng uống a Virusss ơi ^^
bé trung	Đoạn cuối nói lên tất cả  tee có trâu đến đâu cũng  phải  nằm sấp  :))
#Thịnh	Nhìn viruss gầy y hệt lynk lee :v Ăn nhiều vào !
đỗ minh phương	viruss liệu được 50kg không
Thu Hằng Nguyễn	Viruss sao gầy quá vậy anh ơi :)))
Kevin Hiếu	Nồi vs đạn
Quân Nguyễn	Tee ác vccccc
Thanh Lịch Official	Ly nhậu thì thôi rồi
Leo Nguyễn	nút haha chỗ nào nhỉ
nam nguyễn	ô T gia trưởng nha :v :(
Thảo là Cỏ	Câu "Đấy là việc của ông" với " Vãi cả nồiii ạ! " sắp thành câu cửa miệng của t rồi 😂😂
Chung Hà Xuân Bảo	Ba ông này hài vãi chưởng kkkkkkkk
Sơn Lâm	Anh em Bắc tụ họp trong Nam =))))
Glenn Wick	a Tee howi nats qua =)))))
Hoàng Thiên Vlogs	Hôm nay ko say ko về
Hiếu Phạm	ghét nhất thể loại uống rượu mà cứ ép, ngta k uống đc thì đừng ép, nể nên uống đến chục nháy r mà vẫn cố tình, nhìn ngta sắp ngỏm mẹ ra đấy rồi còn gì :))
ss Lolicon	hài vl
Hao Hao	Đùa với justatee ak
San Lê	Dễ thương quá : )) À bảo Tee nhớ >w<
Ngọc Táo vlogs	đợi mãi cái video này hôm đó e ko dc xem hehe xem sếp uống thế nào
PVN clips	" Vãi cả nồi"  câu này lặp lại hơi nhiều
Anh Lâm	HÀI Đ THỂ TẢ ĐC :))))))))))))))))))))))
NTV Smile	Thíck nhậu với just ng như này vui lắm. Vr nay gặp cao thủ sm rồi kk
Tiến Phạm	Tôi thấy cái video có 14’34s mà ổng có 1,2 câu ổng ns đi ns lại,... tôi hk ns ra chắc mấy ôg bik là j r chứ 😑😑😑
Danh Trần	Sao anh không cho đếm cái câu “vãi cả nồi” với “vãi cả đạn” á anh
Huynh Nguyen	Uống nước lã nhiều thế a Viruss :)))
Trung Cao	k biết là ông tee nói nhiều thế đâu :)))
smile 25	Tee đỉnh quá
Nguyễn Nghĩa	Justtea với Phương Ly lầy quá hài hước nữa coi cười đau bụng ủng hộ nhóm điên 😂
Hieu Pham Trung	=)))))))))
Nam Đinh	vãi cả nồi ạ
Rexx Vigga	uống soju à? bảo sao mặt ông T tỉnh bơ
Tien Boleo	Em  ko  bao  h  uong ruou
Anh Duc Nguyen	Mới hơn 10 chén mà ... Top 1 thì phải sập chứ mấy ac ê. A viruss uống nhấp môi à 😆
Yang Yang	Viruss khá giống MC Yoo Jae Suk.
Phạm Hùng	Rượu sochu à
Tư Nguyễn	Phương ly là ai z mn
khoa ha	anh viruss ăn nhiều vào nhìn anh chẳng khác gì tờ giấy cả=))
Haru Chan	Nhìn thấy rồi nhé vr nhấp môi lộ nhé :))
LAD Vlog	Chị áo đen xinh thế anh ơi 😍😍😍😍😍😍😍😍😍😍
FG Shiro	Ông Hoàng cãi lý  Dớt Ta Tiiiiiiiiii
Nguyen Phu Da	Haha 😂 mời đúng ông bợm nhậu rồi
Dj Wolf	Sayyy thụt l =))₩
Hani Leggo Hói	A Hoàng gầy thế. Mỏng dính luôn ấy. 😂😂
Hưng Huyền Thoại Moba	*SAY GAMNING LÀ ĐÂY*
Thái Lê xuân	Sn 2001 uống dk khoảng 30 chén mắt trâu :))
YuYu Ngọc	Vãi justatee gắt vãi haha 😂 😂 😂
Đức Nguyễn Công	Khổ thân bị gạ.
DOGE IS GOD	2' vãi
Fantastic Tú Baby	Team nát vl hà há
Linh Huỳnh	Wow
Long Thân	troiwfiiiiiiiiiiiiiii Phương Ly uống ghê dễ sợ ))))
Đạt Nguyễn Ngọc	Hài a tee vch :))
Hiếu x	vãi cả nồi ạ 😂😂
Trang Thùy	Ông tee nát quá ròi :))) bắn như thầy cúng vậy 😂😂
Đông Đây	nồi quốc dân :)
Smart NNT	Bà Ly thấy ghét thiệt hứ làm j ko à
Quoc Tuan Bui	Vãi cả nồi ạ =)))
Nhiên An	Ông ViruSs gầy vl :V
Công Dương Channel	Anh Lâm tẩu nhanh quá :v
anh dương	Tee văn hay vazz
Kiên Đậu	cô Ly uống thần sầu v
Shin Ye Eun	Tưởng tượng viruss vs phương ly là 1 cặp......max đẹp đôi
Minh Duong Nguyen	Đã chơi phải chơi như just
Bên Em Mưa	Ngài áo xanh mỏ thì 100% mà lúc nào cũng nửa ly,  thánh
fit247 Eleven	Vãi cả lồi
Tuấn Dương	Anh rc bài ngày chưa giông bão của Bùi   Lan Hương anh oi
Kim Chi Huỳnh Thị	*vãi cả đạn ạ* *Vãi cả nồi ạ* Hơi nhiều hahaha
Thao Tung	ông lâm =)))
HxProx.	Nhìn ông viruss mắc cười quá
COTREAL HD	*UỐNG ĐƯỢC THÌ UỐNG, KHÔNG UỐNG ĐƯỢC THÌ...CŨNG GẮNG MÀ UỐNG :)) ĐÔ J.TEE CŨNG CAO NHỈ :)) **P.LY** ĐÃ XINH RỒI CÒN UỐNG RIỆU NỮA CÀNG XINH HƠN :)) MÀ ĐÂY RIÊỤ GÌ MÀ NGHE MÙI NHẠT NHẸ VẬY A H.VIRUSS*
Heo Pham	Ông tee say rồi kkk
Quang Gia Dang	Nồi với đạn đâu lắm thía :3
Ngọc Ánh Phạm	Vãi nồi...vãi đạn...anh say nhưg tim anh đang đau :)))
Lam Nguyen	Uống bia , rượu mà mặt đỏ là không tốt nhé ! Khoa học chứng minh rồi chứ không phải do máu gì đỏ đâu , mà là bị ngộ độc nhẹ đó ! Bỏ đi nhé
TÍt NguyỄn	Vãi cả nồi ạ
Thứ Nguyễn	mất hình tượng Just quá
Trang Nguyễn Thị Thùy	Sếp Rớt còn gầy hơn chị Phương Ly nữa trời ơiiiiiii hâhha
Hải Ckýp	Cái kiểu của Justatee uống là tới bến luôn. Kết rồi đấy 🤣
Trần Tuấn	Người của công chúng uống rượu nói cũng hay mà đã nát thì cũng nát có bài có bản đúng là idol 😍😍😍😍
Đan28 Bi	Sup chóo qua kênh tui
Tknt Thiệm	Ông tee thánh nhậu mẹ rồi , văn vãi nồi , như này chối đc cốc nào :)))
Ngọc Thăng Phạm	Đau ruột
Huy Nguyen	rượu gì đó viruss
Quí Lê Trọng	Tee chuẩn vãi.^^.
Vinh Dương	Có ai như tui k.Uống rượu mặt đỏ lừ nhưng ko say.
việt Lưu	Anh tee nói hay thật
Su- Tố Như	Xem mà cười ỉa
Dương Hoàng	Anh Viruss vẫn uống đc nữa mà
Nguyễn đắc Phong	Chị ly xinh gái :)
[V] LỐC Zz	Tee là lí do anh say :)))
Bách hóa toàn thư lác Nguyễn	😂😂😂😂😂😂😂😂😂😂😂😂😂😂😂😂😂😂😂😂😂😂😂😂😂😂😂😂😂😂😂😂😂😂😂😂😂😂😂😂😂😂😂😂😂😂😂😂😂😂😂😂😂😂😂😂😂😂😂😂😂😂😂😂😂😂😂😂😂😂😂😂😂😂😂😂😂😂😂😂😂😂😂😂😂😂😂😂😂😂😂😂😂😂😂😂😂😂😂😂😂😂😂😂😂😂😂😂😂😂😂😂😂😂😂😂😂😂😂😂😂😂😂😂😂😂😂😂😂😂😂😂😂😂😂😂😂😂😂😂😂😂😂😂😂😂😂😂😂😂😂😂😂😂😂😂😂😂😂😂😂😂😂😂😂😂😂😂😂😂😂😂😂😂😂😂😂😂😂😂😂😂😂😂😂😂😂😂😂😂😂😂😂😂😂😂😂😂😂😂😂😂😂😂😂😂😂😂😂😂😂😂😂😂😂😂😂😂😂😂😂😂😂😂😂😂😂😂😂😂😂😂😂😂😂😂😂😂😂😂😂😂😂😂😂😂😂😂😂😂😂😂😂😂😂😂😂😂😂😂 😂😂😂😂😂😂😂😂😂😂😂😂😂😂😂😂😂😂😂😂😂😂😂😂😂😂😂😂😂😂😂😂😂😂😂😂😂😂😂😂😂😂😂😂😂😂😂😂😂😂😂😂 😂😂😂😂😂😂😂😂😂😂😂😂😂😂😂😂😂😂😂😂😂😂😂😂😂😂😂😂😂😂😂😂😂😂😂😂😂😂😂😂😂😂😂😂😂😂😂😂😂😂😂😂 😂😂😂😂😂😂😂😂😂😂😂😂😂😂😂😂😂😂😂😂😂😂😂😂😂😂😂😂😂😂😂😂😂😂😂😂😂😂😂😂😂😂😂😂😂😂😂😂😂😂😂😂 😂😂😂😂😂😂😂😂😂😂😂😂😂😂😂😂😂😂😂😂😂😂😂😂😂😂😂😂😂😂😂😂😂😂😂😂😂😂😂😂😂😂😂😂😂😂😂😂😂😂😂😂 😂😂😂😂😂😂😂😂😂😂😂😂😂😂😂😂😂😂😂😂😂😂😂😂😂😂😂😂😂😂😂😂😂😂😂😂😂😂😂😂😂😂😂😂😂😂😂😂😂😂😂😂 😂😂😂😂😂😂😂😂😂😂😂😂😂😂😂😂😂😂😂😂😂😂😂😂😂😂😂😂😂😂😂😂😂😂😂😂😂😂😂😂😂😂😂😂😂😂😂😂😂😂😂😂 😂😂😂😂😂😂😂😂😂😂😂😂😂😂😂😂😂😂😂😂😂😂😂😂😂😂😂😂😂😂😂😂😂😂😂😂😂😂😂😂😂😂😂😂😂😂😂😂😂😂😂😂 😂😂😂😂😂😂😂😂😂😂😂😂😂😂😂😂😂😂😂😂😂😂😂😂😂😂😂😂😂😂😂😂😂😂😂😂😂😂😂😂😂😂😂😂😂😂😂😂😂😂😂😂 😂😂😂😂😂😂😂😂😂😂😂😂😂😂😂😂😂😂😂😂😂😂😂😂😂😂😂😂😂😂😂😂😂😂😂😂😂😂😂😂😂😂😂😂😂😂😂😂😂😂😂😂 😂😂😂😂😂😂😂😂😂😂😂😂😂😂😂😂😂😂😂😂😂😂😂😂😂😂😂😂😂😂😂😂😂😂😂😂😂😂😂😂😂😂😂😂😂😂😂😂😂😂😂😂
huuthien Phac	Sao gây thế a Virusss
EDM NEW	Xin chào Viruss
Đức Anh Nguyễn	Ông Tee lầy vl, rượu bất khả ép ~> ép bất khả từ ~> từ từ rồi cũng hết. Gặp đội ca si lát này thì chỉ có gọi huệ thôi :v bà Ly cũng gọi là biết chơi đấy :)))
The Carry	Ly xinh quá 😍😍😍
Sentinel Zzz	Thật ra ép rượu hay né rượu cũng phải có nghệ thuật hết, làm thế nào k mất lòng nhau mà vẫn vui là thành công rồi =))
Hoang Tu	Chị ly xinh thế  Anh hoàng yếu quá
quang hung	Nồi và đạn quốc dân
Thắng Đoàn Minh	Cò hương vcl :))
quang trần	Chén đ gì to vcl , chắc rượu này nhẹ thôi , chứ nặng rót tầm như này chắc phọt ra luôn mất
Phúc Kig	uống rượu vào rồi nói nhảm vãi
Tzil	Phương ly uống gắt ghê , nguyên lý mà thấy mặt bth luôn ms ghê chứ :))
Levi Ackerman	Phương ly cute vl :v
Thằng Lười	uống ghê thế :v
minh mốc	Rượu hàn đúg k mấy ôg  thế thì nhằm nhò gì
Mạnh Thế Dũng Nguyễn	Tee khéo kinh :))
Toàn Sida	vi dút nhạt vãi cứ vãi cả đạn với cả vãi cả nồi . tee đanh đá quá
K Cloud 1304	Tee kiểu ăn nói văn vẻ vcl. Chuẩn mẫu đàn ông r
Bian	Phê
Nhạc game Offcial	https://youtu.be/9S2AMZNTOcY
B L A C K	Chết mợ, anh Tee bình thường ít nói, uống vô sao hóa chao nói như thần thế này.
Cu's Tí'ss	Th kia có uống dell đâu lừa virrus uống thôi
Thanh Vân #VMin #Meanie #LinHoon #JackMark	. "Tôi sẽ che chở cho ông" :))
Ngoc Xuan Nguyen	Haha anh justi nói nhiềi quá
Nam Láo Official	Trug bình cứ 5ly đấy là dk 100 mà uốg 13ly cứ cho là ms dk 300 vẫn chưa dk nửa lý mà cái này còn phải uốg nhiều :v
Hiếu Super	A tee giống tui say là nói chuyện nhiều càng say càng nói :))
Spice T	Ai thấy phương ly xinh gái lồn to điểm danhhhhhh !!!!!
Quốc Toàn	Clip này hay quá cười đau bụng  :))
Tat Hoan	Viruss nhjn khổ vai kakaka
Dương Gia Thoại	Vãi cả nồi ra Vãi cả đạn ra
Tiến Anh Nguyễn	Có phải ông ngồi bên phải hay đóng phim không ta
Trần Anh Tuấn	Biết là nhiều khi ép là ko hay nhưng ngồi bàn nhậu phải có 1 2 thanh niên bắt lỗi thế này mới vui
Khói Bụi	VĂN UỐNG RƯỢU Của Team SS Jus Phương Ly kinh vãi chưởng :))) văn uống ruowjy kinh thế
Tuan Nguyen	Phương Ly của em đâu anh
Long Ninja Táo	Khi rượu đã ngấm
hiếu võ	Thanh niên bán nồi lớn nhất vịnh nam bộ :v
Dung Ngo	hoàng gầy quá hoàng ơi...
Bùi Thành Đạt	Mời Justatee là sai rồi 😂😂
Khánh Nguyễn	Viruss sai lầm khi mời phương ly vs justatea về uống. Phương ly vừa xinh mà uống ghê vcl Đáng là editor phải đếm số câu vãi cả nồi ạ của viruss
Truong Le	Cofirm Justti say từ đầu clip cmnr:))
Yuno TTN	just say từ ly thứ 5 và cái jeets có hậu
Ronaldo Johnson	Vãi nồi + vãi đạn =)))
thu văn	*ok anh say* (Em là lý do anh say)
Mạnh Quân	Vãi cả nồi ạ!!!
Bùi Văn Trung	Uống ko lại sao ko gọi ngân sát thủ đến uống hộ
Đức Anh Ngô	Justa “Văn” Tee :))
Danh Hoàng	Uống rượu kêu ông vs tôi =))) có vẻ hơi nhạt :v
ɴeed γou	Mới qua đi uống cưới bạn mẹ 6 thằng ngồi vào kêu ko đc ép nhau ae phải đoàn kết chưa dứt câu 10phút khách tới nó bẫy mấy câu mấy thằng đua nhau dìm nhau làm mẹ tưởng sướng làm uống sấp mặt nôn từ cưới vềf đến nhà ae đi uống tiệc đừng tin bố con thằng nào tự cứu mình thôi,lỡ mồm 1 câu thôi trả giá bằng việc phạt uống đéo uống chúng nó bảo mày sang mẹ bàn con gái mà ngồi . 😁😁
Trong Han	viruss nhậu nồi nhiều vãi
01 Khánh Ali	Cái j cx vãi cả lồi:3
Hehehe Channel	Vcl
Hưng Bờm	Thik phương ly quá
Le Quang	VIRIT CHỈ BIẾT NÓI :VÃI CẢ NỒI. XUỐT BỮA NHẬU. HÀI VL.. 😂😂. CHỊU LUÔN. GĂPH PHẢI DÂN NHẬU ĐÍCH THỰC
Trần Đình Nam	Ôi Thôi 2 Idol Của Tôi 😢 Mình Ngồi Xem Mà Cứ Cười Anh Rớt Ko À ? Câu Vãi Cả Nồi Chắc Ông Nói Đến Mấy Chục Lần 😂😂
Nguyễn Chung	mía có mỗi bài thằng điên mà,anh làm lắm clip thế
Huong Nguyenthi	Phương Ly xinh vch mà 😍
An Thuyên	Uống vậy chit ng đó ăn vào chứ uống thế dễ ra lắm nha 😂😂😂
Công Bình Trần	Hình như là anh just có làm video về uống rượp hợp lý ấy nhề 😀😀😀
Hùng Nguyễn Tuấn	Đù Mất người
Tốn Tạ	Jus nói ông chỉ cần uống thôi ông nói nhiều t đau đầu lắm trong khi jus nói nhiều vl
Nero Trần	Tee nhậu xong lầy kinh :))
Sỹ Đỗ	Em vừa đi học về nên like muộn
Long Nguyen	Có ai nghĩ đó là nước như tao ko 😂
Broken Heart	Tee lầy =)
Ren KouHa	Chẳng là a hoàng ít uống nên k quen thôi..chứ a hoàng mà uống thì a Tee chỉ có nát..nhìn tỉnh bơ
Yêu Bóng Đá	Thanh niên uống rượu cũng dẻp
Duy D	Vãi cả đạn
Anh Phan	Câu của miệng:" vãi cả nồi ạ"
An SuýtĐzai	:)))) vl tee :))
Phạm Văn Thư	Ông Tee uống rượu vào là nát :3
HJP Channel	Mk uống 1,2.. chén là mặt đỏ như đít khỉ.có ai giống mk ko??🤗
Ngọc Thọ Bùi	Nhớ tháo tem chai rượu anh nhé
Tuan To	Ly cuối cùng ông đã uống đâu mà còn tính ly thứ 15, gian vãi nồi
Hùng Đức Lê	Say mẹ rồi kkk
j 4 c e小心	viruss nhin Phuong Ly, kieu, in love cmnr ((=
Cháo Trắng	Ly ngon quá! Em quẩy hết đêm đc á=))))
Trung Đức Vũ	Tee lầy vãi nồi =)))))
Hola Hola	làm cái đếm câu vãi cả nồi xem được bao nhiêu đi :))
Giang Nguyen	A jusstatee ko ve cho con bu đi a bỏ bê chi Tram Anh ở nha the ha -))))
Hubg Luu	Iu phương ly
Cuong Quoc	Ông áo tím lầy nói 100% mà uống tý tẹo là bỏ
Trư Bát Giới	Viruss gầy là thầy uống rượu 😃
Yêu EDM	Tổng  hợp cuộc nói  chuyện của Viruss : Vãi cả nồi!,Vãi Cả Đạn!,Vãi cả chưởng!...
Hannah Dang	Mắt Tee thâm hết r:( thức khuya nhiều quá đấy anh ơiii giữ sức khỏe nhá:((
Đoàn Hoà Dự	Uống có trách nhiệm phần 3 Like a Tee
Hau Ngoc	Vãi cả ............!
Nguyễn Bích Huyền	Ly còn ai đó ăn tết cùng nhưng viruss thì ko cho nên là uống đi =>> tee lầy vl
Giang Nguyễn	vai rớt vãi hết cả nồi chảo , đạn dược rồi haha
NDT Vlog	A mặt đỏ rà kìa anh Viruss
Nguyệt Ánh	Đề nghị a Viruss trích 1 số tiền mua thuốc tăng cân =)))
phong van dinh	Phương Ly
Quoc Bao UTC	Virus nói hơi bị yếu nhỉ :3 jusstatee giành nói hết :))
Ẩn	Có chút rượu mà mình lại bay bay thế này :))
Yonroot	Thánh Tee bắt lỗi kinh
RM5S _Nghĩa	Thích cô ly ghê
pukA phan	Vãi cả nồi
fKt Vũ	anh Hoàng ơi..! ăn uống vào......nhìn giống nghiện rồi đấy......
Hoàng Việt	Ông Tee cục xúc vl 😂
Nghĩa Vũ	Phương ly ❤️
Trọc Been	Ủng hộ tee. Hãy bứt phá lên vir
tuan nguyen minh	Nồi đâu ra mà nhiều vậy
Công Tuấn Trương	Vãi cả nồi :))
Tú Thanh	Ông tee say lầy vl
Minh Khôi	Ngoài vãi cái nồi thì ông hết biết nói gì rồi rồi ạ ??
Toản Trần	Phương ly xinh qué 😍😍😍
Tuấn Linh Lê	Cả đầu đến cuối chỉ vãi nồi vãi đạn
nguyh huy	Just gắt thế, viruss cạn cmn lời 😂😂😂
Kazuto Kirigaya	Vãi cả làm con khỉ 😂
love you	phương ly uong dữ quá
Dragon Viet	Sếp mình said : VÃI CẢ NỒI Ạ.😂😂
Hoàng Mai	Uống được cũng được, uống không được cũng được, nhưng mình không thích kiểu ép rượu rồi lôi chuyện là đàn ông phải uống, phải chiều bạn. Mình thích lối sống của anh Viruss, cái gì cũng vừa đủ, không để bản thân rơi vào tình trạng mất kiểm soát
Linh Diệu	Nồi ạ đạn ạ....
BSQッBinosS	Justatee xỉn=))
NGT CHANEL	Ấu cay...!!! Anh say... Nhưng tim anh đang đau... Ấu !! Đâu hay .... Có chút rượu mà mình lại bay bay thế này.... Em ơi...!! Đôi rượu làm mình tỉnh giấc đó... Buông lơi.... Anh chẳng muốn nghĩ tới..
Huỳnh Tấn Đạt	Anh Tee kiểu người bình tĩnh chứ không phải không say
vlog mít	Trong mỗi cuộc rượu luôn luôn có một người làm đầu đàn, bắt lỗi, nói nhiều vô cùng như ông just  > Rượu bất khả ép
nam pham	hay là viruss uống rượu thật, 2 vị kia uống nước lọccccc
Quang Hiếu Trần	Phương Ly xinh vãi
Mayumi Saegusa	A tee chơi xấu vl
Duy Phạm	Sao cứ vcđ, vcn vậy anh.... ko hạn chế lại được à, nghe nhiều quá cũng khó chịu đấy.
Phạm Đức	mấy cái nhấp môi ko tính nha
My Ngoc Duong	Tội sếp quá trời ạ 😄😄😄
ĐoaN D.Đ	VR hầu như lúc nào cũng có câu vãi nghe nhiều thấy khó chịu ghê
Không Tên Tuổi	Vãi cả nồi ạ...😂😂😂
G Channel	Nhìn buồn cười vãi
wa đuhek	Nhìn ah như thag nghiện ý
Lý Lee	Phương Ly uống kinh vậy 🍺😱
Wall	Vãi Cả Nồi x3,14
dat tuan	A viruss bị a justatee bắt lỗi nhiều vl =))))
Trang Trịnh	Ly ơi em bá quá :))
Đại Phi	Jus tổ lái
Lee Chul Soo	Soju uống thì bao h mới say???
Nguyen Duc Cuong	Vãi nồi hơi nhiều 😂
An Trần	Phương lyyyyy dễ thương
Bá Lại	Tee lầy
Hậu Nguyễn Ngọc	Yêu ly vcc :))
Thái thiên thần	jaytee thuộc thành phần nát khi uống rượu
Trình Huỳnh	Xem mấy lần rồi mà vẫn buồn cười hahaaha
Viet Oreki	đoạn cuối mấy ông hài vl :v :v :v
Thế Anh Trần	VirusS:vãi cả...
gió vô tình	Khi bạn để con gái say :))
Vu Nguyen	tee lầy kinh hồn :)) haha quả này viruss ra hà nội chỉ có bơi ngửa :))
challenge Chí Phèo	mấy ông kia có uống nhiêu đâu toàn anh viruss uống ko kkkk
Đức Thiện Nguyễn	Kinh
Linh Trường Nguyễn	VÃI CẢ NỒI
Call My Name Fox	Vãi cả lồiiiiii ạ
nhimxelu_no1 nhim	Ônng Viruss vật vã vậy =))))
Duy Nguyen Cong	Ứ gì 😂😂😂
WindDashers	*Ok anh say, nhưng tim anh đang đau oh... đâu hay, có chút rượu mà mình lại bay bay thế này =))*
Vitun Le	Ông Tee lầy vãl cả nồi
Hoàng Hôn Khóc	nói thật nhé nếu rượu này đưa đây tao múc 1 buổi sáng cũng đc :)) thật đấy. bọn tao uống rượu TQ 10 ngàn 1 lít kia còn bay cả 2 lít mà có 1 cái uống xong đầu óc nó quay cuồn thôi :))
Hamster nguyễn	nữ chính MV xinh quá. =)) mà cá tính nữa
2811 NTK	#tramanhvirussderoi=)))
hoa tran	Ai thấy phương ly đẹp gái,điểm danh 😍😍
Đạt Nguyễn	Phương ly xinh quá
Lương Bắc Đỗ	cười điên người =)))))0 hahahahaha
Sam Esther	1:20 ai như tui hông Hết hồn chim én
Bảo Gin	phương lyyyyyy của t
Roo Ty	Tee đanh đá v~ :)))
Đường Tam Tạng	Đi ca nô ko tụi em chị lấy giá rẻ :))
Quý Nguyễn	Lại nhảy vào mồm tôi rồi :))
annt SE00065x	Vãi cả nồiiiiii àhh
top 1 thách đấu liên quân Việt Nam	Ô áo xanh toàn nhấp môi. Ý thức nhậu kém vkl
7arker	Ai thống kê cho t ông Viruss nói bn câu “VCN” vs “VCĐ” vs nào 😂
Thái Nguyễn Thế	các cụ có câu: các cậu có cu :v :v
THACH DANG	Tội vr vl
BoBo PooM	a tee mà gặp e á. e cho a uống 1 e uống 2 nhé. a chỉ bắt nạt dk viruss thôi:)
Su Tuyết	Cho e hỏi mua thảm đó ở đâu v ạ??
Duy Gioi Nguyen	Nhà anh không thiếu gì ngoài nồi vs đạn =)))
zero 9	Uống ko hết dc ly rượu sao mà gà vậy có ai để ý dĩa thức ăn ko sao mà từ đầu đến cuối vẫn còn nguyên vậy nhậu j mà uống mỗi lửa ly rượu trẻ ghé à
TUNG LE	Just,just,just,just,just, am just, am just à.. Anh uốn không sayyy Khônh say đâu mà.. Uốn tiếp đi ông.. Kêu tui lên mà.. Phương ly đã tới.. Thêm vài hiệp nữa.. Chơi hết tối nayyyy...
Hai Hoang	Viruss cũng uống kinh bỏ mẹ ra ấy chứ :))
Nhạc Phong Official	Lầy vãi nồi
Mr_ Gia Phú	Mồm bảo chăc tôi uông 4 đến 5 chén là ngu mak đả 8 chén vãi đạn
The GOD Rubik	Phương Ly xinh qué! Rụng tym rồi <3
như lai phật tổ	Trâm anh chưa giết các anh à ><
Tuấn Anh Trần	Trông thế justatee gia trưởng nhỉ
Tùng Haha	ép dầu ép mỡ ai lỡ ép rươu. trong bàn nhậu kiểu gì cũng có: 1 thằng cậy uống đc rồi hay khích đểu(tee), 1 thằng đell biết uống nhưng ko muốn mặc váy(vruss), còn một đứa im lặng quan sát rồi diệt mồi từ đầu đến cuối buổi nhậu( phương ly) và còn 1 đứa đã chuẩn bị mọi thủ đoạn tránh rượu trc khi vào cuộc(thằng điên). mà trên đời ghét nhất là mấy đứa khích uống bia uống rượu. bọn mk uống chẳng bg ép chỉ đưa ra cái luật đứa nào uống ít nhất là ko tôn trọng ae, tí dọn đống này. thế thôi:v
Nghiện Công Nghệ	Nhìn viruss Dam Dang v 🤣🤣🤣
Anh Bèo	vui quá mấy anh ơi
Hòa 23	Best ép rượu. Hài vkl =)))
vu huy	Anh Tee gắt :))
Thuận Trần	Jus gắt vl
HadeSs gaming	Best tee ép rượu
tôn ngộ không	say quá cũng đừng đ*t chụy phương ly nhé anh
Big Bird	Viruss gầy théeeee
Oc buou gold	A Tee chúc cứ vui mà :))
win Huynh	Ông viruss cứ vãi cả nồi ạ, vãi đạn ạ =))
tung duong nguyen duc	T đếch thấy hay gì kiểu ép rượu nửa đùa nửa thật thế này .
Hải Nguyễn	Reaction Sống cho hết đời thanh xuân cảu dick đi anh :))
꧁༺ѕт࿐ĐạtGG༻꧂ -offical	Ah Viruss mặt đỏ như gà tây vậy 😂😂
Master Jack	Hài vãi
king boss	Ông Hoàng đi tập gym đi, cứ như bộ xương khô :))
hưng lê	Anh tee uống rượu nói nhìu vãi
Tuấn Đép	Anh Say nhưng tim anh đang đau ó,đâu hay.... :v
Lâm Tiều Phu	ông Tee rượu vào vẫn tỉnh bơ
Hiền carô	Lại gặp thánh uống rượu viruss phải quỳ
Đức Vinh	Vãi cả nồiii🤣🤣
Thành Hoàng	Tee uống gắt vl
We-Pi	Vãi cả nồi ạ
Nam đẹp zai khoai lang	8:20 chia sẻ của 1 bạn trẻ có vợ .
Ngân Ngân Vlogs	*Lần Đầu Thấy Anh Uống Rượu* :))
Trung Lê	Hình ảnh cuối cùng là đẹp nhất anh ơi
Ẩm Thực Tam Mao	Cmt đủ 200 like ae nhà Tam Mao sẽ thử thách tìm đến nhà của Viruss nhé
B Tube	tưng tưng mắc cười quá :D
minhthuan nguuyen	Nói ít thôi uống nhìu vào 😂😂
Tuấn Devin	A Virrus uống riệu giống mình 1 chén là đỏ. Uống say đầu óc vẫn tỉnh  A Justatee kiểu người càng uống càng nát. ( uống được nhiều ) Và quả kết quá gắt. :))
Tiến Anh Đinh	Virss hãi
Ngọc Thân Nguyễn	Virus vs jus là bạn học hay s z trời
Hắc kiếm sĩ Kirito	Chị phương linh đâu :v
Hai Minh	Lắm nồi quá 😂😂😂
Cam TV	Team xem sớm 😀😁😀
Tuấn Anh	Anh áo vàng và anh ôm tee là ai v :v
Hoàng Điệp	nhìn như t nghiện
Chung Nguyen Tat	4:18 Viruss nhìn Phương Ly mà nể
yêu nông nghiệp	Con em nào dể thương z
Đắc Hiếu Nguyễn	ViruSs gầy quá
Đỗ Tú	Tee uống ghê vlin
Sang Dinh	Hi
Trúc Phương	*Xem mà cười đau bụng*
Quân Nguyễn TV	*Team ko bik uống rượu, bia đâu rồi* 👌🏻👌🏻👌🏻👌🏻
Bô Mập Channel	mình mà làm video này thì end trong vòng 3 nốt nhạc. 1 nóc là lên mẹ rồi
Bắc WK	Ummmm bh anh mới reaction vậy !!
Hiếu Võ	Vãi cả nồi =)) vãi cả đạn :))
Jeon Jungkook	Wow
Hà Vũ	A gầy thế
Mực khô	Hóng ông viruss làm thêm một bài nữa =))
Violet Vương	hAHAhaHa
Ari MVP	*Fan Virus điểm danh nào 6h 30phut hôm nay mình tặng nick liên quân mong ae ghé qua ủng hộ mình nhé cảm ơn*
Tâm Đoàn	Vãi cả nồiiiiiiiiiii Ạ
khesanh.net	ViruSs gầy quá, tập gym đi em
Tonny Official	A just say 😂😂
Cf m	Phê chưa anh
Lê Tình	BEST SAY RUU HAHAHA
Vy Nguyễn	😂😂
channel GD	Haha 😄
A.R.M.Y & SKY & BLINK & VIP	Lão jus uống kinh thế
Thảo Trang	Điên là điên là điên 😂
Khải Tik Tok	sud chéo uy tín
murad siêu việt	Hi
ATS BOSS	Hello 3 anh
Yab	Gầy
Thảo Hồng	💟
Quân Gray	Chéo sub uy tín
Naga Dosu	V khỉ
Nguyễn Quốc Anh	Chú Lâm toàn 1%
Cannabin Tv	Vãi cả xoong
EDM MUSIC	Lâu lâu lâu thì ta mới nhậu 1 lần
Chang Bin	LÀm ơn ai đó đó có tấm lòng hảo tâm hãy làm phước bố thí cho tôi 1 like và 1 SUB đc ko ạ
ứ ừ	Sub uy tín 100%
tien nam	Dô nàoooooooooo
NHT Gamer	top 2 like đầu hihi
